PID	App. Year	Improvements	Land	Total	CollectedOn
1	2023	0	0	0	2024-11-26
1	2022	1254000	0	1254000	2024-11-26
1	2021	1254000	0	1254000	2024-11-26
2	2023	2705300	0	2705300	2024-11-26
2	2022	3294400	0	3294400	2024-11-26
2	2021	2861300	0	2861300	2024-11-26
3	2023	2007300	0	2007300	2024-11-26
3	2022	2353000	0	2353000	2024-11-26
3	2021	2527700	0	2527700	2024-11-26
4	2023	12600	0	12600	2024-11-26
4	2022	12600	0	12600	2024-11-26
4	2021	500	0	500	2024-11-26
5	2023	93700	167600	261300	2024-11-26
5	2022	93700	167600	261300	2024-11-26
5	2021	93700	167600	261300	2024-11-26
7	2023	77200	104600	181800	2024-11-26
7	2022	77200	104600	181800	2024-11-26
7	2021	77200	104600	181800	2024-11-26
8	2023	114000	140400	254400	2024-11-26
8	2022	114000	140400	254400	2024-11-26
8	2021	114000	140400	254400	2024-11-26
9	2023	112100	157900	270000	2024-11-26
9	2022	112100	157900	270000	2024-11-26
9	2021	108900	157900	266800	2024-11-26
10	2023	254100	163000	417100	2024-11-26
10	2022	254100	163000	417100	2024-11-26
10	2021	254100	163000	417100	2024-11-26
12	2023	261800	225200	487000	2024-11-26
12	2022	261800	225200	487000	2024-11-26
12	2021	261800	225200	487000	2024-11-26
13	2023	275700	280700	556400	2024-11-26
13	2022	275700	280700	556400	2024-11-26
13	2021	275700	280700	556400	2024-11-26
16	2023	1016100	385700	1401800	2024-11-26
16	2022	1016100	385700	1401800	2024-11-26
16	2021	1016100	385700	1401800	2024-11-26
18	2023	194000	122600	316600	2024-11-26
18	2022	194000	139100	333100	2024-11-26
18	2021	162500	139100	301600	2024-11-26
19	2023	125000	106300	231300	2024-11-26
19	2022	125000	62300	187300	2024-11-26
19	2021	91700	62300	154000	2024-11-26
20	2023	381400	234400	615800	2024-11-26
20	2022	381400	234400	615800	2024-11-26
20	2021	381400	234400	615800	2024-11-26
21	2023	398100	288400	686500	2024-11-26
21	2022	398100	288400	686500	2024-11-26
21	2021	398100	288400	686500	2024-11-26
22	2023	269300	179700	449000	2024-11-26
22	2022	269300	179700	449000	2024-11-26
22	2021	269300	179700	449000	2024-11-26
23	2023	233100	245600	478700	2024-11-26
23	2022	233100	245600	478700	2024-11-26
23	2021	233100	245600	478700	2024-11-26
25	2023	392500	170500	563000	2024-11-26
25	2022	378700	170500	549200	2024-11-26
25	2021	410600	170500	581100	2024-11-26
26	2023	144700	205300	350000	2024-11-26
26	2022	144700	205300	350000	2024-11-26
26	2021	151100	205300	356400	2024-11-26
27	2023	327100	210000	537100	2024-11-26
27	2022	327100	210000	537100	2024-11-26
27	2021	326700	210000	536700	2024-11-26
28	2023	302000	244000	546000	2024-11-26
28	2022	298800	244000	542800	2024-11-26
28	2021	292900	244000	536900	2024-11-26
29	2023	420400	235700	656100	2024-11-26
29	2022	420400	235700	656100	2024-11-26
29	2021	420400	235700	656100	2024-11-26
30	2023	275300	218200	493500	2024-11-26
30	2022	275300	218200	493500	2024-11-26
30	2021	275800	218200	494000	2024-11-26
32	2023	136200	146800	283000	2024-11-26
32	2022	131000	146800	277800	2024-11-26
32	2021	131000	146800	277800	2024-11-26
33	2023	176400	151600	328000	2024-11-26
33	2022	176400	151600	328000	2024-11-26
33	2021	176400	151600	328000	2024-11-26
34	2023	395200	157700	552900	2024-11-26
34	2022	395200	157700	552900	2024-11-26
34	2021	395200	157700	552900	2024-11-26
35	2023	0	29200	29200	2024-11-26
35	2022	0	29200	29200	2024-11-26
35	2021	0	29200	29200	2024-11-26
36	2023	377800	416200	794000	2024-11-26
36	2022	303000	416200	719200	2024-11-26
36	2021	303000	416200	719200	2024-11-26
37	2023	297500	353000	650500	2024-11-26
37	2022	297500	353000	650500	2024-11-26
37	2021	297500	353000	650500	2024-11-26
40	2023	0	43000	43000	2024-11-26
40	2022	0	43000	43000	2024-11-26
40	2021	0	43000	43000	2024-11-26
41	2023	447000	186000	633000	2024-11-26
41	2022	447000	186000	633000	2024-11-26
41	2021	447000	186000	633000	2024-11-26
42	2023	269800	218700	488500	2024-11-26
42	2022	269800	218700	488500	2024-11-26
42	2021	269800	218700	488500	2024-11-26
43	2023	137300	208300	345600	2024-11-26
43	2022	137300	208300	345600	2024-11-26
43	2021	137300	208300	345600	2024-11-26
50	2023	194300	0	194300	2024-11-26
50	2022	194300	0	194300	2024-11-26
50	2021	194300	0	194300	2024-11-26
51	2023	197400	0	197400	2024-11-26
51	2022	197400	0	197400	2024-11-26
51	2021	197400	0	197400	2024-11-26
52	2023	184100	0	184100	2024-11-26
52	2022	184100	0	184100	2024-11-26
52	2021	184100	0	184100	2024-11-26
53	2023	208500	0	208500	2024-11-26
53	2022	208500	0	208500	2024-11-26
53	2021	208500	0	208500	2024-11-26
54	2023	179900	0	179900	2024-11-26
54	2022	179900	0	179900	2024-11-26
54	2021	179900	0	179900	2024-11-26
55	2023	195600	0	195600	2024-11-26
55	2022	195600	0	195600	2024-11-26
55	2021	195600	0	195600	2024-11-26
56	2023	1025200	234500	1259700	2024-11-26
56	2022	976100	234500	1210600	2024-11-26
56	2021	926400	234500	1160900	2024-11-26
57	2023	734700	230000	964700	2024-11-26
57	2022	734700	230000	964700	2024-11-26
57	2021	734700	230000	964700	2024-11-26
58	2023	653600	262000	915600	2024-11-26
58	2022	653600	262000	915600	2024-11-26
58	2021	653600	262000	915600	2024-11-26
59	2023	355300	156500	511800	2024-11-26
59	2022	355300	156500	511800	2024-11-26
59	2021	355300	156500	511800	2024-11-26
60	2023	485100	218900	704000	2024-11-26
60	2022	485100	218900	704000	2024-11-26
60	2021	485100	218900	704000	2024-11-26
62	2023	515100	163900	679000	2024-11-26
62	2022	498400	163900	662300	2024-11-26
62	2021	485300	163900	649200	2024-11-26
63	2023	258400	232100	490500	2024-11-26
63	2022	258400	232100	490500	2024-11-26
63	2021	258400	232100	490500	2024-11-26
64	2023	103900	218200	322100	2024-11-26
64	2022	103900	218200	322100	2024-11-26
64	2021	103900	218200	322100	2024-11-26
65	2023	482500	228900	711400	2024-11-26
65	2022	436100	228900	665000	2024-11-26
65	2021	316000	228900	544900	2024-11-26
66	2023	218800	230900	449700	2024-11-26
66	2022	218800	230900	449700	2024-11-26
66	2021	218800	230900	449700	2024-11-26
67	2023	0	103200	103200	2024-11-26
67	2022	0	103200	103200	2024-11-26
67	2021	0	103200	103200	2024-11-26
68	2023	127000	157100	284100	2024-11-26
68	2022	127000	157100	284100	2024-11-26
68	2021	127000	157100	284100	2024-11-26
69	2023	0	8600	8600	2024-11-26
69	2022	0	8600	8600	2024-11-26
69	2021	0	8600	8600	2024-11-26
76	2023	519800	234400	754200	2024-11-26
76	2022	519800	234400	754200	2024-11-26
76	2021	519800	234400	754200	2024-11-26
77	2023	343500	234900	578400	2024-11-26
77	2022	343500	234900	578400	2024-11-26
77	2021	343500	234900	578400	2024-11-26
78	2023	173800	216500	390300	2024-11-26
78	2022	173800	216500	390300	2024-11-26
78	2021	173800	216500	390300	2024-11-26
79	2023	116800	216500	333300	2024-11-26
79	2022	116800	216500	333300	2024-11-26
79	2021	116800	216500	333300	2024-11-26
80	2023	301600	317200	618800	2024-11-26
80	2022	301600	317200	618800	2024-11-26
80	2021	301600	317200	618800	2024-11-26
81	2023	92200	233300	325500	2024-11-26
81	2022	92200	233300	325500	2024-11-26
81	2021	139400	290400	429800	2024-11-26
82	2023	217700	199300	417000	2024-11-26
82	2022	217700	199300	417000	2024-11-26
82	2021	217700	199300	417000	2024-11-26
83	2023	190300	161800	352100	2024-11-26
83	2022	190300	161800	352100	2024-11-26
83	2021	189900	161800	351700	2024-11-26
84	2023	3187200	2000100	5187300	2024-11-26
84	2022	3187200	2000100	5187300	2024-11-26
84	2021	3187200	2000100	5187300	2024-11-26
85	2023	0	16900	16900	2024-11-26
85	2022	0	16900	16900	2024-11-26
85	2021	0	16900	16900	2024-11-26
86	2023	471700	228900	700600	2024-11-26
86	2022	471700	228900	700600	2024-11-26
86	2021	471700	228900	700600	2024-11-26
87	2023	379700	256000	635700	2024-11-26
87	2022	379700	256000	635700	2024-11-26
87	2021	379700	256000	635700	2024-11-26
88	2023	43200	113400	156600	2024-11-26
88	2022	43200	113400	156600	2024-11-26
88	2021	43200	113400	156600	2024-11-26
89	2023	269500	375600	645100	2024-11-26
89	2022	252300	375600	627900	2024-11-26
89	2021	252300	375600	627900	2024-11-26
91	2023	526300	277000	803300	2024-11-26
91	2022	526300	277000	803300	2024-11-26
91	2021	526300	277000	803300	2024-11-26
92	2023	77800	179500	257300	2024-11-26
92	2022	77800	179500	257300	2024-11-26
92	2021	77800	179500	257300	2024-11-26
93	2023	548900	204300	753200	2024-11-26
93	2022	548900	204300	753200	2024-11-26
93	2021	475800	204300	680100	2024-11-26
94	2023	385500	179200	564700	2024-11-26
94	2022	385500	179200	564700	2024-11-26
94	2021	385500	179200	564700	2024-11-26
95	2023	410100	207600	617700	2024-11-26
95	2022	410100	207600	617700	2024-11-26
95	2021	410100	207600	617700	2024-11-26
99	2023	328500	0	328500	2024-11-26
99	2022	328500	0	328500	2024-11-26
99	2021	328500	0	328500	2024-11-26
101	2023	543900	0	543900	2024-11-26
101	2022	543900	0	543900	2024-11-26
101	2021	543900	0	543900	2024-11-26
102	2023	7500	104000	111500	2024-11-26
102	2022	7500	104000	111500	2024-11-26
102	2021	7500	104000	111500	2024-11-26
103	2023	121800	185100	306900	2024-11-26
103	2022	121800	185100	306900	2024-11-26
103	2021	121800	185100	306900	2024-11-26
104	2023	1055000	394300	1449300	2024-11-26
104	2022	1055000	394300	1449300	2024-11-26
104	2021	1055000	394300	1449300	2024-11-26
105	2023	236100	274300	510400	2024-11-26
105	2022	236100	274300	510400	2024-11-26
105	2021	236100	274300	510400	2024-11-26
106	2023	1421000	488300	1909300	2024-11-26
106	2022	1421000	488300	1909300	2024-11-26
106	2021	1421000	488300	1909300	2024-11-26
107	2023	359500	263700	623200	2024-11-26
107	2022	359500	263700	623200	2024-11-26
107	2021	359500	263700	623200	2024-11-26
111	2023	4400	424700	429100	2024-11-26
111	2022	4400	424700	429100	2024-11-26
111	2021	4400	424700	429100	2024-11-26
115	2023	89200	194200	283400	2024-11-26
115	2022	51000	194200	245200	2024-11-26
115	2021	221200	258500	479700	2024-11-26
116	2023	249500	148200	397700	2024-11-26
116	2022	249500	148200	397700	2024-11-26
116	2021	249500	148200	397700	2024-11-26
117	2023	435400	0	435400	2024-11-26
117	2022	426300	0	426300	2024-11-26
117	2021	426300	0	426300	2024-11-26
118	2023	155800	405100	560900	2024-11-26
118	2022	155800	405100	560900	2024-11-26
118	2021	155800	405100	560900	2024-11-26
120	2023	462100	360800	822900	2024-11-26
120	2022	462100	360800	822900	2024-11-26
120	2021	462100	360800	822900	2024-11-26
121	2023	124500	143700	268200	2024-11-26
121	2022	2900	143700	146600	2024-11-26
121	2021	2400	143700	146100	2024-11-26
122	2023	273000	133300	406300	2024-11-26
122	2022	273000	133300	406300	2024-11-26
122	2021	273000	133300	406300	2024-11-26
123	2023	151900	132200	284100	2024-11-26
123	2022	151900	132200	284100	2024-11-26
123	2021	151900	132200	284100	2024-11-26
124	2023	354900	223000	577900	2024-11-26
124	2022	354900	223000	577900	2024-11-26
124	2021	354900	223000	577900	2024-11-26
125	2023	272000	155700	427700	2024-11-26
125	2022	272000	155700	427700	2024-11-26
125	2021	272000	155700	427700	2024-11-26
127	2023	240200	153300	393500	2024-11-26
127	2022	240200	153300	393500	2024-11-26
127	2021	240200	153300	393500	2024-11-26
128	2023	395000	188500	583500	2024-11-26
128	2022	395000	188500	583500	2024-11-26
128	2021	395000	188500	583500	2024-11-26
129	2023	182300	157500	339800	2024-11-26
129	2022	182300	157500	339800	2024-11-26
129	2021	182300	157500	339800	2024-11-26
132	2023	0	40300	40300	2024-11-26
132	2022	0	40300	40300	2024-11-26
132	2021	0	40300	40300	2024-11-26
133	2023	42000	0	42000	2024-11-26
133	2022	42000	0	42000	2024-11-26
133	2021	42000	0	42000	2024-11-26
136	2023	15200	12200	27400	2024-11-26
136	2022	15200	12200	27400	2024-11-26
136	2021	15200	12200	27400	2024-11-26
137	2023	46900	189400	236300	2024-11-26
137	2022	46900	189400	236300	2024-11-26
137	2021	46900	189400	236300	2024-11-26
138	2023	1194500	246000	1440500	2024-11-26
138	2022	1194500	246000	1440500	2024-11-26
138	2021	1194500	246000	1440500	2024-11-26
139	2023	81400	166400	247800	2024-11-26
139	2022	81400	166400	247800	2024-11-26
139	2021	81400	166400	247800	2024-11-26
140	2023	595300	151500	746800	2024-11-26
140	2022	575300	151500	726800	2024-11-26
140	2021	575300	151500	726800	2024-11-26
142	2023	183800	209900	393700	2024-11-26
142	2022	183800	209900	393700	2024-11-26
142	2021	183800	209900	393700	2024-11-26
143	2023	334100	206900	541000	2024-11-26
143	2022	334100	206900	541000	2024-11-26
143	2021	334100	206900	541000	2024-11-26
144	2023	145200	133000	278200	2024-11-26
144	2022	145200	133000	278200	2024-11-26
144	2021	144800	133000	277800	2024-11-26
148	2023	163800	142700	306500	2024-11-26
148	2022	163800	142700	306500	2024-11-26
148	2021	163800	142700	306500	2024-11-26
149	2023	385600	171200	556800	2024-11-26
149	2022	385600	171200	556800	2024-11-26
149	2021	385600	171200	556800	2024-11-26
150	2023	402500	170200	572700	2024-11-26
150	2022	410700	170200	580900	2024-11-26
150	2021	410700	170200	580900	2024-11-26
151	2023	0	218500	218500	2024-11-26
151	2022	0	218500	218500	2024-11-26
151	2021	0	218500	218500	2024-11-26
152	2023	176000	84800	260800	2024-11-26
152	2022	176000	84800	260800	2024-11-26
152	2021	175200	84800	260000	2024-11-26
153	2023	149400	111300	260700	2024-11-26
153	2022	149400	111300	260700	2024-11-26
153	2021	149400	111300	260700	2024-11-26
154	2023	82500	82400	164900	2024-11-26
154	2022	82500	82400	164900	2024-11-26
154	2021	82500	82400	164900	2024-11-26
159	2023	23700	166100	189800	2024-11-26
159	2022	21200	166100	187300	2024-11-26
159	2021	21200	166100	187300	2024-11-26
161	2023	562100	219600	781700	2024-11-26
161	2022	562100	219600	781700	2024-11-26
161	2021	562100	219600	781700	2024-11-26
162	2023	172300	126800	299100	2024-11-26
162	2022	165400	126800	292200	2024-11-26
162	2021	165400	126800	292200	2024-11-26
163	2023	269600	158900	428500	2024-11-26
163	2022	269600	158900	428500	2024-11-26
163	2021	269600	158900	428500	2024-11-26
164	2023	46200	98300	144500	2024-11-26
164	2022	46200	98300	144500	2024-11-26
164	2021	46200	98300	144500	2024-11-26
167	2023	289300	224000	513300	2024-11-26
167	2022	289300	224000	513300	2024-11-26
167	2021	289300	224000	513300	2024-11-26
168	2023	174500	129600	304100	2024-11-26
168	2022	174500	129600	304100	2024-11-26
168	2021	174500	129600	304100	2024-11-26
169	2023	154200	111100	265300	2024-11-26
169	2022	154200	111100	265300	2024-11-26
169	2021	154200	111100	265300	2024-11-26
170	2023	1225500	266800	1492300	2024-11-26
170	2022	1225500	266800	1492300	2024-11-26
170	2021	1225500	266800	1492300	2024-11-26
171	2023	0	144500	144500	2024-11-26
171	2022	0	144500	144500	2024-11-26
171	2021	0	144500	144500	2024-11-26
172	2023	0	161400	161400	2024-11-26
172	2022	0	161400	161400	2024-11-26
172	2021	0	161400	161400	2024-11-26
173	2023	465200	146600	611800	2024-11-26
173	2022	465200	146600	611800	2024-11-26
173	2021	465200	154000	619200	2024-11-26
174	2023	152300	132200	284500	2024-11-26
174	2022	152300	132200	284500	2024-11-26
174	2021	152300	132200	284500	2024-11-26
176	2023	156600	137900	294500	2024-11-26
176	2022	156600	137900	294500	2024-11-26
176	2021	156600	137900	294500	2024-11-26
177	2023	81400	129800	211200	2024-11-26
177	2022	81400	129800	211200	2024-11-26
177	2021	85100	129800	214900	2024-11-26
178	2023	231800	126600	358400	2024-11-26
178	2022	231800	126600	358400	2024-11-26
178	2021	231800	126600	358400	2024-11-26
179	2023	149400	138100	287500	2024-11-26
179	2022	149400	138100	287500	2024-11-26
179	2021	149400	138100	287500	2024-11-26
180	2023	597800	284700	882500	2024-11-26
180	2022	597800	284700	882500	2024-11-26
180	2021	597800	284700	882500	2024-11-26
181	2023	0	333600	333600	2024-11-26
181	2022	0	333600	333600	2024-11-26
181	2021	0	333600	333600	2024-11-26
182	2023	546700	233200	779900	2024-11-26
182	2022	507900	233200	741100	2024-11-26
182	2021	507900	233200	741100	2024-11-26
183	2023	282900	103000	385900	2024-11-26
183	2022	282900	103000	385900	2024-11-26
183	2021	10900	103000	113900	2024-11-26
187	2023	314000	322400	636400	2024-11-26
187	2022	314000	322400	636400	2024-11-26
187	2021	351200	344600	695800	2024-11-26
188	2023	613900	312400	926300	2024-11-26
188	2022	613900	312400	926300	2024-11-26
188	2021	329500	275100	604600	2024-11-26
189	2023	8500	129600	138100	2024-11-26
189	2022	8500	129600	138100	2024-11-26
189	2021	8500	129600	138100	2024-11-26
190	2023	0	59200	59200	2024-11-26
190	2022	0	59200	59200	2024-11-26
190	2021	0	59200	59200	2024-11-26
191	2023	0	204100	204100	2024-11-26
191	2022	0	204100	204100	2024-11-26
191	2021	0	204100	204100	2024-11-26
192	2023	0	689600	689600	2024-11-26
192	2022	0	689600	689600	2024-11-26
192	2021	0	689600	689600	2024-11-26
194	2023	0	22300	22300	2024-11-26
194	2022	0	22300	22300	2024-11-26
194	2021	0	22300	22300	2024-11-26
195	2023	343500	176200	519700	2024-11-26
195	2022	343500	176200	519700	2024-11-26
195	2021	343500	176200	519700	2024-11-26
197	2023	0	166600	166600	2024-11-26
197	2022	0	166600	166600	2024-11-26
197	2021	0	166600	166600	2024-11-26
201	2023	322700	251700	574400	2024-11-26
201	2022	322700	251700	574400	2024-11-26
201	2021	322700	251700	574400	2024-11-26
202	2023	420600	774500	1195100	2024-11-26
202	2022	418600	774500	1193100	2024-11-26
202	2021	392300	774500	1166800	2024-11-26
203	2023	232400	125100	357500	2024-11-26
203	2022	232400	125100	357500	2024-11-26
203	2021	232400	125100	357500	2024-11-26
204	2023	396000	484700	880700	2024-11-26
204	2022	396000	484700	880700	2024-11-26
204	2021	396000	484700	880700	2024-11-26
206	2023	606800	227800	834600	2024-11-26
206	2022	606800	227800	834600	2024-11-26
206	2021	606800	227800	834600	2024-11-26
207	2023	1700	647500	649200	2024-11-26
207	2022	1700	647500	649200	2024-11-26
207	2021	1700	647500	649200	2024-11-26
208	2023	136600	142400	279000	2024-11-26
208	2022	180600	142400	323000	2024-11-26
208	2021	180600	142400	323000	2024-11-26
209	2023	124500	143300	267800	2024-11-26
209	2022	124500	143300	267800	2024-11-26
209	2021	119000	143300	262300	2024-11-26
210	2023	193800	143300	337100	2024-11-26
210	2022	193800	143300	337100	2024-11-26
210	2021	193800	143300	337100	2024-11-26
217	2023	0	476800	476800	2024-11-26
217	2022	0	476800	476800	2024-11-26
217	2021	0	476800	476800	2024-11-26
219	2023	176100	164500	340600	2024-11-26
219	2022	176100	164500	340600	2024-11-26
219	2021	176100	164500	340600	2024-11-26
220	2023	180400	108100	288500	2024-11-26
220	2022	180400	108100	288500	2024-11-26
220	2021	180400	108100	288500	2024-11-26
221	2023	221900	95600	317500	2024-11-26
221	2022	221900	95600	317500	2024-11-26
221	2021	221900	95600	317500	2024-11-26
222	2023	269100	168700	437800	2024-11-26
222	2022	269100	168700	437800	2024-11-26
222	2021	269100	168700	437800	2024-11-26
223	2023	334100	175300	509400	2024-11-26
223	2022	334100	175300	509400	2024-11-26
223	2021	322900	175300	498200	2024-11-26
224	2023	234300	215300	449600	2024-11-26
224	2022	234300	215300	449600	2024-11-26
224	2021	234300	215300	449600	2024-11-26
225	2023	86100	176600	262700	2024-11-26
225	2022	86100	176600	262700	2024-11-26
225	2021	86100	176600	262700	2024-11-26
229	2023	312700	179600	492300	2024-11-26
229	2022	312700	179600	492300	2024-11-26
229	2021	312700	179600	492300	2024-11-26
230	2023	0	218200	218200	2024-11-26
230	2022	0	218200	218200	2024-11-26
230	2021	0	218200	218200	2024-11-26
231	2023	0	91300	91300	2024-11-26
231	2022	82800	91300	174100	2024-11-26
231	2021	82800	91300	174100	2024-11-26
232	2023	72200	57800	130000	2024-11-26
232	2022	72200	57800	130000	2024-11-26
232	2021	72200	57800	130000	2024-11-26
233	2023	81500	65100	146600	2024-11-26
233	2022	81500	65100	146600	2024-11-26
233	2021	81500	65100	146600	2024-11-26
234	2023	228500	134400	362900	2024-11-26
234	2022	228500	134400	362900	2024-11-26
234	2021	228500	134400	362900	2024-11-26
235	2023	455900	169300	625200	2024-11-26
235	2022	455900	169300	625200	2024-11-26
235	2021	455900	169300	625200	2024-11-26
236	2023	184400	119700	304100	2024-11-26
236	2022	184400	119700	304100	2024-11-26
236	2021	184400	119700	304100	2024-11-26
237	2023	45100	88200	133300	2024-11-26
237	2022	45100	88200	133300	2024-11-26
237	2021	45100	88200	133300	2024-11-26
238	2023	149100	133300	282400	2024-11-26
238	2022	149100	133300	282400	2024-11-26
238	2021	149100	133300	282400	2024-11-26
241	2023	62700	719400	782100	2024-11-26
241	2022	143900	719400	863300	2024-11-26
241	2021	143900	719400	863300	2024-11-26
243	2023	0	9700	9700	2024-11-26
243	2022	0	9700	9700	2024-11-26
243	2021	0	9700	9700	2024-11-26
244	2023	0	800	800	2024-11-26
244	2022	0	800	800	2024-11-26
244	2021	0	800	800	2024-11-26
245	2023	193200	115700	308900	2024-11-26
245	2022	193200	115700	308900	2024-11-26
245	2021	193200	115700	308900	2024-11-26
246	2023	0	300300	300300	2024-11-26
246	2022	0	300300	300300	2024-11-26
246	2021	0	300300	300300	2024-11-26
247	2023	13400	149200	162600	2024-11-26
247	2022	13400	149200	162600	2024-11-26
247	2021	13400	149200	162600	2024-11-26
248	2023	126300	137700	264000	2024-11-26
248	2022	126300	137700	264000	2024-11-26
248	2021	126300	137700	264000	2024-11-26
249	2023	155900	144300	300200	2024-11-26
249	2022	155900	144300	300200	2024-11-26
249	2021	155900	144300	300200	2024-11-26
250	2023	0	341700	341700	2024-11-26
250	2022	0	341700	341700	2024-11-26
250	2021	0	341700	341700	2024-11-26
251	2023	367000	349100	716100	2024-11-26
251	2022	367000	349100	716100	2024-11-26
251	2021	367000	349100	716100	2024-11-26
252	2023	176700	251500	428200	2024-11-26
252	2022	176700	251500	428200	2024-11-26
252	2021	176700	251500	428200	2024-11-26
253	2023	212100	150400	362500	2024-11-26
253	2022	212100	150400	362500	2024-11-26
253	2021	212100	150400	362500	2024-11-26
254	2023	356800	460900	817700	2024-11-26
254	2022	356800	460900	817700	2024-11-26
254	2021	356800	460900	817700	2024-11-26
255	2023	523800	129400	653200	2024-11-26
255	2022	471100	129400	600500	2024-11-26
255	2021	435400	129400	564800	2024-11-26
256	2023	1367900	364300	1732200	2024-11-26
256	2022	1367900	364300	1732200	2024-11-26
256	2021	1367900	364300	1732200	2024-11-26
257	2023	56900	130700	187600	2024-11-26
257	2022	56900	130700	187600	2024-11-26
257	2021	56900	130700	187600	2024-11-26
258	2023	378800	0	378800	2024-11-26
258	2022	378800	0	378800	2024-11-26
258	2021	378800	0	378800	2024-11-26
259	2023	2454700	592700	3047400	2024-11-26
259	2022	2454700	592700	3047400	2024-11-26
259	2021	2454700	592700	3047400	2024-11-26
260	2023	82600	164500	247100	2024-11-26
260	2022	82600	164500	247100	2024-11-26
260	2021	82600	164500	247100	2024-11-26
267	2023	66900	122600	189500	2024-11-26
267	2022	66900	122600	189500	2024-11-26
267	2021	66900	122600	189500	2024-11-26
270	2023	54400	117800	172200	2024-11-26
270	2022	54400	117800	172200	2024-11-26
270	2021	54400	117800	172200	2024-11-26
271	2023	293800	127600	421400	2024-11-26
271	2022	293800	127600	421400	2024-11-26
271	2021	293800	127600	421400	2024-11-26
272	2023	0	11300	11300	2024-11-26
272	2022	0	11300	11300	2024-11-26
272	2021	0	11300	11300	2024-11-26
273	2023	32800	100700	133500	2024-11-26
273	2022	32800	100700	133500	2024-11-26
273	2021	32800	100700	133500	2024-11-26
274	2023	230700	139000	369700	2024-11-26
274	2022	230700	139000	369700	2024-11-26
274	2021	230700	139000	369700	2024-11-26
275	2023	15500	109800	125300	2024-11-26
275	2022	15500	109800	125300	2024-11-26
275	2021	30200	109800	140000	2024-11-26
276	2023	133100	173400	306500	2024-11-26
276	2022	133100	173400	306500	2024-11-26
276	2021	133100	173400	306500	2024-11-26
277	2023	0	58200	58200	2024-11-26
277	2022	0	58200	58200	2024-11-26
277	2021	0	58200	58200	2024-11-26
278	2023	147100	303100	450200	2024-11-26
278	2022	147100	303100	450200	2024-11-26
278	2021	159300	313600	472900	2024-11-26
279	2023	161300	176800	338100	2024-11-26
279	2022	161300	176800	338100	2024-11-26
279	2021	161300	176800	338100	2024-11-26
280	2023	0	431500	431500	2024-11-26
280	2022	0	431500	431500	2024-11-26
280	2021	0	431500	431500	2024-11-26
283	2023	25500	171600	197100	2024-11-26
283	2022	25500	171600	197100	2024-11-26
283	2021	25500	171600	197100	2024-11-26
287	2023	566500	297100	863600	2024-11-26
287	2022	566500	297100	863600	2024-11-26
287	2021	566500	297100	863600	2024-11-26
288	2023	245600	328100	573700	2024-11-26
288	2022	245600	328100	573700	2024-11-26
288	2021	245600	328100	573700	2024-11-26
290	2023	618200	454000	1072200	2024-11-26
290	2022	618200	454000	1072200	2024-11-26
290	2021	618200	454000	1072200	2024-11-26
291	2023	0	139200	139200	2024-11-26
291	2022	0	139200	139200	2024-11-26
291	2021	0	139200	139200	2024-11-26
292	2023	376400	569300	945700	2024-11-26
292	2022	($18,800)	569300	550500	2024-11-26
292	2021	376400	569300	945700	2024-11-26
294	2023	411100	386400	797500	2024-11-26
294	2022	411100	386400	797500	2024-11-26
294	2021	411100	386400	797500	2024-11-26
295	2023	132400	104100	236500	2024-11-26
295	2022	132400	104100	236500	2024-11-26
295	2021	132400	104100	236500	2024-11-26
296	2023	131100	0	131100	2024-11-26
296	2022	131100	0	131100	2024-11-26
296	2021	131100	0	131100	2024-11-26
297	2023	40800	88400	129200	2024-11-26
297	2022	40800	88400	129200	2024-11-26
297	2021	40800	88400	129200	2024-11-26
298	2023	168100	118200	286300	2024-11-26
298	2022	168100	118200	286300	2024-11-26
298	2021	168100	118200	286300	2024-11-26
299	2023	108200	133400	241600	2024-11-26
299	2022	108200	133400	241600	2024-11-26
299	2021	108200	133400	241600	2024-11-26
300	2023	116500	93400	209900	2024-11-26
300	2022	116500	93400	209900	2024-11-26
300	2021	116500	93400	209900	2024-11-26
301	2023	197200	235000	432200	2024-11-26
301	2022	197200	235000	432200	2024-11-26
301	2021	197200	235000	432200	2024-11-26
303	2023	392100	179200	571300	2024-11-26
303	2022	392100	179200	571300	2024-11-26
303	2021	392100	179200	571300	2024-11-26
306	2023	252100	220000	472100	2024-11-26
306	2022	252100	220000	472100	2024-11-26
306	2021	254500	220000	474500	2024-11-26
307	2023	498100	362500	860600	2024-11-26
307	2022	498100	362500	860600	2024-11-26
307	2021	498100	362500	860600	2024-11-26
308	2023	280100	196600	476700	2024-11-26
308	2022	280100	196600	476700	2024-11-26
308	2021	280100	196600	476700	2024-11-26
309	2023	283000	571900	854900	2024-11-26
309	2022	283000	571900	854900	2024-11-26
309	2021	283000	571900	854900	2024-11-26
310	2023	511300	244800	756100	2024-11-26
310	2022	511300	244800	756100	2024-11-26
310	2021	511300	244800	756100	2024-11-26
311	2023	0	637800	637800	2024-11-26
311	2022	0	637800	637800	2024-11-26
311	2021	0	637800	637800	2024-11-26
313	2023	675600	661400	1337000	2024-11-26
313	2022	675600	661400	1337000	2024-11-26
313	2021	675600	661400	1337000	2024-11-26
315	2023	484200	174900	659100	2024-11-26
315	2022	484200	174900	659100	2024-11-26
315	2021	484200	174900	659100	2024-11-26
316	2023	229500	180700	410200	2024-11-26
316	2022	229500	180700	410200	2024-11-26
316	2021	229500	180700	410200	2024-11-26
317	2023	361800	152900	514700	2024-11-26
317	2022	361800	152900	514700	2024-11-26
317	2021	361800	152900	514700	2024-11-26
319	2023	381800	222900	604700	2024-11-26
319	2022	381800	222900	604700	2024-11-26
319	2021	381800	222900	604700	2024-11-26
320	2023	0	433100	433100	2024-11-26
320	2022	0	433100	433100	2024-11-26
320	2021	0	433100	433100	2024-11-26
321	2023	74900	140500	215400	2024-11-26
321	2022	74900	140500	215400	2024-11-26
321	2021	74900	140500	215400	2024-11-26
322	2023	0	273200	273200	2024-11-26
322	2022	0	273200	273200	2024-11-26
322	2021	0	273200	273200	2024-11-26
323	2023	150100	143800	293900	2024-11-26
323	2022	150100	143800	293900	2024-11-26
323	2021	149300	143800	293100	2024-11-26
324	2023	319900	137800	457700	2024-11-26
324	2022	319900	137800	457700	2024-11-26
324	2021	319900	137800	457700	2024-11-26
325	2023	750700	251100	1001800	2024-11-26
325	2022	750700	251100	1001800	2024-11-26
325	2021	750700	251100	1001800	2024-11-26
326	2023	327800	180100	507900	2024-11-26
326	2022	327800	180100	507900	2024-11-26
326	2021	327800	180100	507900	2024-11-26
327	2023	266500	153200	419700	2024-11-26
327	2022	252500	153200	405700	2024-11-26
327	2021	244400	153200	397600	2024-11-26
328	2023	178800	161000	339800	2024-11-26
328	2022	178800	161000	339800	2024-11-26
328	2021	178800	161000	339800	2024-11-26
329	2023	113100	93200	206300	2024-11-26
329	2022	110800	93200	204000	2024-11-26
329	2021	130800	93200	224000	2024-11-26
330	2023	216200	201200	417400	2024-11-26
330	2022	216200	201200	417400	2024-11-26
330	2021	228000	201200	429200	2024-11-26
331	2023	62500	131800	194300	2024-11-26
331	2022	62500	131800	194300	2024-11-26
331	2021	62500	131800	194300	2024-11-26
333	2023	0	15700	15700	2024-11-26
333	2022	0	15700	15700	2024-11-26
333	2021	0	15700	15700	2024-11-26
334	2023	459600	318400	778000	2024-11-26
334	2022	459600	318400	778000	2024-11-26
334	2021	459600	318400	778000	2024-11-26
335	2023	130700	157100	287800	2024-11-26
335	2022	103500	157100	260600	2024-11-26
335	2021	103500	157100	260600	2024-11-26
336	2023	210700	158300	369000	2024-11-26
336	2022	210700	158300	369000	2024-11-26
336	2021	210700	158300	369000	2024-11-26
337	2023	630400	197400	827800	2024-11-26
337	2022	630400	197400	827800	2024-11-26
337	2021	630400	197400	827800	2024-11-26
339	2023	153000	140300	293300	2024-11-26
339	2022	153000	140300	293300	2024-11-26
339	2021	153000	140300	293300	2024-11-26
340	2023	382600	176700	559300	2024-11-26
340	2022	382600	176700	559300	2024-11-26
340	2021	389200	199000	588200	2024-11-26
341	2023	198000	123800	321800	2024-11-26
341	2022	191600	123800	315400	2024-11-26
341	2021	191600	123800	315400	2024-11-26
343	2023	238400	197200	435600	2024-11-26
343	2022	238400	197200	435600	2024-11-26
343	2021	238400	197200	435600	2024-11-26
344	2023	265500	504500	770000	2024-11-26
344	2022	265500	504500	770000	2024-11-26
344	2021	265500	504500	770000	2024-11-26
345	2023	288300	153300	441600	2024-11-26
345	2022	288300	153300	441600	2024-11-26
345	2021	288300	153300	441600	2024-11-26
346	2023	256900	159200	416100	2024-11-26
346	2022	256900	159200	416100	2024-11-26
346	2021	256900	159200	416100	2024-11-26
347	2023	8800	293500	302300	2024-11-26
347	2022	8800	293500	302300	2024-11-26
347	2021	8800	293500	302300	2024-11-26
348	2023	287400	149400	436800	2024-11-26
348	2022	287400	149400	436800	2024-11-26
348	2021	287400	149400	436800	2024-11-26
349	2023	0	102600	102600	2024-11-26
349	2022	0	102600	102600	2024-11-26
349	2021	0	102600	102600	2024-11-26
350	2023	0	52200	52200	2024-11-26
350	2022	0	52200	52200	2024-11-26
350	2021	0	52200	52200	2024-11-26
351	2023	284700	148900	433600	2024-11-26
351	2022	284700	148900	433600	2024-11-26
351	2021	284700	148900	433600	2024-11-26
355	2023	0	330300	330300	2024-11-26
355	2022	0	330300	330300	2024-11-26
355	2021	0	330300	330300	2024-11-26
357	2023	0	159000	159000	2024-11-26
357	2022	0	159000	159000	2024-11-26
357	2021	0	159000	159000	2024-11-26
358	2023	0	9300	9300	2024-11-26
358	2022	0	9300	9300	2024-11-26
358	2021	0	9300	9300	2024-11-26
359	2023	92400	135100	227500	2024-11-26
359	2022	92400	135100	227500	2024-11-26
359	2021	92400	135100	227500	2024-11-26
360	2023	128100	101800	229900	2024-11-26
360	2022	128100	101800	229900	2024-11-26
360	2021	128100	101800	229900	2024-11-26
361	2023	344600	367400	712000	2024-11-26
361	2022	344600	367400	712000	2024-11-26
361	2021	344600	367400	712000	2024-11-26
363	2023	392400	128100	520500	2024-11-26
363	2022	392400	128100	520500	2024-11-26
363	2021	391000	128100	519100	2024-11-26
364	2023	114400	98300	212700	2024-11-26
364	2022	114400	98300	212700	2024-11-26
364	2021	114400	98300	212700	2024-11-26
365	2023	544900	502900	1047800	2024-11-26
365	2022	544900	502900	1047800	2024-11-26
365	2021	544900	502900	1047800	2024-11-26
368	2023	242900	111700	354600	2024-11-26
368	2022	242900	111700	354600	2024-11-26
368	2021	242900	111700	354600	2024-11-26
369	2023	477100	445900	923000	2024-11-26
369	2022	477100	445900	923000	2024-11-26
369	2021	477100	445900	923000	2024-11-26
370	2023	0	312000	312000	2024-11-26
370	2022	0	312000	312000	2024-11-26
370	2021	0	312000	312000	2024-11-26
371	2023	342300	166800	509100	2024-11-26
371	2022	342300	166800	509100	2024-11-26
371	2021	342300	166800	509100	2024-11-26
372	2023	219900	208700	428600	2024-11-26
372	2022	219900	208700	428600	2024-11-26
372	2021	219900	208700	428600	2024-11-26
375	2023	0	244100	244100	2024-11-26
375	2022	0	244100	244100	2024-11-26
375	2021	0	303100	303100	2024-11-26
376	2023	387900	326200	714100	2024-11-26
376	2022	387900	326200	714100	2024-11-26
376	2021	387900	326200	714100	2024-11-26
377	2023	34900	462600	497500	2024-11-26
377	2022	34900	462600	497500	2024-11-26
377	2021	34900	462600	497500	2024-11-26
378	2023	345600	142700	488300	2024-11-26
378	2022	345600	142700	488300	2024-11-26
378	2021	345600	142700	488300	2024-11-26
379	2023	65300	118000	183300	2024-11-26
379	2022	65300	118000	183300	2024-11-26
379	2021	60600	118000	178600	2024-11-26
380	2023	184800	157400	342200	2024-11-26
380	2022	184800	157400	342200	2024-11-26
380	2021	184800	157400	342200	2024-11-26
381	2023	73000	107800	180800	2024-11-26
381	2022	73000	107800	180800	2024-11-26
381	2021	73000	107800	180800	2024-11-26
382	2023	150900	158900	309800	2024-11-26
382	2022	150900	158900	309800	2024-11-26
382	2021	150900	158900	309800	2024-11-26
383	2023	0	376700	376700	2024-11-26
383	2022	0	376700	376700	2024-11-26
383	2021	0	376700	376700	2024-11-26
384	2023	115100	446700	561800	2024-11-26
384	2022	115100	446700	561800	2024-11-26
384	2021	115100	446700	561800	2024-11-26
385	2023	285900	172600	458500	2024-11-26
385	2022	285900	172600	458500	2024-11-26
385	2021	285900	172600	458500	2024-11-26
387	2023	0	32300	32300	2024-11-26
387	2022	0	32300	32300	2024-11-26
387	2021	0	32300	32300	2024-11-26
388	2023	0	73500	73500	2024-11-26
388	2022	0	73500	73500	2024-11-26
388	2021	0	73500	73500	2024-11-26
389	2023	267800	112600	380400	2024-11-26
389	2022	267800	112600	380400	2024-11-26
389	2021	267800	112600	380400	2024-11-26
390	2023	0	454600	454600	2024-11-26
390	2022	0	454600	454600	2024-11-26
390	2021	0	454600	454600	2024-11-26
391	2023	113000	321300	434300	2024-11-26
391	2022	147800	321300	469100	2024-11-26
391	2021	147800	321300	469100	2024-11-26
392	2023	490000	360400	850400	2024-11-26
392	2022	490000	360400	850400	2024-11-26
392	2021	490100	360300	850400	2024-11-26
394	2023	371100	355400	726500	2024-11-26
394	2022	371100	355400	726500	2024-11-26
394	2021	371100	355400	726500	2024-11-26
395	2023	332100	335700	667800	2024-11-26
395	2022	332100	335700	667800	2024-11-26
395	2021	319100	335700	654800	2024-11-26
398	2023	777200	1621300	2398500	2024-11-26
398	2022	777200	1621300	2398500	2024-11-26
398	2021	777200	1621300	2398500	2024-11-26
399	2023	354400	297700	652100	2024-11-26
399	2022	354400	297700	652100	2024-11-26
399	2021	352100	297700	649800	2024-11-26
400	2023	339100	163100	502200	2024-11-26
400	2022	339100	163100	502200	2024-11-26
400	2021	339100	163100	502200	2024-11-26
401	2023	0	1188900	1188900	2024-11-26
401	2022	0	1188900	1188900	2024-11-26
401	2021	0	1188900	1188900	2024-11-26
402	2023	1367100	1205000	2572100	2024-11-26
402	2022	1367100	1205000	2572100	2024-11-26
402	2021	1367100	1205000	2572100	2024-11-26
405	2023	146300	143300	289600	2024-11-26
405	2022	146300	143300	289600	2024-11-26
405	2021	147800	143300	291100	2024-11-26
407	2023	0	420900	420900	2024-11-26
407	2022	0	420900	420900	2024-11-26
407	2021	0	420900	420900	2024-11-26
408	2023	171500	148500	320000	2024-11-26
408	2022	171500	148500	320000	2024-11-26
408	2021	171500	148500	320000	2024-11-26
415	2023	242800	371700	614500	2024-11-26
415	2022	242800	371700	614500	2024-11-26
415	2021	242800	371700	614500	2024-11-26
417	2023	34800	608700	643500	2024-11-26
417	2022	34800	608700	643500	2024-11-26
417	2021	34800	608700	643500	2024-11-26
418	2023	432100	205700	637800	2024-11-26
418	2022	432100	205700	637800	2024-11-26
418	2021	442900	205700	648600	2024-11-26
427	2023	317000	162800	479800	2024-11-26
427	2022	317000	162800	479800	2024-11-26
427	2021	317000	162800	479800	2024-11-26
429	2023	555500	262800	818300	2024-11-26
429	2022	553700	262800	816500	2024-11-26
429	2021	553700	262800	816500	2024-11-26
432	2023	0	23700	23700	2024-11-26
432	2022	0	23700	23700	2024-11-26
432	2021	0	23700	23700	2024-11-26
433	2023	37700	104500	142200	2024-11-26
433	2022	37700	104500	142200	2024-11-26
433	2021	37700	104500	142200	2024-11-26
434	2023	58600	184300	242900	2024-11-26
434	2022	58600	184300	242900	2024-11-26
434	2021	58600	184300	242900	2024-11-26
435	2023	104100	221200	325300	2024-11-26
435	2022	104100	221200	325300	2024-11-26
435	2021	104100	221200	325300	2024-11-26
436	2023	57700	187000	244700	2024-11-26
436	2022	57700	187000	244700	2024-11-26
436	2021	60300	205800	266100	2024-11-26
437	2023	682800	378100	1060900	2024-11-26
437	2022	682800	378100	1060900	2024-11-26
437	2021	674600	378100	1052700	2024-11-26
438	2023	308800	261700	570500	2024-11-26
438	2022	308800	261700	570500	2024-11-26
438	2021	308800	261700	570500	2024-11-26
439	2023	0	6400	6400	2024-11-26
439	2022	0	6400	6400	2024-11-26
439	2021	0	6400	6400	2024-11-26
440	2023	53000	228900	281900	2024-11-26
440	2022	53000	228900	281900	2024-11-26
440	2021	53000	228900	281900	2024-11-26
441	2023	404100	455200	859300	2024-11-26
441	2022	404100	455200	859300	2024-11-26
441	2021	393000	455200	848200	2024-11-26
442	2023	229500	196700	426200	2024-11-26
442	2022	229500	196700	426200	2024-11-26
442	2021	229500	196700	426200	2024-11-26
446	2023	421000	344100	765100	2024-11-26
446	2022	417800	344100	761900	2024-11-26
446	2021	417800	344100	761900	2024-11-26
447	2023	191200	228500	419700	2024-11-26
447	2022	191200	228500	419700	2024-11-26
447	2021	191200	228500	419700	2024-11-26
448	2023	396900	307500	704400	2024-11-26
448	2022	396900	307500	704400	2024-11-26
448	2021	396900	307500	704400	2024-11-26
450	2023	561400	1063100	1624500	2024-11-26
450	2022	561400	1063100	1624500	2024-11-26
450	2021	561400	1057000	1618400	2024-11-26
454	2023	586600	840000	1426600	2024-11-26
454	2022	586600	840000	1426600	2024-11-26
454	2021	586400	840000	1426400	2024-11-26
457	2023	818800	409400	1228200	2024-11-26
457	2022	818800	409400	1228200	2024-11-26
457	2021	818800	409400	1228200	2024-11-26
458	2023	234800	272600	507400	2024-11-26
458	2022	234800	272600	507400	2024-11-26
458	2021	234800	272600	507400	2024-11-26
459	2023	293400	192000	485400	2024-11-26
459	2022	293400	192000	485400	2024-11-26
459	2021	293400	192000	485400	2024-11-26
460	2023	479100	279000	758100	2024-11-26
460	2022	479100	279000	758100	2024-11-26
460	2021	479100	279000	758100	2024-11-26
461	2023	714600	311800	1026400	2024-11-26
461	2022	714600	311800	1026400	2024-11-26
461	2021	673400	311800	985200	2024-11-26
462	2023	544600	246100	790700	2024-11-26
462	2022	544600	246100	790700	2024-11-26
462	2021	544600	246100	790700	2024-11-26
463	2023	0	372200	372200	2024-11-26
463	2022	0	372200	372200	2024-11-26
463	2021	0	372200	372200	2024-11-26
465	2023	0	250900	250900	2024-11-26
465	2022	0	250900	250900	2024-11-26
465	2021	0	250900	250900	2024-11-26
469	2023	725500	271500	997000	2024-11-26
469	2022	725500	271500	997000	2024-11-26
469	2021	725500	271500	997000	2024-11-26
472	2023	715000	241600	956600	2024-11-26
472	2022	715000	241600	956600	2024-11-26
472	2021	715000	241600	956600	2024-11-26
473	2023	535100	210400	745500	2024-11-26
473	2022	535100	210400	745500	2024-11-26
473	2021	535100	210400	745500	2024-11-26
474	2023	358800	200000	558800	2024-11-26
474	2022	358800	200000	558800	2024-11-26
474	2021	358800	200000	558800	2024-11-26
475	2023	472000	379600	851600	2024-11-26
475	2022	472000	379600	851600	2024-11-26
475	2021	472000	379600	851600	2024-11-26
476	2023	1080000	376800	1456800	2024-11-26
476	2022	285600	334600	620200	2024-11-26
476	2021	285600	334600	620200	2024-11-26
478	2023	270800	522200	793000	2024-11-26
478	2022	270800	522200	793000	2024-11-26
478	2021	270800	522200	793000	2024-11-26
479	2023	750500	609400	1359900	2024-11-26
479	2022	750500	609400	1359900	2024-11-26
479	2021	750500	609400	1359900	2024-11-26
480	2023	233500	232000	465500	2024-11-26
480	2022	233500	232000	465500	2024-11-26
480	2021	247100	232000	479100	2024-11-26
482	2023	308300	229800	538100	2024-11-26
482	2022	308300	229800	538100	2024-11-26
482	2021	308300	229800	538100	2024-11-26
483	2023	0	700	700	2024-11-26
483	2022	0	700	700	2024-11-26
483	2021	0	700	700	2024-11-26
484	2023	431700	182200	613900	2024-11-26
484	2022	431700	182200	613900	2024-11-26
484	2021	431700	182200	613900	2024-11-26
486	2023	367800	218100	585900	2024-11-26
486	2022	367800	218100	585900	2024-11-26
486	2021	367800	218100	585900	2024-11-26
487	2023	170800	180000	350800	2024-11-26
487	2022	165100	180000	345100	2024-11-26
487	2021	165100	180000	345100	2024-11-26
488	2023	314900	248800	563700	2024-11-26
488	2022	309400	248800	558200	2024-11-26
488	2021	309400	248800	558200	2024-11-26
489	2023	225500	253700	479200	2024-11-26
489	2022	225500	253700	479200	2024-11-26
489	2021	225500	253700	479200	2024-11-26
490	2023	289700	211700	501400	2024-11-26
490	2022	289700	211700	501400	2024-11-26
490	2021	289700	211700	501400	2024-11-26
491	2023	311300	608300	919600	2024-11-26
491	2022	311300	608300	919600	2024-11-26
491	2021	311300	608300	919600	2024-11-26
492	2023	146800	198600	345400	2024-11-26
492	2022	146800	198600	345400	2024-11-26
492	2021	124500	198600	323100	2024-11-26
493	2023	442700	693200	1135900	2024-11-26
493	2022	442700	693200	1135900	2024-11-26
493	2021	442700	693200	1135900	2024-11-26
494	2023	978200	559900	1538100	2024-11-26
494	2022	978200	559900	1538100	2024-11-26
494	2021	978200	559900	1538100	2024-11-26
495	2023	308000	314900	622900	2024-11-26
495	2022	308000	333700	641700	2024-11-26
495	2021	308000	333700	641700	2024-11-26
501	2023	63500	199300	262800	2024-11-26
501	2022	63500	199300	262800	2024-11-26
501	2021	63500	199300	262800	2024-11-26
505	2023	704800	688900	1393700	2024-11-26
505	2022	704800	688900	1393700	2024-11-26
505	2021	704800	688900	1393700	2024-11-26
506	2023	580400	356800	937200	2024-11-26
506	2022	580400	356800	937200	2024-11-26
506	2021	580400	356800	937200	2024-11-26
507	2023	($43,300)	653800	610500	2024-11-26
507	2022	($43,300)	653800	610500	2024-11-26
507	2021	326000	653800	979800	2024-11-26
509	2023	339400	260800	600200	2024-11-26
509	2022	339400	260800	600200	2024-11-26
509	2021	339400	260800	600200	2024-11-26
510	2023	406200	343100	749300	2024-11-26
510	2022	406200	343100	749300	2024-11-26
510	2021	406200	343100	749300	2024-11-26
511	2023	196100	212500	408600	2024-11-26
511	2022	196100	212500	408600	2024-11-26
511	2021	196100	212500	408600	2024-11-26
512	2023	0	265100	265100	2024-11-26
512	2022	0	265100	265100	2024-11-26
512	2021	0	265100	265100	2024-11-26
513	2023	275900	214600	490500	2024-11-26
513	2022	275900	214600	490500	2024-11-26
513	2021	275900	214600	490500	2024-11-26
514	2023	365300	357000	722300	2024-11-26
514	2022	365300	357000	722300	2024-11-26
514	2021	365300	357000	722300	2024-11-26
515	2023	173600	187700	361300	2024-11-26
515	2022	173600	187700	361300	2024-11-26
515	2021	173600	187700	361300	2024-11-26
517	2023	387600	281800	669400	2024-11-26
517	2022	331700	281800	613500	2024-11-26
517	2021	331700	281800	613500	2024-11-26
518	2023	290800	217800	508600	2024-11-26
518	2022	290800	217800	508600	2024-11-26
518	2021	290800	217800	508600	2024-11-26
519	2023	142100	156900	299000	2024-11-26
519	2022	142100	156900	299000	2024-11-26
519	2021	142100	156900	299000	2024-11-26
520	2023	512800	204900	717700	2024-11-26
520	2022	482800	204900	687700	2024-11-26
520	2021	482800	204900	687700	2024-11-26
522	2023	133200	162100	295300	2024-11-26
522	2022	133200	162100	295300	2024-11-26
522	2021	133200	162100	295300	2024-11-26
526	2023	133300	217300	350600	2024-11-26
526	2022	133300	217300	350600	2024-11-26
526	2021	133300	217300	350600	2024-11-26
527	2023	312700	207400	520100	2024-11-26
527	2022	312700	207400	520100	2024-11-26
527	2021	312700	207400	520100	2024-11-26
529	2023	159300	181700	341000	2024-11-26
529	2022	159300	181700	341000	2024-11-26
529	2021	159300	181700	341000	2024-11-26
530	2023	458500	301900	760400	2024-11-26
530	2022	458500	301900	760400	2024-11-26
530	2021	458500	301900	760400	2024-11-26
532	2023	58700	182400	241100	2024-11-26
532	2022	58700	182400	241100	2024-11-26
532	2021	58700	182400	241100	2024-11-26
533	2023	561200	270000	831200	2024-11-26
533	2022	561200	270000	831200	2024-11-26
533	2021	561200	270000	831200	2024-11-26
537	2023	544100	312100	856200	2024-11-26
537	2022	544100	312100	856200	2024-11-26
537	2021	544100	312100	856200	2024-11-26
538	2023	379300	259400	638700	2024-11-26
538	2022	379300	259400	638700	2024-11-26
538	2021	377000	259400	636400	2024-11-26
540	2023	296800	300900	597700	2024-11-26
540	2022	296800	300900	597700	2024-11-26
540	2021	296800	300900	597700	2024-11-26
542	2023	184300	147700	332000	2024-11-26
542	2022	184300	147700	332000	2024-11-26
542	2021	177800	147700	325500	2024-11-26
543	2023	0	54100	54100	2024-11-26
543	2022	0	54100	54100	2024-11-26
543	2021	0	54100	54100	2024-11-26
544	2023	62700	171200	233900	2024-11-26
544	2022	62700	171200	233900	2024-11-26
544	2021	62700	171200	233900	2024-11-26
545	2023	119600	168200	287800	2024-11-26
545	2022	109800	168200	278000	2024-11-26
545	2021	102700	168200	270900	2024-11-26
546	2023	115400	217500	332900	2024-11-26
546	2022	115400	217500	332900	2024-11-26
546	2021	115400	217500	332900	2024-11-26
547	2023	175800	185500	361300	2024-11-26
547	2022	175800	185500	361300	2024-11-26
547	2021	175800	185500	361300	2024-11-26
552	2023	3600	276400	280000	2024-11-26
552	2022	3600	276400	280000	2024-11-26
552	2021	3600	276400	280000	2024-11-26
557	2023	114900	203800	318700	2024-11-26
557	2022	114900	203800	318700	2024-11-26
557	2021	114900	203800	318700	2024-11-26
558	2023	45800	161200	207000	2024-11-26
558	2022	45800	161200	207000	2024-11-26
558	2021	45800	161200	207000	2024-11-26
559	2023	300300	270400	570700	2024-11-26
559	2022	300300	270400	570700	2024-11-26
559	2021	300300	270400	570700	2024-11-26
560	2023	123400	162900	286300	2024-11-26
560	2022	123400	162900	286300	2024-11-26
560	2021	123400	162900	286300	2024-11-26
561	2023	0	12200	12200	2024-11-26
561	2022	0	12200	12200	2024-11-26
561	2021	0	12200	12200	2024-11-26
563	2023	344200	236700	580900	2024-11-26
563	2022	344200	236700	580900	2024-11-26
563	2021	344200	236700	580900	2024-11-26
564	2023	544200	657500	1201700	2024-11-26
564	2022	497800	657500	1155300	2024-11-26
564	2021	497800	657500	1155300	2024-11-26
565	2023	247800	332200	580000	2024-11-26
565	2022	247800	332200	580000	2024-11-26
565	2021	247800	332200	580000	2024-11-26
569	2023	728700	508400	1237100	2024-11-26
569	2022	730600	508400	1239000	2024-11-26
569	2021	732700	508400	1241100	2024-11-26
570	2023	184400	577900	762300	2024-11-26
570	2022	184400	577900	762300	2024-11-26
570	2021	184400	578000	762400	2024-11-26
571	2023	169100	180000	349100	2024-11-26
571	2022	169100	180000	349100	2024-11-26
571	2021	169100	180000	349100	2024-11-26
572	2023	155200	183900	339100	2024-11-26
572	2022	155200	183900	339100	2024-11-26
572	2021	181000	183900	364900	2024-11-26
575	2023	796700	1024700	1821400	2024-11-26
575	2022	862000	1131400	1993400	2024-11-26
575	2021	862000	1131400	1993400	2024-11-26
576	2023	2084100	1274800	3358900	2024-11-26
576	2022	2084100	1274800	3358900	2024-11-26
576	2021	2084100	1349300	3433400	2024-11-26
578	2023	881300	822200	1703500	2024-11-26
578	2022	881300	822200	1703500	2024-11-26
578	2021	881300	1036100	1917400	2024-11-26
579	2023	443300	267200	710500	2024-11-26
579	2022	443300	267200	710500	2024-11-26
579	2021	443300	267200	710500	2024-11-26
580	2023	0	19300	19300	2024-11-26
580	2022	0	19300	19300	2024-11-26
580	2021	0	19300	19300	2024-11-26
581	2023	174700	567800	742500	2024-11-26
581	2022	174700	567800	742500	2024-11-26
581	2021	169200	567800	737000	2024-11-26
582	2023	1765300	671400	2436700	2024-11-26
582	2022	1700400	671400	2371800	2024-11-26
582	2021	971900	671400	1643300	2024-11-26
584	2023	561900	531100	1093000	2024-11-26
584	2022	561900	531100	1093000	2024-11-26
584	2021	561900	531100	1093000	2024-11-26
591	2023	0	346300	346300	2024-11-26
591	2022	0	346300	346300	2024-11-26
591	2021	0	346300	346300	2024-11-26
592	2023	0	190200	190200	2024-11-26
592	2022	0	190200	190200	2024-11-26
592	2021	0	190200	190200	2024-11-26
593	2023	234800	372000	606800	2024-11-26
593	2022	234800	372000	606800	2024-11-26
593	2021	234800	372000	606800	2024-11-26
594	2023	541800	257000	798800	2024-11-26
594	2022	541800	257000	798800	2024-11-26
594	2021	541800	257000	798800	2024-11-26
597	2023	689900	399500	1089400	2024-11-26
597	2022	689900	399500	1089400	2024-11-26
597	2021	689900	399500	1089400	2024-11-26
598	2023	0	35000	35000	2024-11-26
598	2022	0	35000	35000	2024-11-26
598	2021	0	35000	35000	2024-11-26
600	2023	133000	128800	261800	2024-11-26
600	2022	133000	128800	261800	2024-11-26
600	2021	133000	128800	261800	2024-11-26
603	2023	0	238800	238800	2024-11-26
603	2022	0	250000	250000	2024-11-26
603	2021	0	250000	250000	2024-11-26
605	2023	189700	133300	323000	2024-11-26
605	2022	189700	133300	323000	2024-11-26
605	2021	189700	133300	323000	2024-11-26
607	2023	243800	191800	435600	2024-11-26
607	2022	243800	191800	435600	2024-11-26
607	2021	243800	191800	435600	2024-11-26
611	2023	672000	460500	1132500	2024-11-26
611	2022	672000	460500	1132500	2024-11-26
611	2021	672000	460500	1132500	2024-11-26
616	2023	403700	153200	556900	2024-11-26
616	2022	403700	153200	556900	2024-11-26
616	2021	403700	153200	556900	2024-11-26
617	2023	175400	155200	330600	2024-11-26
617	2022	175400	155200	330600	2024-11-26
617	2021	153300	155200	308500	2024-11-26
618	2023	111400	505700	617100	2024-11-26
618	2022	83100	280100	363200	2024-11-26
618	2021	83100	280100	363200	2024-11-26
620	2023	0	70300	70300	2024-11-26
620	2022	0	70300	70300	2024-11-26
620	2021	0	70300	70300	2024-11-26
621	2023	147500	203200	350700	2024-11-26
621	2022	147500	203200	350700	2024-11-26
621	2021	147400	203200	350600	2024-11-26
622	2023	97700	138300	236000	2024-11-26
622	2022	97700	138300	236000	2024-11-26
622	2021	97700	138300	236000	2024-11-26
623	2023	89500	210200	299700	2024-11-26
623	2022	89500	210200	299700	2024-11-26
623	2021	89500	210200	299700	2024-11-26
624	2023	301300	291700	593000	2024-11-26
624	2022	301300	291700	593000	2024-11-26
624	2021	301300	291700	593000	2024-11-26
625	2023	553700	220500	774200	2024-11-26
625	2022	553700	220500	774200	2024-11-26
625	2021	553700	220500	774200	2024-11-26
626	2023	428100	297700	725800	2024-11-26
626	2022	428100	297700	725800	2024-11-26
626	2021	428100	297700	725800	2024-11-26
627	2023	0	32700	32700	2024-11-26
627	2022	0	32700	32700	2024-11-26
627	2021	0	32700	32700	2024-11-26
633	2023	0	585800	585800	2024-11-26
633	2022	0	585800	585800	2024-11-26
633	2021	0	585800	585800	2024-11-26
634	2023	0	287800	287800	2024-11-26
634	2022	0	287800	287800	2024-11-26
634	2021	0	287800	287800	2024-11-26
635	2023	0	4200	4200	2024-11-26
635	2022	0	4200	4200	2024-11-26
635	2021	0	4200	4200	2024-11-26
636	2023	0	4200	4200	2024-11-26
636	2022	0	4200	4200	2024-11-26
636	2021	0	4200	4200	2024-11-26
637	2023	228800	81000	309800	2024-11-26
637	2022	228800	81000	309800	2024-11-26
637	2021	228800	81000	309800	2024-11-26
638	2023	279300	245000	524300	2024-11-26
638	2022	279300	245000	524300	2024-11-26
638	2021	279300	245000	524300	2024-11-26
639	2023	1610400	809400	2419800	2024-11-26
639	2022	1610400	809400	2419800	2024-11-26
639	2021	1610400	809400	2419800	2024-11-26
643	2023	0	40400	40400	2024-11-26
643	2022	0	40400	40400	2024-11-26
643	2021	0	40400	40400	2024-11-26
645	2023	243400	133300	376700	2024-11-26
645	2022	243400	133300	376700	2024-11-26
645	2021	243400	133300	376700	2024-11-26
647	2023	30000	302800	332800	2024-11-26
647	2022	30000	302800	332800	2024-11-26
647	2021	30000	302800	332800	2024-11-26
648	2023	838300	492700	1331000	2024-11-26
648	2022	838300	492700	1331000	2024-11-26
648	2021	838300	492700	1331000	2024-11-26
649	2023	318500	254900	573400	2024-11-26
649	2022	318500	254900	573400	2024-11-26
649	2021	318500	254900	573400	2024-11-26
650	2023	183500	235400	418900	2024-11-26
650	2022	183500	235400	418900	2024-11-26
650	2021	183500	235400	418900	2024-11-26
651	2023	183300	278100	461400	2024-11-26
651	2022	183300	278100	461400	2024-11-26
651	2021	183300	278100	461400	2024-11-26
652	2023	23900	208300	232200	2024-11-26
652	2022	23900	208300	232200	2024-11-26
652	2021	23900	208300	232200	2024-11-26
653	2023	68500	262400	330900	2024-11-26
653	2022	68500	262400	330900	2024-11-26
653	2021	68500	262400	330900	2024-11-26
654	2023	107000	377200	484200	2024-11-26
654	2022	107000	377200	484200	2024-11-26
654	2021	107000	377200	484200	2024-11-26
655	2023	480400	433200	913600	2024-11-26
655	2022	480400	433200	913600	2024-11-26
655	2021	480400	433200	913600	2024-11-26
659	2023	0	13900	13900	2024-11-26
659	2022	0	13900	13900	2024-11-26
659	2021	0	13900	13900	2024-11-26
664	2023	55700	128400	184100	2024-11-26
664	2022	55700	128400	184100	2024-11-26
664	2021	55700	128400	184100	2024-11-26
667	2023	18200	100700	118900	2024-11-26
667	2022	18200	100700	118900	2024-11-26
667	2021	18200	100700	118900	2024-11-26
673	2023	44600	225800	270400	2024-11-26
673	2022	44600	225800	270400	2024-11-26
673	2021	44600	225800	270400	2024-11-26
675	2023	0	52400	52400	2024-11-26
675	2022	0	52400	52400	2024-11-26
675	2021	0	52400	52400	2024-11-26
686	2023	0	11600	11600	2024-11-26
686	2022	0	11600	11600	2024-11-26
686	2021	0	11600	11600	2024-11-26
688	2023	2600	47600	50200	2024-11-26
688	2022	2600	47600	50200	2024-11-26
688	2021	2600	47600	50200	2024-11-26
689	2023	281400	207100	488500	2024-11-26
689	2022	309800	207100	516900	2024-11-26
689	2021	301300	207100	508400	2024-11-26
690	2023	726400	200500	926900	2024-11-26
690	2022	726400	200500	926900	2024-11-26
690	2021	726400	200500	926900	2024-11-26
691	2023	400600	265800	666400	2024-11-26
691	2022	400600	265800	666400	2024-11-26
691	2021	400600	265800	666400	2024-11-26
692	2023	578500	227500	806000	2024-11-26
692	2022	578500	227500	806000	2024-11-26
692	2021	578500	227500	806000	2024-11-26
694	2023	192900	152200	345100	2024-11-26
694	2022	192900	152200	345100	2024-11-26
694	2021	191000	152200	343200	2024-11-26
695	2023	179300	193800	373100	2024-11-26
695	2022	179300	193800	373100	2024-11-26
695	2021	179300	193800	373100	2024-11-26
696	2023	324100	191200	515300	2024-11-26
696	2022	324100	191200	515300	2024-11-26
696	2021	301800	191200	493000	2024-11-26
697	2023	227900	214600	442500	2024-11-26
697	2022	227900	214600	442500	2024-11-26
697	2021	227900	214600	442500	2024-11-26
698	2023	486500	179200	665700	2024-11-26
698	2022	486500	179200	665700	2024-11-26
698	2021	486500	179200	665700	2024-11-26
700	2023	48900	77600	126500	2024-11-26
700	2022	48900	77600	126500	2024-11-26
700	2021	48900	77600	126500	2024-11-26
701	2023	211800	176600	388400	2024-11-26
701	2022	208100	176600	384700	2024-11-26
701	2021	208100	176600	384700	2024-11-26
702	2023	216000	149500	365500	2024-11-26
702	2022	216000	149500	365500	2024-11-26
702	2021	216000	149500	365500	2024-11-26
703	2023	66400	191800	258200	2024-11-26
703	2022	66400	191800	258200	2024-11-26
703	2021	66400	191800	258200	2024-11-26
704	2023	146600	149000	295600	2024-11-26
704	2022	146600	149000	295600	2024-11-26
704	2021	146600	149000	295600	2024-11-26
705	2023	2000	8800	10800	2024-11-26
705	2022	2000	8800	10800	2024-11-26
705	2021	2000	8800	10800	2024-11-26
706	2023	213600	196500	410100	2024-11-26
706	2022	213600	196500	410100	2024-11-26
706	2021	213600	196500	410100	2024-11-26
707	2023	210800	170800	381600	2024-11-26
707	2022	210800	170800	381600	2024-11-26
707	2021	210800	170800	381600	2024-11-26
708	2023	144900	157600	302500	2024-11-26
708	2022	144900	157600	302500	2024-11-26
708	2021	144900	157600	302500	2024-11-26
711	2023	162700	125900	288600	2024-11-26
711	2022	162700	125900	288600	2024-11-26
711	2021	162700	125900	288600	2024-11-26
717	2023	0	447800	447800	2024-11-26
717	2022	0	447800	447800	2024-11-26
717	2021	0	447800	447800	2024-11-26
719	2023	347200	280700	627900	2024-11-26
719	2022	347200	280700	627900	2024-11-26
719	2021	341500	280700	622200	2024-11-26
720	2023	213000	175200	388200	2024-11-26
720	2022	213000	175200	388200	2024-11-26
720	2021	213000	175200	388200	2024-11-26
723	2023	262400	145600	408000	2024-11-26
723	2022	249500	145600	395100	2024-11-26
723	2021	209100	145600	354700	2024-11-26
724	2023	0	445500	445500	2024-11-26
724	2022	0	466700	466700	2024-11-26
724	2021	0	466700	466700	2024-11-26
725	2023	446600	301400	748000	2024-11-26
725	2022	446600	301400	748000	2024-11-26
725	2021	446600	301400	748000	2024-11-26
734	2023	559500	267700	827200	2024-11-26
734	2022	559500	267700	827200	2024-11-26
734	2021	559500	267700	827200	2024-11-26
735	2023	0	258100	258100	2024-11-26
735	2022	0	258100	258100	2024-11-26
735	2021	0	270500	270500	2024-11-26
736	2023	1054700	284700	1339400	2024-11-26
736	2022	1054700	284700	1339400	2024-11-26
736	2021	1054700	284700	1339400	2024-11-26
737	2023	854300	389700	1244000	2024-11-26
737	2022	854300	389700	1244000	2024-11-26
737	2021	854300	389700	1244000	2024-11-26
738	2023	375400	271100	646500	2024-11-26
738	2022	375400	271100	646500	2024-11-26
738	2021	375400	271100	646500	2024-11-26
739	2023	420500	329500	750000	2024-11-26
739	2022	471700	329500	801200	2024-11-26
739	2021	540400	329500	869900	2024-11-26
740	2023	668000	334400	1002400	2024-11-26
740	2022	668000	334400	1002400	2024-11-26
740	2021	668000	334400	1002400	2024-11-26
741	2023	136000	320100	456100	2024-11-26
741	2022	136000	320100	456100	2024-11-26
741	2021	146100	363400	509500	2024-11-26
742	2023	602000	344800	946800	2024-11-26
742	2022	602000	344800	946800	2024-11-26
742	2021	602000	344800	946800	2024-11-26
743	2023	254600	268600	523200	2024-11-26
743	2022	258000	268600	526600	2024-11-26
743	2021	256800	294500	551300	2024-11-26
744	2023	330000	352900	682900	2024-11-26
744	2022	525500	352900	878400	2024-11-26
744	2021	525500	352900	878400	2024-11-26
745	2023	0	273700	273700	2024-11-26
745	2022	0	273700	273700	2024-11-26
745	2021	0	273700	273700	2024-11-26
746	2023	657300	297600	954900	2024-11-26
746	2022	657300	297600	954900	2024-11-26
746	2021	657300	297600	954900	2024-11-26
747	2023	456000	330800	786800	2024-11-26
747	2022	454400	330800	785200	2024-11-26
747	2021	394000	330800	724800	2024-11-26
748	2023	424400	417700	842100	2024-11-26
748	2022	424400	417700	842100	2024-11-26
748	2021	424400	417700	842100	2024-11-26
749	2023	1062400	588700	1651100	2024-11-26
749	2022	1062400	588700	1651100	2024-11-26
749	2021	1062400	588700	1651100	2024-11-26
750	2023	1008100	272500	1280600	2024-11-26
750	2022	1008100	272500	1280600	2024-11-26
750	2021	926200	272500	1198700	2024-11-26
751	2023	311800	228100	539900	2024-11-26
751	2022	311800	228100	539900	2024-11-26
751	2021	299700	228100	527800	2024-11-26
752	2023	335600	256700	592300	2024-11-26
752	2022	335600	256700	592300	2024-11-26
752	2021	335600	256700	592300	2024-11-26
753	2023	475900	560300	1036200	2024-11-26
753	2022	475900	560300	1036200	2024-11-26
753	2021	475900	560300	1036200	2024-11-26
754	2023	506500	426100	932600	2024-11-26
754	2022	506500	426100	932600	2024-11-26
754	2021	506500	426100	932600	2024-11-26
755	2023	173500	173400	346900	2024-11-26
755	2022	173500	173400	346900	2024-11-26
755	2021	167000	173400	340400	2024-11-26
756	2023	363200	548200	911400	2024-11-26
756	2022	363200	548200	911400	2024-11-26
756	2021	363200	548200	911400	2024-11-26
757	2023	0	251800	251800	2024-11-26
757	2022	0	251800	251800	2024-11-26
757	2021	0	251800	251800	2024-11-26
758	2023	122500	223700	346200	2024-11-26
758	2022	122500	223700	346200	2024-11-26
758	2021	122500	223700	346200	2024-11-26
759	2023	103400	177900	281300	2024-11-26
759	2022	103400	177900	281300	2024-11-26
759	2021	103400	177900	281300	2024-11-26
760	2023	0	289600	289600	2024-11-26
760	2022	0	289600	289600	2024-11-26
760	2021	0	289600	289600	2024-11-26
762	2023	0	181700	181700	2024-11-26
762	2022	0	181700	181700	2024-11-26
762	2021	0	181700	181700	2024-11-26
764	2023	53400	141100	194500	2024-11-26
764	2022	53400	141100	194500	2024-11-26
764	2021	53400	141100	194500	2024-11-26
765	2023	313700	158200	471900	2024-11-26
765	2022	313700	222400	536100	2024-11-26
765	2021	313700	222400	536100	2024-11-26
767	2023	8700	483700	492400	2024-11-26
767	2022	8700	483700	492400	2024-11-26
767	2021	8700	483700	492400	2024-11-26
768	2023	639200	215800	855000	2024-11-26
768	2022	639200	215800	855000	2024-11-26
768	2021	627900	215800	843700	2024-11-26
769	2023	195800	149200	345000	2024-11-26
769	2022	195800	149200	345000	2024-11-26
769	2021	195800	149200	345000	2024-11-26
770	2023	0	269900	269900	2024-11-26
770	2022	0	269900	269900	2024-11-26
770	2021	0	269900	269900	2024-11-26
771	2023	283000	205900	488900	2024-11-26
771	2022	283000	205900	488900	2024-11-26
771	2021	283000	205900	488900	2024-11-26
772	2023	256700	176600	433300	2024-11-26
772	2022	256700	176600	433300	2024-11-26
772	2021	256700	176600	433300	2024-11-26
773	2023	0	142900	142900	2024-11-26
773	2022	0	142900	142900	2024-11-26
773	2021	0	142900	142900	2024-11-26
774	2023	161200	147700	308900	2024-11-26
774	2022	161200	147700	308900	2024-11-26
774	2021	161200	147700	308900	2024-11-26
775	2023	127300	164800	292100	2024-11-26
775	2022	127300	164800	292100	2024-11-26
775	2021	127300	164800	292100	2024-11-26
776	2023	404000	206900	610900	2024-11-26
776	2022	404000	206900	610900	2024-11-26
776	2021	404000	206900	610900	2024-11-26
782	2023	831100	401000	1232100	2024-11-26
782	2022	831100	401000	1232100	2024-11-26
782	2021	831100	401000	1232100	2024-11-26
783	2023	94200	152700	246900	2024-11-26
783	2022	94200	152700	246900	2024-11-26
783	2021	94200	152700	246900	2024-11-26
784	2023	11200	149400	160600	2024-11-26
784	2022	11200	149400	160600	2024-11-26
784	2021	11200	149400	160600	2024-11-26
785	2023	857100	551300	1408400	2024-11-26
785	2022	857100	551300	1408400	2024-11-26
785	2021	857100	551300	1408400	2024-11-26
786	2023	484200	382900	867100	2024-11-26
786	2022	484200	382900	867100	2024-11-26
786	2021	484200	382900	867100	2024-11-26
787	2023	238800	166500	405300	2024-11-26
787	2022	238800	166500	405300	2024-11-26
787	2021	238800	166500	405300	2024-11-26
788	2023	136300	156300	292600	2024-11-26
788	2022	136300	156300	292600	2024-11-26
788	2021	136300	156300	292600	2024-11-26
789	2023	288700	222700	511400	2024-11-26
789	2022	288700	222700	511400	2024-11-26
789	2021	273500	222700	496200	2024-11-26
792	2023	413000	181300	594300	2024-11-26
792	2022	413000	181300	594300	2024-11-26
792	2021	413000	181300	594300	2024-11-26
793	2023	0	268100	268100	2024-11-26
793	2022	0	268100	268100	2024-11-26
793	2021	0	268100	268100	2024-11-26
795	2023	236000	161200	397200	2024-11-26
795	2022	236000	161200	397200	2024-11-26
795	2021	236000	161200	397200	2024-11-26
796	2023	55500	94000	149500	2024-11-26
796	2022	55500	94000	149500	2024-11-26
796	2021	55500	94000	149500	2024-11-26
797	2023	535400	214900	750300	2024-11-26
797	2022	535400	214900	750300	2024-11-26
797	2021	535400	214900	750300	2024-11-26
798	2023	5400	457100	462500	2024-11-26
798	2022	5400	457100	462500	2024-11-26
798	2021	5400	457100	462500	2024-11-26
799	2023	375900	182900	558800	2024-11-26
799	2022	375900	182900	558800	2024-11-26
799	2021	375900	182900	558800	2024-11-26
800	2023	1185500	377100	1562600	2024-11-26
800	2022	1185500	377100	1562600	2024-11-26
800	2021	1185500	377100	1562600	2024-11-26
801	2023	395700	679100	1074800	2024-11-26
801	2022	395700	679100	1074800	2024-11-26
801	2021	395700	679100	1074800	2024-11-26
804	2023	453900	446200	900100	2024-11-26
804	2022	453900	446200	900100	2024-11-26
804	2021	453900	446200	900100	2024-11-26
806	2023	715100	336900	1052000	2024-11-26
806	2022	715100	336900	1052000	2024-11-26
806	2021	715100	336900	1052000	2024-11-26
807	2023	0	722500	722500	2024-11-26
807	2022	0	722500	722500	2024-11-26
807	2021	0	722500	722500	2024-11-26
808	2023	268500	184100	452600	2024-11-26
808	2022	268500	184100	452600	2024-11-26
808	2021	268500	184100	452600	2024-11-26
809	2023	194900	182800	377700	2024-11-26
809	2022	194900	182800	377700	2024-11-26
809	2021	194900	182800	377700	2024-11-26
810	2023	747800	384400	1132200	2024-11-26
810	2022	747800	384400	1132200	2024-11-26
810	2021	747800	384400	1132200	2024-11-26
811	2023	17300	352400	369700	2024-11-26
811	2022	17300	352400	369700	2024-11-26
811	2021	17300	352400	369700	2024-11-26
812	2023	225800	182600	408400	2024-11-26
812	2022	261500	214500	476000	2024-11-26
812	2021	256800	214500	471300	2024-11-26
814	2023	494100	176200	670300	2024-11-26
814	2022	494100	176200	670300	2024-11-26
814	2021	494100	176200	670300	2024-11-26
815	2023	378600	252100	630700	2024-11-26
815	2022	378600	252100	630700	2024-11-26
815	2021	378600	252100	630700	2024-11-26
816	2023	641800	303400	945200	2024-11-26
816	2022	611800	303400	915200	2024-11-26
816	2021	611800	303400	915200	2024-11-26
820	2023	954300	279300	1233600	2024-11-26
820	2022	954300	279300	1233600	2024-11-26
820	2021	954300	279300	1233600	2024-11-26
821	2023	0	243100	243100	2024-11-26
821	2022	0	243100	243100	2024-11-26
821	2021	0	243100	243100	2024-11-26
824	2023	38200	190600	228800	2024-11-26
824	2022	38200	190600	228800	2024-11-26
824	2021	38200	190600	228800	2024-11-26
826	2023	301900	308300	610200	2024-11-26
826	2022	301900	308300	610200	2024-11-26
826	2021	301900	308300	610200	2024-11-26
827	2023	749700	900000	1649700	2024-11-26
827	2022	749700	900000	1649700	2024-11-26
827	2021	749700	900000	1649700	2024-11-26
829	2023	393900	358200	752100	2024-11-26
829	2022	393900	358200	752100	2024-11-26
829	2021	393900	358200	752100	2024-11-26
830	2023	159900	138800	298700	2024-11-26
830	2022	159900	138800	298700	2024-11-26
830	2021	159900	138800	298700	2024-11-26
831	2023	1136400	699600	1836000	2024-11-26
831	2022	1136400	699600	1836000	2024-11-26
831	2021	1136400	699600	1836000	2024-11-26
832	2023	0	100800	100800	2024-11-26
832	2022	0	100800	100800	2024-11-26
832	2021	0	100800	100800	2024-11-26
833	2023	342900	180000	522900	2024-11-26
833	2022	342900	180000	522900	2024-11-26
833	2021	392400	180000	572400	2024-11-26
834	2023	156300	120200	276500	2024-11-26
834	2022	156300	120200	276500	2024-11-26
834	2021	156300	120200	276500	2024-11-26
835	2023	342000	236200	578200	2024-11-26
835	2022	342000	236200	578200	2024-11-26
835	2021	342000	236200	578200	2024-11-26
836	2023	0	258500	258500	2024-11-26
836	2022	0	258500	258500	2024-11-26
836	2021	0	258500	258500	2024-11-26
837	2023	499700	245900	745600	2024-11-26
837	2022	498200	245900	744100	2024-11-26
837	2021	484200	245900	730100	2024-11-26
838	2023	258600	142000	400600	2024-11-26
838	2022	258600	142000	400600	2024-11-26
838	2021	258300	142000	400300	2024-11-26
839	2023	534600	365900	900500	2024-11-26
839	2022	534600	365900	900500	2024-11-26
839	2021	534600	365900	900500	2024-11-26
840	2023	127400	137200	264600	2024-11-26
840	2022	107300	130700	238000	2024-11-26
840	2021	106100	130700	236800	2024-11-26
841	2023	543500	205900	749400	2024-11-26
841	2022	543500	205900	749400	2024-11-26
841	2021	543500	205900	749400	2024-11-26
842	2023	127100	93200	220300	2024-11-26
842	2022	127100	93200	220300	2024-11-26
842	2021	127100	93200	220300	2024-11-26
843	2023	83600	152200	235800	2024-11-26
843	2022	83600	152200	235800	2024-11-26
843	2021	83600	152200	235800	2024-11-26
844	2023	4300	297500	301800	2024-11-26
844	2022	4300	297500	301800	2024-11-26
844	2021	4300	297500	301800	2024-11-26
845	2023	211500	141600	353100	2024-11-26
845	2022	211500	141600	353100	2024-11-26
845	2021	211500	141600	353100	2024-11-26
846	2023	0	113800	113800	2024-11-26
846	2022	0	113800	113800	2024-11-26
846	2021	0	113800	113800	2024-11-26
849	2023	0	117700	117700	2024-11-26
849	2022	0	117700	117700	2024-11-26
849	2021	0	117700	117700	2024-11-26
850	2023	33500	152200	185700	2024-11-26
850	2022	33500	152200	185700	2024-11-26
850	2021	33500	152200	185700	2024-11-26
851	2023	1500	156500	158000	2024-11-26
851	2022	1500	156500	158000	2024-11-26
851	2021	1500	156500	158000	2024-11-26
852	2023	35100	139500	174600	2024-11-26
852	2022	35100	139500	174600	2024-11-26
852	2021	35100	139500	174600	2024-11-26
853	2023	79000	125500	204500	2024-11-26
853	2022	79000	125500	204500	2024-11-26
853	2021	79000	125500	204500	2024-11-26
855	2023	42800	128800	171600	2024-11-26
855	2022	42800	128800	171600	2024-11-26
855	2021	42800	128800	171600	2024-11-26
858	2023	0	290600	290600	2024-11-26
858	2022	0	290600	290600	2024-11-26
858	2021	0	290600	290600	2024-11-26
860	2023	0	422400	422400	2024-11-26
860	2022	0	422400	422400	2024-11-26
860	2021	0	422400	422400	2024-11-26
861	2023	203600	139000	342600	2024-11-26
861	2022	203600	139000	342600	2024-11-26
861	2021	203600	139000	342600	2024-11-26
862	2023	714100	334100	1048200	2024-11-26
862	2022	714100	334100	1048200	2024-11-26
862	2021	714500	334100	1048600	2024-11-26
863	2023	0	165600	165600	2024-11-26
863	2022	0	165600	165600	2024-11-26
863	2021	0	165600	165600	2024-11-26
864	2023	0	156600	156600	2024-11-26
864	2022	0	156600	156600	2024-11-26
864	2021	0	156600	156600	2024-11-26
865	2023	913800	367800	1281600	2024-11-26
865	2022	913800	367800	1281600	2024-11-26
865	2021	913800	367800	1281600	2024-11-26
867	2023	1064900	808600	1873500	2024-11-26
867	2022	1064900	808600	1873500	2024-11-26
867	2021	1064900	808600	1873500	2024-11-26
868	2023	314000	269600	583600	2024-11-26
868	2022	314000	269600	583600	2024-11-26
868	2021	314000	269600	583600	2024-11-26
869	2023	209700	155600	365300	2024-11-26
869	2022	209700	155600	365300	2024-11-26
869	2021	209700	155600	365300	2024-11-26
871	2023	367100	181500	548600	2024-11-26
871	2022	367100	181500	548600	2024-11-26
871	2021	367100	181500	548600	2024-11-26
872	2023	397900	289300	687200	2024-11-26
872	2022	397900	289300	687200	2024-11-26
872	2021	397900	289300	687200	2024-11-26
873	2023	525300	788000	1313300	2024-11-26
873	2022	525300	788000	1313300	2024-11-26
873	2021	525300	788000	1313300	2024-11-26
874	2023	146500	300200	446700	2024-11-26
874	2022	146500	300200	446700	2024-11-26
874	2021	146500	300200	446700	2024-11-26
875	2023	434800	228300	663100	2024-11-26
875	2022	434800	228300	663100	2024-11-26
875	2021	434800	228300	663100	2024-11-26
876	2023	187900	352500	540400	2024-11-26
876	2022	187900	352500	540400	2024-11-26
876	2021	187900	352500	540400	2024-11-26
877	2023	468400	403300	871700	2024-11-26
877	2022	468400	403300	871700	2024-11-26
877	2021	468400	403300	871700	2024-11-26
878	2023	326300	465800	792100	2024-11-26
878	2022	325900	465800	791700	2024-11-26
878	2021	325900	465800	791700	2024-11-26
879	2023	183200	218400	401600	2024-11-26
879	2022	183200	218400	401600	2024-11-26
879	2021	183200	218400	401600	2024-11-26
880	2023	384400	224300	608700	2024-11-26
880	2022	384400	224300	608700	2024-11-26
880	2021	384400	224300	608700	2024-11-26
881	2023	1268800	371500	1640300	2024-11-26
881	2022	1268800	371500	1640300	2024-11-26
881	2021	1268800	371500	1640300	2024-11-26
883	2023	21300	143600	164900	2024-11-26
883	2022	21300	143600	164900	2024-11-26
883	2021	21300	143600	164900	2024-11-26
884	2023	191000	235500	426500	2024-11-26
884	2022	191000	235500	426500	2024-11-26
884	2021	191000	235500	426500	2024-11-26
887	2023	998100	474700	1472800	2024-11-26
887	2022	998100	474700	1472800	2024-11-26
887	2021	998100	474700	1472800	2024-11-26
888	2023	0	160200	160200	2024-11-26
888	2022	0	160200	160200	2024-11-26
888	2021	0	160200	160200	2024-11-26
891	2023	405300	192900	598200	2024-11-26
891	2022	403600	192900	596500	2024-11-26
891	2021	403600	192900	596500	2024-11-26
892	2023	0	554000	554000	2024-11-26
892	2022	0	554000	554000	2024-11-26
892	2021	0	554000	554000	2024-11-26
895	2023	786900	282800	1069700	2024-11-26
895	2022	786900	282800	1069700	2024-11-26
895	2021	743700	282800	1026500	2024-11-26
896	2023	1117300	352700	1470000	2024-11-26
896	2022	1117300	352700	1470000	2024-11-26
896	2021	1117300	352700	1470000	2024-11-26
897	2023	0	138700	138700	2024-11-26
897	2022	0	138700	138700	2024-11-26
897	2021	0	138700	138700	2024-11-26
898	2023	0	425300	425300	2024-11-26
898	2022	0	425300	425300	2024-11-26
898	2021	0	425300	425300	2024-11-26
899	2023	581100	515300	1096400	2024-11-26
899	2022	581100	515300	1096400	2024-11-26
899	2021	738600	515300	1253900	2024-11-26
900	2023	563900	675100	1239000	2024-11-26
900	2022	563900	675100	1239000	2024-11-26
900	2021	563900	675100	1239000	2024-11-26
901	2023	114200	178100	292300	2024-11-26
901	2022	114200	178100	292300	2024-11-26
901	2021	114200	178100	292300	2024-11-26
907	2023	0	375900	375900	2024-11-26
907	2022	0	375900	375900	2024-11-26
907	2021	0	375900	375900	2024-11-26
908	2023	0	428000	428000	2024-11-26
908	2022	0	428000	428000	2024-11-26
908	2021	0	428000	428000	2024-11-26
909	2023	1264700	1184800	2449500	2024-11-26
909	2022	1264700	1184800	2449500	2024-11-26
909	2021	1264700	1184800	2449500	2024-11-26
910	2023	487700	403500	891200	2024-11-26
910	2022	487700	403500	891200	2024-11-26
910	2021	487700	403500	891200	2024-11-26
911	2023	420600	852600	1273200	2024-11-26
911	2022	420600	852600	1273200	2024-11-26
911	2021	420600	852600	1273200	2024-11-26
912	2023	0	81400	81400	2024-11-26
912	2022	0	81400	81400	2024-11-26
912	2021	0	81400	81400	2024-11-26
913	2023	277400	149300	426700	2024-11-26
913	2022	25900	149300	175200	2024-11-26
913	2021	25900	149300	175200	2024-11-26
915	2023	133700	155800	289500	2024-11-26
915	2022	133700	155800	289500	2024-11-26
915	2021	133700	155800	289500	2024-11-26
916	2023	171000	178500	349500	2024-11-26
916	2022	171000	178500	349500	2024-11-26
916	2021	171000	178500	349500	2024-11-26
917	2023	250500	235300	485800	2024-11-26
917	2022	250500	235300	485800	2024-11-26
917	2021	250500	235300	485800	2024-11-26
920	2023	441800	335600	777400	2024-11-26
920	2022	403900	335600	739500	2024-11-26
920	2021	399600	335600	735200	2024-11-26
921	2023	302400	249100	551500	2024-11-26
921	2022	302400	249100	551500	2024-11-26
921	2021	302400	249100	551500	2024-11-26
923	2023	29900	171500	201400	2024-11-26
923	2022	29900	171500	201400	2024-11-26
923	2021	29900	171500	201400	2024-11-26
924	2023	0	444100	444100	2024-11-26
924	2022	0	477500	477500	2024-11-26
924	2021	0	477500	477500	2024-11-26
925	2023	0	400	400	2024-11-26
925	2022	0	400	400	2024-11-26
925	2021	0	400	400	2024-11-26
934	2023	0	222900	222900	2024-11-26
934	2022	0	222900	222900	2024-11-26
934	2021	0	222900	222900	2024-11-26
935	2023	458600	263000	721600	2024-11-26
935	2022	458600	263000	721600	2024-11-26
935	2021	458600	263000	721600	2024-11-26
939	2023	596300	440400	1036700	2024-11-26
939	2022	596300	440400	1036700	2024-11-26
939	2021	596300	440400	1036700	2024-11-26
940	2023	442600	276100	718700	2024-11-26
940	2022	432600	276100	708700	2024-11-26
940	2021	432600	276100	708700	2024-11-26
941	2023	397900	168600	566500	2024-11-26
941	2022	397900	168600	566500	2024-11-26
941	2021	397900	168600	566500	2024-11-26
942	2023	402700	227300	630000	2024-11-26
942	2022	402700	227300	630000	2024-11-26
942	2021	402700	227300	630000	2024-11-26
943	2023	324200	261900	586100	2024-11-26
943	2022	324200	261900	586100	2024-11-26
943	2021	324200	261900	586100	2024-11-26
944	2023	331800	297200	629000	2024-11-26
944	2022	331800	297200	629000	2024-11-26
944	2021	393600	339500	733100	2024-11-26
947	2023	334800	143600	478400	2024-11-26
947	2022	334800	143600	478400	2024-11-26
947	2021	334800	143600	478400	2024-11-26
949	2023	425800	386900	812700	2024-11-26
949	2022	423400	386900	810300	2024-11-26
949	2021	383600	386900	770500	2024-11-26
951	2023	161600	106600	268200	2024-11-26
951	2022	161600	106600	268200	2024-11-26
951	2021	161600	106600	268200	2024-11-26
952	2023	122200	125500	247700	2024-11-26
952	2022	122200	125500	247700	2024-11-26
952	2021	134400	133800	268200	2024-11-26
953	2023	183800	126300	310100	2024-11-26
953	2022	183800	126300	310100	2024-11-26
953	2021	183800	126300	310100	2024-11-26
954	2023	134700	156100	290800	2024-11-26
954	2022	134700	156100	290800	2024-11-26
954	2021	134700	156100	290800	2024-11-26
955	2023	91100	124900	216000	2024-11-26
955	2022	91100	124900	216000	2024-11-26
955	2021	91100	124900	216000	2024-11-26
958	2023	311600	108600	420200	2024-11-26
958	2022	311600	108600	420200	2024-11-26
958	2021	311600	108600	420200	2024-11-26
959	2023	229100	112600	341700	2024-11-26
959	2022	229100	112600	341700	2024-11-26
959	2021	229100	112600	341700	2024-11-26
960	2023	209600	115100	324700	2024-11-26
960	2022	209600	115100	324700	2024-11-26
960	2021	209600	115100	324700	2024-11-26
961	2023	383800	243800	627600	2024-11-26
961	2022	383800	243800	627600	2024-11-26
961	2021	383800	243800	627600	2024-11-26
962	2023	371900	112400	484300	2024-11-26
962	2022	371900	112400	484300	2024-11-26
962	2021	371900	112400	484300	2024-11-26
963	2023	245600	239300	484900	2024-11-26
963	2022	245600	239300	484900	2024-11-26
963	2021	245600	239300	484900	2024-11-26
964	2023	0	211200	211200	2024-11-26
964	2022	0	211200	211200	2024-11-26
964	2021	0	211200	211200	2024-11-26
965	2023	528500	231100	759600	2024-11-26
965	2022	528500	231100	759600	2024-11-26
965	2021	524400	231100	755500	2024-11-26
966	2023	376200	166000	542200	2024-11-26
966	2022	376200	166000	542200	2024-11-26
966	2021	376200	166000	542200	2024-11-26
967	2023	467700	172900	640600	2024-11-26
967	2022	467700	172900	640600	2024-11-26
967	2021	467700	172900	640600	2024-11-26
968	2023	234500	278700	513200	2024-11-26
968	2022	215000	278700	493700	2024-11-26
968	2021	207300	302900	510200	2024-11-26
969	2023	143300	156100	299400	2024-11-26
969	2022	143300	156100	299400	2024-11-26
969	2021	143300	156100	299400	2024-11-26
971	2023	207900	172600	380500	2024-11-26
971	2022	207900	172600	380500	2024-11-26
971	2021	207900	172600	380500	2024-11-26
972	2023	0	158100	158100	2024-11-26
972	2022	0	158100	158100	2024-11-26
972	2021	0	158100	158100	2024-11-26
973	2023	253200	151600	404800	2024-11-26
973	2022	253200	151600	404800	2024-11-26
973	2021	245500	151600	397100	2024-11-26
974	2023	466700	266000	732700	2024-11-26
974	2022	463100	266000	729100	2024-11-26
974	2021	463100	266000	729100	2024-11-26
975	2023	0	221300	221300	2024-11-26
975	2022	0	221300	221300	2024-11-26
975	2021	0	221300	221300	2024-11-26
976	2023	261400	211800	473200	2024-11-26
976	2022	261400	211800	473200	2024-11-26
976	2021	262700	211800	474500	2024-11-26
977	2023	603500	192500	796000	2024-11-26
977	2022	584200	192500	776700	2024-11-26
977	2021	584200	192500	776700	2024-11-26
978	2023	26100	134100	160200	2024-11-26
978	2022	26100	134100	160200	2024-11-26
978	2021	26100	134100	160200	2024-11-26
979	2023	94700	130300	225000	2024-11-26
979	2022	94700	130300	225000	2024-11-26
979	2021	94700	130300	225000	2024-11-26
981	2023	270900	128900	399800	2024-11-26
981	2022	270900	128900	399800	2024-11-26
981	2021	270900	128900	399800	2024-11-26
982	2023	112400	137000	249400	2024-11-26
982	2022	112400	137000	249400	2024-11-26
982	2021	112400	137000	249400	2024-11-26
983	2023	12100	137300	149400	2024-11-26
983	2022	12100	137300	149400	2024-11-26
983	2021	12100	137300	149400	2024-11-26
984	2023	90800	118300	209100	2024-11-26
984	2022	90800	118300	209100	2024-11-26
984	2021	90800	118300	209100	2024-11-26
986	2023	107000	139600	246600	2024-11-26
986	2022	107000	139600	246600	2024-11-26
986	2021	107000	139600	246600	2024-11-26
987	2023	258800	411500	670300	2024-11-26
987	2022	258800	411500	670300	2024-11-26
987	2021	258800	411500	670300	2024-11-26
990	2023	4100	12000	16100	2024-11-26
990	2022	4100	12000	16100	2024-11-26
990	2021	4100	12000	16100	2024-11-26
991	2023	77800	131000	208800	2024-11-26
991	2022	77800	131000	208800	2024-11-26
991	2021	77800	131000	208800	2024-11-26
992	2023	0	680300	680300	2024-11-26
992	2022	0	680300	680300	2024-11-26
992	2021	0	680300	680300	2024-11-26
993	2023	226300	135900	362200	2024-11-26
993	2022	226300	135900	362200	2024-11-26
993	2021	210700	135900	346600	2024-11-26
994	2023	145200	171100	316300	2024-11-26
994	2022	145200	171100	316300	2024-11-26
994	2021	145200	171100	316300	2024-11-26
995	2023	165900	84200	250100	2024-11-26
995	2022	165900	84200	250100	2024-11-26
995	2021	165900	89400	255300	2024-11-26
996	2023	336100	186700	522800	2024-11-26
996	2022	336100	186700	522800	2024-11-26
996	2021	336100	186700	522800	2024-11-26
997	2023	212500	160700	373200	2024-11-26
997	2022	212500	160700	373200	2024-11-26
997	2021	212500	160700	373200	2024-11-26
998	2023	442600	379500	822100	2024-11-26
998	2022	442600	379500	822100	2024-11-26
998	2021	442600	379500	822100	2024-11-26
1002	2023	0	141700	141700	2024-11-26
1002	2022	0	141700	141700	2024-11-26
1002	2021	0	141700	141700	2024-11-26
1003	2023	178600	361400	540000	2024-11-26
1003	2022	167600	361400	529000	2024-11-26
1003	2021	179900	361400	541300	2024-11-26
1004	2023	370900	175200	546100	2024-11-26
1004	2022	370900	175200	546100	2024-11-26
1004	2021	370900	175200	546100	2024-11-26
1005	2023	348300	184800	533100	2024-11-26
1005	2022	348300	184800	533100	2024-11-26
1005	2021	348300	184800	533100	2024-11-26
1006	2023	131500	140300	271800	2024-11-26
1006	2022	131500	140300	271800	2024-11-26
1006	2021	131500	140300	271800	2024-11-26
1009	2023	0	366700	366700	2024-11-26
1009	2022	0	366700	366700	2024-11-26
1009	2021	0	366700	366700	2024-11-26
1015	2023	56500	122100	178600	2024-11-26
1015	2022	56500	122100	178600	2024-11-26
1015	2021	56500	122100	178600	2024-11-26
1016	2023	122600	155100	277700	2024-11-26
1016	2022	122600	155100	277700	2024-11-26
1016	2021	122600	155100	277700	2024-11-26
1018	2023	43400	191800	235200	2024-11-26
1018	2022	43400	191800	235200	2024-11-26
1018	2021	43400	191800	235200	2024-11-26
1019	2023	265300	163000	428300	2024-11-26
1019	2022	265300	163000	428300	2024-11-26
1019	2021	265300	163000	428300	2024-11-26
1020	2023	81200	169000	250200	2024-11-26
1020	2022	81200	169000	250200	2024-11-26
1020	2021	81200	169000	250200	2024-11-26
1022	2023	370500	395200	765700	2024-11-26
1022	2022	370500	395200	765700	2024-11-26
1022	2021	370500	395200	765700	2024-11-26
1023	2023	160500	195700	356200	2024-11-26
1023	2022	160500	195700	356200	2024-11-26
1023	2021	160500	195700	356200	2024-11-26
1024	2023	142900	148400	291300	2024-11-26
1024	2022	142900	148400	291300	2024-11-26
1024	2021	142900	148400	291300	2024-11-26
1025	2023	296500	202000	498500	2024-11-26
1025	2022	296500	202000	498500	2024-11-26
1025	2021	277500	202000	479500	2024-11-26
1026	2023	261400	264800	526200	2024-11-26
1026	2022	261400	264800	526200	2024-11-26
1026	2021	261400	264800	526200	2024-11-26
1027	2023	0	401100	401100	2024-11-26
1027	2022	0	401100	401100	2024-11-26
1027	2021	0	401100	401100	2024-11-26
1028	2023	0	12200	12200	2024-11-26
1028	2022	0	12200	12200	2024-11-26
1028	2021	0	12200	12200	2024-11-26
1030	2023	368900	354100	723000	2024-11-26
1030	2022	368900	354100	723000	2024-11-26
1030	2021	368900	354100	723000	2024-11-26
1031	2023	145000	176700	321700	2024-11-26
1031	2022	145000	176700	321700	2024-11-26
1031	2021	145000	176700	321700	2024-11-26
1033	2023	298200	306900	605100	2024-11-26
1033	2022	298200	306900	605100	2024-11-26
1033	2021	298200	306900	605100	2024-11-26
1034	2023	17100	103900	121000	2024-11-26
1034	2022	17100	103900	121000	2024-11-26
1034	2021	17100	103900	121000	2024-11-26
1035	2023	162400	251800	414200	2024-11-26
1035	2022	162400	251800	414200	2024-11-26
1035	2021	162400	251800	414200	2024-11-26
1037	2023	53700	226100	279800	2024-11-26
1037	2022	53700	226100	279800	2024-11-26
1037	2021	53700	226100	279800	2024-11-26
1038	2023	114400	97000	211400	2024-11-26
1038	2022	114400	97000	211400	2024-11-26
1038	2021	103600	97000	200600	2024-11-26
1039	2023	0	402900	402900	2024-11-26
1039	2022	0	402900	402900	2024-11-26
1039	2021	0	422400	422400	2024-11-26
1040	2023	404300	143100	547400	2024-11-26
1040	2022	391100	143100	534200	2024-11-26
1040	2021	355700	143100	498800	2024-11-26
1041	2023	348600	147700	496300	2024-11-26
1041	2022	348600	147700	496300	2024-11-26
1041	2021	348600	147700	496300	2024-11-26
1042	2023	245800	152800	398600	2024-11-26
1042	2022	245800	152800	398600	2024-11-26
1042	2021	245800	152800	398600	2024-11-26
1043	2023	125600	100500	226100	2024-11-26
1043	2022	125600	100500	226100	2024-11-26
1043	2021	125600	100500	226100	2024-11-26
1045	2023	68200	105400	173600	2024-11-26
1045	2022	68200	105400	173600	2024-11-26
1045	2021	68200	105400	173600	2024-11-26
1046	2023	128000	131300	259300	2024-11-26
1046	2022	128000	131300	259300	2024-11-26
1046	2021	128000	131300	259300	2024-11-26
1048	2023	0	4400	4400	2024-11-26
1048	2022	0	4400	4400	2024-11-26
1048	2021	0	4400	4400	2024-11-26
1049	2023	31100	161400	192500	2024-11-26
1049	2022	31100	161400	192500	2024-11-26
1049	2021	31100	161400	192500	2024-11-26
1051	2023	73600	147200	220800	2024-11-26
1051	2022	73600	147200	220800	2024-11-26
1051	2021	73600	147200	220800	2024-11-26
1052	2023	118300	260900	379200	2024-11-26
1052	2022	118300	260900	379200	2024-11-26
1052	2021	118300	260900	379200	2024-11-26
1053	2023	859100	1007400	1866500	2024-11-26
1053	2022	859100	1044500	1903600	2024-11-26
1053	2021	859100	1044500	1903600	2024-11-26
1054	2023	1622000	804100	2426100	2024-11-26
1054	2022	1622000	804100	2426100	2024-11-26
1054	2021	1616600	865600	2482200	2024-11-26
1055	2023	0	327000	327000	2024-11-26
1055	2022	0	327000	327000	2024-11-26
1055	2021	0	327000	327000	2024-11-26
1057	2023	0	72300	72300	2024-11-26
1057	2022	0	72300	72300	2024-11-26
1057	2021	0	72300	72300	2024-11-26
1058	2023	9400	270800	280200	2024-11-26
1058	2022	9400	270800	280200	2024-11-26
1058	2021	9400	270800	280200	2024-11-26
1060	2023	952200	438500	1390700	2024-11-26
1060	2022	952200	438500	1390700	2024-11-26
1060	2021	952200	438500	1390700	2024-11-26
1061	2023	132200	194200	326400	2024-11-26
1061	2022	132200	194200	326400	2024-11-26
1061	2021	132200	194200	326400	2024-11-26
1064	2023	536700	476500	1013200	2024-11-26
1064	2022	536700	476500	1013200	2024-11-26
1064	2021	536700	476500	1013200	2024-11-26
1068	2023	620900	381500	1002400	2024-11-26
1068	2022	620900	336000	956900	2024-11-26
1068	2021	620900	336000	956900	2024-11-26
1069	2023	0	180000	180000	2024-11-26
1069	2022	0	180000	180000	2024-11-26
1069	2021	0	180000	180000	2024-11-26
1070	2023	62100	169800	231900	2024-11-26
1070	2022	62100	169800	231900	2024-11-26
1070	2021	62100	169800	231900	2024-11-26
1071	2023	496200	139200	635400	2024-11-26
1071	2022	496200	139200	635400	2024-11-26
1071	2021	496200	139200	635400	2024-11-26
1076	2023	0	220200	220200	2024-11-26
1076	2022	0	220200	220200	2024-11-26
1076	2021	0	220200	220200	2024-11-26
1077	2023	0	997900	997900	2024-11-26
1077	2022	0	997900	997900	2024-11-26
1077	2021	0	997900	997900	2024-11-26
1078	2023	200900	103900	304800	2024-11-26
1078	2022	200900	103900	304800	2024-11-26
1078	2021	200900	103900	304800	2024-11-26
1079	2023	0	66800	66800	2024-11-26
1079	2022	0	66800	66800	2024-11-26
1079	2021	0	66800	66800	2024-11-26
1081	2023	0	92100	92100	2024-11-26
1081	2022	0	92100	92100	2024-11-26
1081	2021	0	92100	92100	2024-11-26
1082	2023	33700	95900	129600	2024-11-26
1082	2022	33700	95900	129600	2024-11-26
1082	2021	33700	95900	129600	2024-11-26
1083	2023	0	572000	572000	2024-11-26
1083	2022	0	572000	572000	2024-11-26
1083	2021	0	572000	572000	2024-11-26
1084	2023	0	33700	33700	2024-11-26
1084	2022	0	33700	33700	2024-11-26
1084	2021	0	33700	33700	2024-11-26
1085	2023	0	140400	140400	2024-11-26
1085	2022	0	140400	140400	2024-11-26
1085	2021	0	140400	140400	2024-11-26
1087	2023	0	83500	83500	2024-11-26
1087	2022	0	83500	83500	2024-11-26
1087	2021	0	83500	83500	2024-11-26
1091	2023	80800	145200	226000	2024-11-26
1091	2022	80800	145200	226000	2024-11-26
1091	2021	89200	145200	234400	2024-11-26
1092	2023	309500	161300	470800	2024-11-26
1092	2022	309500	161300	470800	2024-11-26
1092	2021	309500	161300	470800	2024-11-26
1093	2023	0	139200	139200	2024-11-26
1093	2022	0	139200	139200	2024-11-26
1093	2021	0	139200	139200	2024-11-26
1094	2023	179900	240600	420500	2024-11-26
1094	2022	179900	240600	420500	2024-11-26
1094	2021	179900	240600	420500	2024-11-26
1096	2023	1589900	780600	2370500	2024-11-26
1096	2022	1589900	780600	2370500	2024-11-26
1096	2021	1543900	780600	2324500	2024-11-26
1097	2023	0	197900	197900	2024-11-26
1097	2022	0	197900	197900	2024-11-26
1097	2021	0	197900	197900	2024-11-26
1099	2023	269700	194800	464500	2024-11-26
1099	2022	257600	194800	452400	2024-11-26
1099	2021	237600	194800	432400	2024-11-26
1101	2023	176500	127400	303900	2024-11-26
1101	2022	176500	127400	303900	2024-11-26
1101	2021	176500	127400	303900	2024-11-26
1102	2023	94200	134800	229000	2024-11-26
1102	2022	94200	134800	229000	2024-11-26
1102	2021	94200	134800	229000	2024-11-26
1103	2023	0	353700	353700	2024-11-26
1103	2022	0	353700	353700	2024-11-26
1103	2021	0	353700	353700	2024-11-26
1104	2023	535000	434700	969700	2024-11-26
1104	2022	535000	434700	969700	2024-11-26
1104	2021	535000	434700	969700	2024-11-26
1105	2023	538000	432800	970800	2024-11-26
1105	2022	538000	432800	970800	2024-11-26
1105	2021	538000	432800	970800	2024-11-26
1109	2023	653900	489400	1143300	2024-11-26
1109	2022	653900	489400	1143300	2024-11-26
1109	2021	653900	489400	1143300	2024-11-26
1111	2023	0	128800	128800	2024-11-26
1111	2022	0	128800	128800	2024-11-26
1111	2021	0	128800	128800	2024-11-26
1112	2023	196600	168700	365300	2024-11-26
1112	2022	196600	168700	365300	2024-11-26
1112	2021	196600	168700	365300	2024-11-26
1113	2023	73200	455600	528800	2024-11-26
1113	2022	73200	455600	528800	2024-11-26
1113	2021	73200	455600	528800	2024-11-26
1118	2023	204900	130200	335100	2024-11-26
1118	2022	204900	130200	335100	2024-11-26
1118	2021	204900	130200	335100	2024-11-26
1120	2023	370500	232200	602700	2024-11-26
1120	2022	370500	232200	602700	2024-11-26
1120	2021	370500	232200	602700	2024-11-26
1121	2023	221000	148900	369900	2024-11-26
1121	2022	221000	148900	369900	2024-11-26
1121	2021	221000	148900	369900	2024-11-26
1122	2023	27800	97300	125100	2024-11-26
1122	2022	27800	97300	125100	2024-11-26
1122	2021	27800	97300	125100	2024-11-26
1123	2023	37100	140400	177500	2024-11-26
1123	2022	37100	140400	177500	2024-11-26
1123	2021	37100	140400	177500	2024-11-26
1124	2023	39500	95000	134500	2024-11-26
1124	2022	39500	95000	134500	2024-11-26
1124	2021	39500	95000	134500	2024-11-26
1125	2023	27000	50400	77400	2024-11-26
1125	2022	27000	50400	77400	2024-11-26
1125	2021	27000	50400	77400	2024-11-26
1126	2023	194300	103600	297900	2024-11-26
1126	2022	194300	103600	297900	2024-11-26
1126	2021	194300	103600	297900	2024-11-26
1127	2023	50200	304400	354600	2024-11-26
1127	2022	50200	304400	354600	2024-11-26
1127	2021	50200	304400	354600	2024-11-26
1129	2023	0	107900	107900	2024-11-26
1129	2022	0	107900	107900	2024-11-26
1129	2021	0	107900	107900	2024-11-26
1131	2023	54200	338100	392300	2024-11-26
1131	2022	54200	338100	392300	2024-11-26
1131	2021	54200	338100	392300	2024-11-26
1132	2023	605600	584900	1190500	2024-11-26
1132	2022	605600	531100	1136700	2024-11-26
1132	2021	605600	534600	1140200	2024-11-26
1133	2023	121200	111300	232500	2024-11-26
1133	2022	121200	111300	232500	2024-11-26
1133	2021	121200	111300	232500	2024-11-26
1136	2023	82700	92300	175000	2024-11-26
1136	2022	82700	92300	175000	2024-11-26
1136	2021	82700	92300	175000	2024-11-26
1137	2023	26500	75000	101500	2024-11-26
1137	2022	26500	75000	101500	2024-11-26
1137	2021	26500	75000	101500	2024-11-26
1138	2023	40000	46500	86500	2024-11-26
1138	2022	40000	46500	86500	2024-11-26
1138	2021	40000	46500	86500	2024-11-26
1140	2023	233000	150300	383300	2024-11-26
1140	2022	233000	150300	383300	2024-11-26
1140	2021	275600	143300	418900	2024-11-26
1141	2023	0	3300	3300	2024-11-26
1141	2022	0	3300	3300	2024-11-26
1141	2021	0	3300	3300	2024-11-26
1142	2023	298500	151900	450400	2024-11-26
1142	2022	252600	151900	404500	2024-11-26
1142	2021	68200	151900	220100	2024-11-26
1144	2023	380000	190600	570600	2024-11-26
1144	2022	380000	190600	570600	2024-11-26
1144	2021	380000	266400	646400	2024-11-26
1149	2023	164600	275900	440500	2024-11-26
1149	2022	164600	275900	440500	2024-11-26
1149	2021	165700	275900	441600	2024-11-26
1150	2023	195100	190700	385800	2024-11-26
1150	2022	195100	190700	385800	2024-11-26
1150	2021	195100	190700	385800	2024-11-26
1151	2023	0	347500	347500	2024-11-26
1151	2022	0	347500	347500	2024-11-26
1151	2021	0	347500	347500	2024-11-26
1152	2023	0	311600	311600	2024-11-26
1152	2022	0	311600	311600	2024-11-26
1152	2021	0	311600	311600	2024-11-26
1154	2023	0	100400	100400	2024-11-26
1154	2022	0	100400	100400	2024-11-26
1154	2021	0	100400	100400	2024-11-26
1155	2023	0	217300	217300	2024-11-26
1155	2022	0	217300	217300	2024-11-26
1155	2021	0	217300	217300	2024-11-26
1156	2023	343100	221600	564700	2024-11-26
1156	2022	343100	221600	564700	2024-11-26
1156	2021	343100	221600	564700	2024-11-26
1157	2023	77200	178200	255400	2024-11-26
1157	2022	77200	178200	255400	2024-11-26
1157	2021	77200	178200	255400	2024-11-26
1158	2023	0	304500	304500	2024-11-26
1158	2022	0	304500	304500	2024-11-26
1158	2021	0	304500	304500	2024-11-26
1163	2023	0	205000	205000	2024-11-26
1163	2022	0	205000	205000	2024-11-26
1163	2021	0	205000	205000	2024-11-26
1164	2023	0	2792500	2792500	2024-11-26
1164	2022	0	2792500	2792500	2024-11-26
1164	2021	0	2792500	2792500	2024-11-26
1165	2023	70600	85100	155700	2024-11-26
1165	2022	70500	85100	155600	2024-11-26
1165	2021	70500	85100	155600	2024-11-26
1166	2023	185000	154900	339900	2024-11-26
1166	2022	182400	154900	337300	2024-11-26
1166	2021	182400	154900	337300	2024-11-26
1167	2023	156100	142600	298700	2024-11-26
1167	2022	154000	142600	296600	2024-11-26
1167	2021	154000	142600	296600	2024-11-26
1169	2023	527000	253000	780000	2024-11-26
1169	2022	527000	253000	780000	2024-11-26
1169	2021	527000	253000	780000	2024-11-26
1170	2023	267100	299800	566900	2024-11-26
1170	2022	261600	299800	561400	2024-11-26
1170	2021	261600	299800	561400	2024-11-26
1171	2023	0	83700	83700	2024-11-26
1171	2022	0	83700	83700	2024-11-26
1171	2021	0	83700	83700	2024-11-26
1173	2023	58600	258000	316600	2024-11-26
1173	2022	58600	258000	316600	2024-11-26
1173	2021	58600	258000	316600	2024-11-26
1177	2023	0	324600	324600	2024-11-26
1177	2022	0	324600	324600	2024-11-26
1177	2021	0	324600	324600	2024-11-26
1186	2023	0	59000	59000	2024-11-26
1186	2022	0	59000	59000	2024-11-26
1186	2021	0	59000	59000	2024-11-26
1187	2023	0	72300	72300	2024-11-26
1187	2022	0	72300	72300	2024-11-26
1187	2021	0	72300	72300	2024-11-26
1188	2023	500600	348700	849300	2024-11-26
1188	2022	477000	348700	825700	2024-11-26
1188	2021	477000	348700	825700	2024-11-26
1189	2023	0	290400	290400	2024-11-26
1189	2022	0	290400	290400	2024-11-26
1189	2021	0	290400	290400	2024-11-26
1190	2023	1200	113100	114300	2024-11-26
1190	2022	1200	113100	114300	2024-11-26
1190	2021	1200	113100	114300	2024-11-26
1191	2023	0	110100	110100	2024-11-26
1191	2022	0	110100	110100	2024-11-26
1191	2021	0	110100	110100	2024-11-26
1192	2023	0	22300	22300	2024-11-26
1192	2022	0	22300	22300	2024-11-26
1192	2021	0	22300	22300	2024-11-26
1193	2023	0	77500	77500	2024-11-26
1193	2022	0	77500	77500	2024-11-26
1193	2021	0	77500	77500	2024-11-26
1195	2023	318700	160200	478900	2024-11-26
1195	2022	318700	160200	478900	2024-11-26
1195	2021	314400	160200	474600	2024-11-26
1196	2023	328700	168700	497400	2024-11-26
1196	2022	325600	168700	494300	2024-11-26
1196	2021	325600	168700	494300	2024-11-26
1197	2023	4300	63600	67900	2024-11-26
1197	2022	4300	63600	67900	2024-11-26
1197	2021	4300	63600	67900	2024-11-26
1198	2023	0	0	0	2024-11-26
1198	2022	0	0	0	2024-11-26
1198	2021	0	0	0	2024-11-26
1199	2023	119900	138500	258400	2024-11-26
1199	2022	119800	138500	258300	2024-11-26
1199	2021	119800	138500	258300	2024-11-26
1200	2023	168200	130700	298900	2024-11-26
1200	2022	165800	130700	296500	2024-11-26
1200	2021	165800	130700	296500	2024-11-26
1201	2023	272000	138100	410100	2024-11-26
1201	2022	284500	138100	422600	2024-11-26
1201	2021	284500	138100	422600	2024-11-26
1202	2023	296000	138100	434100	2024-11-26
1202	2022	294100	138100	432200	2024-11-26
1202	2021	294100	138100	432200	2024-11-26
1203	2023	189600	138100	327700	2024-11-26
1203	2022	189100	138100	327200	2024-11-26
1203	2021	189100	138100	327200	2024-11-26
1204	2023	190600	145500	336100	2024-11-26
1204	2022	187600	145500	333100	2024-11-26
1204	2021	187600	145500	333100	2024-11-26
1206	2023	0	625400	625400	2024-11-26
1206	2022	0	625400	625400	2024-11-26
1206	2021	0	625400	625400	2024-11-26
1207	2023	0	16100	16100	2024-11-26
1207	2022	0	16100	16100	2024-11-26
1207	2021	0	16100	16100	2024-11-26
1208	2023	299400	162800	462200	2024-11-26
1208	2022	293700	162800	456500	2024-11-26
1208	2021	293700	162800	456500	2024-11-26
1209	2023	300400	199500	499900	2024-11-26
1209	2022	294100	199500	493600	2024-11-26
1209	2021	294100	199500	493600	2024-11-26
1211	2023	118500	167700	286200	2024-11-26
1211	2022	116300	167700	284000	2024-11-26
1211	2021	116300	167700	284000	2024-11-26
1212	2023	474700	190000	664700	2024-11-26
1212	2022	474700	190000	664700	2024-11-26
1212	2021	470800	190000	660800	2024-11-26
1213	2023	400100	189300	589400	2024-11-26
1213	2022	390400	189300	579700	2024-11-26
1213	2021	390400	189300	579700	2024-11-26
1214	2023	0	33200	33200	2024-11-26
1214	2022	0	33200	33200	2024-11-26
1214	2021	0	33200	33200	2024-11-26
1215	2023	0	419900	419900	2024-11-26
1215	2022	0	419900	419900	2024-11-26
1215	2021	0	419900	419900	2024-11-26
1222	2023	479600	268300	747900	2024-11-26
1222	2022	428200	268300	696500	2024-11-26
1222	2021	376600	268300	644900	2024-11-26
1223	2023	0	428700	428700	2024-11-26
1223	2022	0	428700	428700	2024-11-26
1223	2021	0	428700	428700	2024-11-26
1225	2023	224600	218500	443100	2024-11-26
1225	2022	222900	218500	441400	2024-11-26
1225	2021	222900	218500	441400	2024-11-26
1226	2023	857800	714300	1572100	2024-11-26
1226	2022	831300	714300	1545600	2024-11-26
1226	2021	831300	714300	1545600	2024-11-26
1227	2023	425300	360300	785600	2024-11-26
1227	2022	425300	360300	785600	2024-11-26
1227	2021	425300	360300	785600	2024-11-26
1228	2023	161900	344400	506300	2024-11-26
1228	2022	162200	344400	506600	2024-11-26
1228	2021	162200	344400	506600	2024-11-26
1229	2023	34700	80000	114700	2024-11-26
1229	2022	34700	80000	114700	2024-11-26
1229	2021	34700	80000	114700	2024-11-26
1230	2023	358300	279000	637300	2024-11-26
1230	2022	358200	279000	637200	2024-11-26
1230	2021	358200	279000	637200	2024-11-26
1232	2023	155200	147100	302300	2024-11-26
1232	2022	156500	147100	303600	2024-11-26
1232	2021	156500	147100	303600	2024-11-26
1233	2023	304300	176600	480900	2024-11-26
1233	2022	304300	176600	480900	2024-11-26
1233	2021	304300	176600	480900	2024-11-26
1234	2023	132600	136700	269300	2024-11-26
1234	2022	129400	136700	266100	2024-11-26
1234	2021	129400	136700	266100	2024-11-26
1235	2023	114400	120800	235200	2024-11-26
1235	2022	114800	120800	235600	2024-11-26
1235	2021	114800	120800	235600	2024-11-26
1236	2023	65700	143200	208900	2024-11-26
1236	2022	66500	143200	209700	2024-11-26
1236	2021	66500	143200	209700	2024-11-26
1243	2023	0	299900	299900	2024-11-26
1243	2022	0	299900	299900	2024-11-26
1243	2021	0	299900	299900	2024-11-26
1247	2023	520900	415900	936800	2024-11-26
1247	2022	510900	415900	926800	2024-11-26
1247	2021	510900	415900	926800	2024-11-26
1248	2023	521400	319500	840900	2024-11-26
1248	2022	455900	319500	775400	2024-11-26
1248	2021	455900	319500	775400	2024-11-26
1249	2023	176800	414100	590900	2024-11-26
1249	2022	176600	414100	590700	2024-11-26
1249	2021	176600	414100	590700	2024-11-26
1250	2023	281200	168700	449900	2024-11-26
1250	2022	278300	168700	447000	2024-11-26
1250	2021	278300	168700	447000	2024-11-26
1251	2023	457700	190500	648200	2024-11-26
1251	2022	457500	190500	648000	2024-11-26
1251	2021	457500	190500	648000	2024-11-26
1255	2023	368200	157800	526000	2024-11-26
1255	2022	363500	157800	521300	2024-11-26
1255	2021	363500	157800	521300	2024-11-26
1256	2023	240200	140300	380500	2024-11-26
1256	2022	238500	140300	378800	2024-11-26
1256	2021	238500	140300	378800	2024-11-26
1257	2023	149800	130700	280500	2024-11-26
1257	2022	149000	130700	279700	2024-11-26
1257	2021	149000	130700	279700	2024-11-26
1263	2023	156000	409000	565000	2024-11-26
1263	2022	156000	409000	565000	2024-11-26
1263	2021	156000	409000	565000	2024-11-26
1265	2023	256800	146600	403400	2024-11-26
1265	2022	255500	146600	402100	2024-11-26
1265	2021	255500	146600	402100	2024-11-26
1266	2023	338200	173300	511500	2024-11-26
1266	2022	324100	173300	497400	2024-11-26
1266	2021	324100	173300	497400	2024-11-26
1267	2023	278700	149300	428000	2024-11-26
1267	2022	278100	149300	427400	2024-11-26
1267	2021	278100	149300	427400	2024-11-26
1268	2023	21400	118300	139700	2024-11-26
1268	2022	21400	118300	139700	2024-11-26
1268	2021	28300	126800	155100	2024-11-26
1269	2023	184700	232400	417100	2024-11-26
1269	2022	184700	232400	417100	2024-11-26
1269	2021	184700	232400	417100	2024-11-26
1270	2023	0	5200	5200	2024-11-26
1270	2022	0	5200	5200	2024-11-26
1270	2021	0	5200	5200	2024-11-26
1271	2023	312500	150800	463300	2024-11-26
1271	2022	312500	150800	463300	2024-11-26
1271	2021	312500	150800	463300	2024-11-26
1272	2023	389400	369100	758500	2024-11-26
1272	2022	389400	369100	758500	2024-11-26
1272	2021	369200	369100	738300	2024-11-26
1274	2023	305400	168100	473500	2024-11-26
1274	2022	312200	168100	480300	2024-11-26
1274	2021	312200	168100	480300	2024-11-26
1277	2023	0	294200	294200	2024-11-26
1277	2022	0	294200	294200	2024-11-26
1277	2021	0	294200	294200	2024-11-26
1282	2023	0	304600	304600	2024-11-26
1282	2022	0	304600	304600	2024-11-26
1282	2021	0	304600	304600	2024-11-26
1289	2023	0	181900	181900	2024-11-26
1289	2022	0	181900	181900	2024-11-26
1289	2021	0	181900	181900	2024-11-26
1291	2023	0	33700	33700	2024-11-26
1291	2022	0	33700	33700	2024-11-26
1291	2021	0	33700	33700	2024-11-26
1292	2023	0	186800	186800	2024-11-26
1292	2022	0	186800	186800	2024-11-26
1292	2021	0	186800	186800	2024-11-26
1298	2023	1015500	308700	1324200	2024-11-26
1298	2022	1014200	308700	1322900	2024-11-26
1298	2021	1009200	308700	1317900	2024-11-26
1299	2023	334900	124400	459300	2024-11-26
1299	2022	329400	124400	453800	2024-11-26
1299	2021	329400	124400	453800	2024-11-26
1302	2023	0	191600	191600	2024-11-26
1302	2022	0	191600	191600	2024-11-26
1302	2021	0	191600	191600	2024-11-26
1304	2023	830300	1532600	2362900	2024-11-26
1304	2022	830300	1532600	2362900	2024-11-26
1304	2021	830300	1532600	2362900	2024-11-26
1305	2023	3697300	337000	4034300	2024-11-26
1305	2022	3697300	337000	4034300	2024-11-26
1305	2021	3697300	337000	4034300	2024-11-26
1309	2023	0	198000	198000	2024-11-26
1309	2022	0	198000	198000	2024-11-26
1309	2021	0	198000	198000	2024-11-26
1311	2023	441600	237500	679100	2024-11-26
1311	2022	441600	237500	679100	2024-11-26
1311	2021	441600	237500	679100	2024-11-26
1312	2023	0	778800	778800	2024-11-26
1312	2022	0	778800	778800	2024-11-26
1312	2021	0	778800	778800	2024-11-26
1313	2023	266300	187800	454100	2024-11-26
1313	2022	241900	187800	429700	2024-11-26
1313	2021	241900	187800	429700	2024-11-26
1319	2023	5700	193700	199400	2024-11-26
1319	2022	5700	193700	199400	2024-11-26
1319	2021	5700	193700	199400	2024-11-26
1323	2023	405400	163300	568700	2024-11-26
1323	2022	402700	163300	566000	2024-11-26
1323	2021	402700	163300	566000	2024-11-26
1325	2023	224400	252600	477000	2024-11-26
1325	2022	207200	252600	459800	2024-11-26
1325	2021	207200	252600	459800	2024-11-26
1326	2023	788400	402300	1190700	2024-11-26
1326	2022	780700	402300	1183000	2024-11-26
1326	2021	780700	402300	1183000	2024-11-26
1327	2023	0	435200	435200	2024-11-26
1327	2022	0	435200	435200	2024-11-26
1327	2021	0	435200	435200	2024-11-26
1332	2023	0	48800	48800	2024-11-26
1332	2022	0	48800	48800	2024-11-26
1332	2021	0	48800	48800	2024-11-26
1333	2023	527300	330300	857600	2024-11-26
1333	2022	527300	330300	857600	2024-11-26
1333	2021	527300	330300	857600	2024-11-26
1335	2023	308200	254700	562900	2024-11-26
1335	2022	307900	254700	562600	2024-11-26
1335	2021	307900	254700	562600	2024-11-26
1336	2023	0	259300	259300	2024-11-26
1336	2022	0	259300	259300	2024-11-26
1336	2021	0	259300	259300	2024-11-26
1337	2023	0	253000	253000	2024-11-26
1337	2022	0	253000	253000	2024-11-26
1337	2021	0	253000	253000	2024-11-26
1338	2023	547800	204400	752200	2024-11-26
1338	2022	546500	204400	750900	2024-11-26
1338	2021	546500	204400	750900	2024-11-26
1340	2023	225000	195500	420500	2024-11-26
1340	2022	225000	195500	420500	2024-11-26
1340	2021	225000	195500	420500	2024-11-26
1341	2023	632100	202500	834600	2024-11-26
1341	2022	644800	202500	847300	2024-11-26
1341	2021	644800	202500	847300	2024-11-26
1342	2023	456000	230800	686800	2024-11-26
1342	2022	456000	230800	686800	2024-11-26
1342	2021	456000	230800	686800	2024-11-26
1343	2023	104100	198500	302600	2024-11-26
1343	2022	100700	198500	299200	2024-11-26
1343	2021	100700	198500	299200	2024-11-26
1344	2023	544800	1101700	1646500	2024-11-26
1344	2022	518400	1101700	1620100	2024-11-26
1344	2021	518400	1101700	1620100	2024-11-26
1352	2023	310500	456900	767400	2024-11-26
1352	2022	280600	456900	737500	2024-11-26
1352	2021	280600	456900	737500	2024-11-26
1353	2023	725400	336300	1061700	2024-11-26
1353	2022	716800	336300	1053100	2024-11-26
1353	2021	716800	336300	1053100	2024-11-26
1354	2023	328100	423800	751900	2024-11-26
1354	2022	328100	423800	751900	2024-11-26
1354	2021	328100	423800	751900	2024-11-26
1355	2023	0	251200	251200	2024-11-26
1355	2022	0	251200	251200	2024-11-26
1355	2021	0	251200	251200	2024-11-26
1356	2023	0	2464300	2464300	2024-11-26
1356	2022	0	2464300	2464300	2024-11-26
1356	2021	0	2464300	2464300	2024-11-26
1358	2023	0	30700	30700	2024-11-26
1358	2022	0	30700	30700	2024-11-26
1358	2021	0	30700	30700	2024-11-26
1360	2023	0	228600	228600	2024-11-26
1360	2022	0	228600	228600	2024-11-26
1360	2021	0	228600	228600	2024-11-26
1361	2023	0	142400	142400	2024-11-26
1361	2022	0	142400	142400	2024-11-26
1361	2021	0	142400	142400	2024-11-26
1362	2023	0	96100	96100	2024-11-26
1362	2022	0	96100	96100	2024-11-26
1362	2021	0	96100	96100	2024-11-26
1363	2023	0	89400	89400	2024-11-26
1363	2022	0	89400	89400	2024-11-26
1363	2021	0	89400	89400	2024-11-26
1364	2023	0	221800	221800	2024-11-26
1364	2022	0	221800	221800	2024-11-26
1364	2021	0	221800	221800	2024-11-26
1365	2023	0	29900	29900	2024-11-26
1365	2022	0	29900	29900	2024-11-26
1365	2021	0	29900	29900	2024-11-26
1366	2023	0	208500	208500	2024-11-26
1366	2022	0	208500	208500	2024-11-26
1366	2021	0	208500	208500	2024-11-26
1367	2023	1900	207700	209600	2024-11-26
1367	2022	1900	207700	209600	2024-11-26
1367	2021	1900	207700	209600	2024-11-26
1373	2023	969500	628900	1598400	2024-11-26
1373	2022	970800	628900	1599700	2024-11-26
1373	2021	970800	628900	1599700	2024-11-26
1374	2023	271300	225400	496700	2024-11-26
1374	2022	271300	225400	496700	2024-11-26
1374	2021	271300	225400	496700	2024-11-26
1375	2023	1454000	1846700	3300700	2024-11-26
1375	2022	1454000	1846700	3300700	2024-11-26
1375	2021	1454000	1846700	3300700	2024-11-26
1379	2023	0	144500	144500	2024-11-26
1379	2022	0	144500	144500	2024-11-26
1379	2021	0	144500	144500	2024-11-26
1382	2023	630500	345400	975900	2024-11-26
1382	2022	613200	345400	958600	2024-11-26
1382	2021	613200	345400	958600	2024-11-26
1384	2023	644500	589900	1234400	2024-11-26
1384	2022	633900	589900	1223800	2024-11-26
1384	2021	633900	589900	1223800	2024-11-26
1385	2023	485800	282700	768500	2024-11-26
1385	2022	485800	282700	768500	2024-11-26
1385	2021	596200	282700	878900	2024-11-26
1386	2023	800900	729700	1530600	2024-11-26
1386	2022	800900	729700	1530600	2024-11-26
1386	2021	800900	729700	1530600	2024-11-26
1387	2023	0	356000	356000	2024-11-26
1387	2022	0	356000	356000	2024-11-26
1387	2021	0	356000	356000	2024-11-26
1388	2023	0	264000	264000	2024-11-26
1388	2022	0	264000	264000	2024-11-26
1388	2021	0	264000	264000	2024-11-26
1389	2023	159400	206300	365700	2024-11-26
1389	2022	159400	206300	365700	2024-11-26
1389	2021	159400	206300	365700	2024-11-26
1394	2023	0	166300	166300	2024-11-26
1394	2022	0	166300	166300	2024-11-26
1394	2021	0	166300	166300	2024-11-26
1399	2023	0	61600	61600	2024-11-26
1399	2022	0	61600	61600	2024-11-26
1399	2021	0	61600	61600	2024-11-26
1400	2023	0	93700	93700	2024-11-26
1400	2022	0	93700	93700	2024-11-26
1400	2021	0	93700	93700	2024-11-26
1401	2023	0	49300	49300	2024-11-26
1401	2022	0	49300	49300	2024-11-26
1401	2021	0	49300	49300	2024-11-26
1402	2023	0	305600	305600	2024-11-26
1402	2022	0	305600	305600	2024-11-26
1402	2021	0	305600	305600	2024-11-26
1403	2023	0	8500	8500	2024-11-26
1403	2022	0	8500	8500	2024-11-26
1403	2021	0	8500	8500	2024-11-26
1406	2023	694100	684800	1378900	2024-11-26
1406	2022	703700	684800	1388500	2024-11-26
1406	2021	703700	684800	1388500	2024-11-26
1410	2023	165400	192800	358200	2024-11-26
1410	2022	165400	192800	358200	2024-11-26
1410	2021	165400	192800	358200	2024-11-26
1412	2023	105000	206900	311900	2024-11-26
1412	2022	105000	206900	311900	2024-11-26
1412	2021	105000	206900	311900	2024-11-26
1413	2023	0	86600	86600	2024-11-26
1413	2022	0	86600	86600	2024-11-26
1413	2021	0	86600	86600	2024-11-26
1417	2023	0	345400	345400	2024-11-26
1417	2022	0	345400	345400	2024-11-26
1417	2021	0	345400	345400	2024-11-26
1423	2023	0	342200	342200	2024-11-26
1423	2022	0	342200	342200	2024-11-26
1423	2021	0	342200	342200	2024-11-26
1435	2023	0	88300	88300	2024-11-26
1435	2022	0	88300	88300	2024-11-26
1435	2021	0	88300	88300	2024-11-26
1436	2023	0	57100	57100	2024-11-26
1436	2022	0	57100	57100	2024-11-26
1436	2021	0	57100	57100	2024-11-26
1437	2023	0	183500	183500	2024-11-26
1437	2022	0	183500	183500	2024-11-26
1437	2021	0	183500	183500	2024-11-26
1438	2023	0	177200	177200	2024-11-26
1438	2022	0	177200	177200	2024-11-26
1438	2021	0	177200	177200	2024-11-26
1439	2023	0	85000	85000	2024-11-26
1439	2022	0	85000	85000	2024-11-26
1439	2021	0	85000	85000	2024-11-26
1440	2023	0	404400	404400	2024-11-26
1440	2022	0	404400	404400	2024-11-26
1440	2021	0	404400	404400	2024-11-26
1441	2023	0	7500	7500	2024-11-26
1441	2022	0	7500	7500	2024-11-26
1441	2021	0	7500	7500	2024-11-26
1442	2023	0	10900	10900	2024-11-26
1442	2022	0	10900	10900	2024-11-26
1442	2021	0	10900	10900	2024-11-26
1443	2023	0	589400	589400	2024-11-26
1443	2022	0	589400	589400	2024-11-26
1443	2021	0	589400	589400	2024-11-26
1446	2023	0	630500	630500	2024-11-26
1446	2022	0	630500	630500	2024-11-26
1446	2021	0	630500	630500	2024-11-26
1447	2023	200	269800	270000	2024-11-26
1447	2022	200	269800	270000	2024-11-26
1447	2021	200	269800	270000	2024-11-26
1448	2023	0	282000	282000	2024-11-26
1448	2022	0	282000	282000	2024-11-26
1448	2021	0	282000	282000	2024-11-26
1449	2023	60900	274900	335800	2024-11-26
1449	2022	60700	274900	335600	2024-11-26
1449	2021	60700	274900	335600	2024-11-26
1450	2023	20000	73200	93200	2024-11-26
1450	2022	18900	73200	92100	2024-11-26
1450	2021	18900	73200	92100	2024-11-26
1451	2023	110600	145500	256100	2024-11-26
1451	2022	109100	145500	254600	2024-11-26
1451	2021	109100	145500	254600	2024-11-26
1455	2023	224900	230900	455800	2024-11-26
1455	2022	224900	230900	455800	2024-11-26
1455	2021	219200	230900	450100	2024-11-26
1456	2023	16800	173700	190500	2024-11-26
1456	2022	18300	173700	192000	2024-11-26
1456	2021	34800	173700	208500	2024-11-26
1457	2023	123900	159100	283000	2024-11-26
1457	2022	122000	159100	281100	2024-11-26
1457	2021	122000	159100	281100	2024-11-26
1462	2023	301600	439000	740600	2024-11-26
1462	2022	316800	439000	755800	2024-11-26
1462	2021	316800	439000	755800	2024-11-26
1464	2023	0	138700	138700	2024-11-26
1464	2022	0	138700	138700	2024-11-26
1464	2021	0	138700	138700	2024-11-26
1466	2023	0	368800	368800	2024-11-26
1466	2022	0	368800	368800	2024-11-26
1466	2021	0	368800	368800	2024-11-26
1468	2023	281600	366800	648400	2024-11-26
1468	2022	280800	366800	647600	2024-11-26
1468	2021	280800	366800	647600	2024-11-26
1469	2023	0	75600	75600	2024-11-26
1469	2022	0	75600	75600	2024-11-26
1469	2021	0	75600	75600	2024-11-26
1471	2023	12900	165800	178700	2024-11-26
1471	2022	13000	165800	178800	2024-11-26
1471	2021	13000	165800	178800	2024-11-26
1472	2023	59200	236400	295600	2024-11-26
1472	2022	56000	236400	292400	2024-11-26
1472	2021	51300	236400	287700	2024-11-26
1473	2023	167300	320800	488100	2024-11-26
1473	2022	163200	320800	484000	2024-11-26
1473	2021	163200	320800	484000	2024-11-26
1475	2023	72800	275600	348400	2024-11-26
1475	2022	64200	275600	339800	2024-11-26
1475	2021	32700	275600	308300	2024-11-26
1477	2023	94400	139000	233400	2024-11-26
1477	2022	94400	139000	233400	2024-11-26
1477	2021	95100	139000	234100	2024-11-26
1484	2023	114700	166100	280800	2024-11-26
1484	2022	105200	166100	271300	2024-11-26
1484	2021	105200	166100	271300	2024-11-26
1485	2023	152700	201200	353900	2024-11-26
1485	2022	152700	201200	353900	2024-11-26
1485	2021	152700	201200	353900	2024-11-26
1486	2023	276300	350100	626400	2024-11-26
1486	2022	270400	350100	620500	2024-11-26
1486	2021	270400	350100	620500	2024-11-26
1488	2023	0	332900	332900	2024-11-26
1488	2022	0	332900	332900	2024-11-26
1488	2021	0	332900	332900	2024-11-26
1489	2023	0	459000	459000	2024-11-26
1489	2022	0	459000	459000	2024-11-26
1489	2021	0	459000	459000	2024-11-26
100000	2023	765900	240800	1006700	2024-11-26
100000	2022	765900	240800	1006700	2024-11-26
100000	2021	765900	240800	1006700	2024-11-26
100021	2023	1128800	520300	1649100	2024-11-26
100021	2022	1128800	520300	1649100	2024-11-26
100021	2021	1128800	520300	1649100	2024-11-26
100041	2023	0	338400	338400	2024-11-26
100041	2022	0	338400	338400	2024-11-26
100041	2021	0	338400	338400	2024-11-26
100103	2023	234700	229200	463900	2024-11-26
100103	2022	234700	229200	463900	2024-11-26
100103	2021	234700	229200	463900	2024-11-26
100122	2023	386900	280400	667300	2024-11-26
100122	2022	386900	280400	667300	2024-11-26
100122	2021	386900	280400	667300	2024-11-26
100142	2023	217500	0	217500	2024-11-26
100142	2022	217500	0	217500	2024-11-26
100142	2021	217500	0	217500	2024-11-26
100162	2023	217500	0	217500	2024-11-26
100162	2022	217500	0	217500	2024-11-26
100162	2021	217500	0	217500	2024-11-26
100163	2023	251600	0	251600	2024-11-26
100163	2022	251600	0	251600	2024-11-26
100163	2021	251600	0	251600	2024-11-26
100164	2023	244700	0	244700	2024-11-26
100164	2022	244700	0	244700	2024-11-26
100164	2021	244700	0	244700	2024-11-26
100182	2023	377100	0	377100	2024-11-26
100182	2022	377100	0	377100	2024-11-26
100182	2021	377100	0	377100	2024-11-26
100184	2023	349600	0	349600	2024-11-26
100184	2022	349600	0	349600	2024-11-26
100184	2021	349600	0	349600	2024-11-26
100202	2023	0	848400	848400	2024-11-26
100202	2022	0	848400	848400	2024-11-26
100202	2021	0	848400	848400	2024-11-26
100243	2023	478200	229900	708100	2024-11-26
100243	2022	478200	229900	708100	2024-11-26
100243	2021	478200	229900	708100	2024-11-26
100262	2023	841700	257900	1099600	2024-11-26
100262	2022	826700	257900	1084600	2024-11-26
100262	2021	826700	257900	1084600	2024-11-26
100263	2023	609800	202300	812100	2024-11-26
100263	2022	609800	202300	812100	2024-11-26
100263	2021	609800	202300	812100	2024-11-26
100264	2023	0	208200	208200	2024-11-26
100264	2022	0	208200	208200	2024-11-26
100264	2021	0	208200	208200	2024-11-26
100265	2023	431900	203100	635000	2024-11-26
100265	2022	431900	203100	635000	2024-11-26
100265	2021	431900	203100	635000	2024-11-26
100282	2023	557500	190100	747600	2024-11-26
100282	2022	545900	190100	736000	2024-11-26
100282	2021	545900	190100	736000	2024-11-26
100302	2023	263600	206300	469900	2024-11-26
100302	2022	263600	206300	469900	2024-11-26
100302	2021	263600	206300	469900	2024-11-26
100322	2023	0	77200	77200	2024-11-26
100322	2022	0	77200	77200	2024-11-26
100322	2021	0	77200	77200	2024-11-26
100361	2023	0	83150	83150	2024-11-26
100361	2022	0	83150	83150	2024-11-26
100361	2021	0	83150	83150	2024-11-26
100401	2023	0	315200	315200	2024-11-26
100401	2022	0	315200	315200	2024-11-26
100401	2021	0	315200	315200	2024-11-26
100422	2023	451200	0	451200	2024-11-26
100422	2022	451200	0	451200	2024-11-26
100422	2021	451200	0	451200	2024-11-26
100442	2023	387700	0	387700	2024-11-26
100442	2022	387700	0	387700	2024-11-26
100442	2021	387700	0	387700	2024-11-26
100462	2023	204700	0	204700	2024-11-26
100462	2022	204700	0	204700	2024-11-26
100462	2021	204700	0	204700	2024-11-26
100463	2023	398200	0	398200	2024-11-26
100463	2022	398200	0	398200	2024-11-26
100463	2021	398200	0	398200	2024-11-26
100482	2023	212900	0	212900	2024-11-26
100482	2022	212900	0	212900	2024-11-26
100482	2021	212900	0	212900	2024-11-26
100502	2023	421200	0	421200	2024-11-26
100502	2022	421200	0	421200	2024-11-26
100502	2021	421200	0	421200	2024-11-26
100503	2023	261900	0	261900	2024-11-26
100503	2022	261900	0	261900	2024-11-26
100503	2021	261900	0	261900	2024-11-26
100522	2023	184400	0	184400	2024-11-26
100522	2022	184400	0	184400	2024-11-26
100522	2021	184400	0	184400	2024-11-26
100523	2023	332100	0	332100	2024-11-26
100523	2022	332100	0	332100	2024-11-26
100523	2021	332100	0	332100	2024-11-26
100542	2023	473800	0	473800	2024-11-26
100542	2022	473800	0	473800	2024-11-26
100542	2021	473800	0	473800	2024-11-26
100543	2023	543400	0	543400	2024-11-26
100543	2022	543400	0	543400	2024-11-26
100543	2021	543400	0	543400	2024-11-26
100562	2023	427400	0	427400	2024-11-26
100562	2022	427400	0	427400	2024-11-26
100562	2021	427400	0	427400	2024-11-26
100563	2023	340300	0	340300	2024-11-26
100563	2022	340300	0	340300	2024-11-26
100563	2021	340300	0	340300	2024-11-26
100582	2023	385200	0	385200	2024-11-26
100582	2022	385200	0	385200	2024-11-26
100582	2021	385200	0	385200	2024-11-26
100583	2023	1848200	0	1848200	2024-11-26
100583	2022	1848200	0	1848200	2024-11-26
100583	2021	1848200	0	1848200	2024-11-26
100602	2023	0	92900	92900	2024-11-26
100602	2022	0	92900	92900	2024-11-26
100602	2021	0	92900	92900	2024-11-26
100622	2023	0	54500	54500	2024-11-26
100622	2022	0	54500	54500	2024-11-26
100622	2021	0	54500	54500	2024-11-26
100642	2023	0	33000	33000	2024-11-26
100642	2022	0	33000	33000	2024-11-26
100642	2021	0	33000	33000	2024-11-26
100662	2023	0	354300	354300	2024-11-26
100662	2022	0	354300	354300	2024-11-26
100662	2021	0	354300	354300	2024-11-26
100722	2023	374200	176700	550900	2024-11-26
100722	2022	374200	176700	550900	2024-11-26
100722	2021	359600	176700	536300	2024-11-26
100742	2023	674200	317100	991300	2024-11-26
100742	2022	674200	317100	991300	2024-11-26
100742	2021	674200	317100	991300	2024-11-26
100822	2023	147600	709000	856600	2024-11-26
100822	2022	147600	633900	781500	2024-11-26
100822	2021	147600	633900	781500	2024-11-26
100863	2023	162900	104400	267300	2024-11-26
100863	2022	162900	104400	267300	2024-11-26
100863	2021	162900	104400	267300	2024-11-26
101082	2023	0	179500	179500	2024-11-26
101082	2022	0	179500	179500	2024-11-26
101082	2021	0	179500	179500	2024-11-26
101143	2023	531300	268600	799900	2024-11-26
101143	2022	531300	268600	799900	2024-11-26
101143	2021	588800	295700	884500	2024-11-26
101162	2023	273300	253100	526400	2024-11-26
101162	2022	273300	253100	526400	2024-11-26
101162	2021	273300	253100	526400	2024-11-26
101182	2023	457000	332800	789800	2024-11-26
101182	2022	457000	332800	789800	2024-11-26
101182	2021	457000	332800	789800	2024-11-26
101183	2023	0	65400	65400	2024-11-26
101183	2022	0	65400	65400	2024-11-26
101183	2021	0	65400	65400	2024-11-26
101202	2023	0	231200	231200	2024-11-26
101202	2022	0	231200	231200	2024-11-26
101202	2021	0	231200	231200	2024-11-26
101203	2023	0	244300	244300	2024-11-26
101203	2022	0	244300	244300	2024-11-26
101203	2021	0	244300	244300	2024-11-26
101204	2023	0	206800	206800	2024-11-26
101204	2022	0	206800	206800	2024-11-26
101204	2021	0	206800	206800	2024-11-26
101205	2023	0	213100	213100	2024-11-26
101205	2022	0	213100	213100	2024-11-26
101205	2021	0	213100	213100	2024-11-26
101224	2023	521700	249600	771300	2024-11-26
101224	2022	521700	249600	771300	2024-11-26
101224	2021	484500	249600	734100	2024-11-26
101242	2023	660000	249300	909300	2024-11-26
101242	2022	660000	249300	909300	2024-11-26
101242	2021	660000	249300	909300	2024-11-26
101243	2023	621200	221300	842500	2024-11-26
101243	2022	621200	221300	842500	2024-11-26
101243	2021	621200	221300	842500	2024-11-26
101262	2023	408800	243800	652600	2024-11-26
101262	2022	408800	243800	652600	2024-11-26
101262	2021	405400	243800	649200	2024-11-26
101282	2023	384200	458200	842400	2024-11-26
101282	2022	384200	458200	842400	2024-11-26
101282	2021	384200	458200	842400	2024-11-26
101325	2023	666300	454300	1120600	2024-11-26
101325	2022	628800	454300	1083100	2024-11-26
101325	2021	628800	454300	1083100	2024-11-26
101342	2023	812300	754500	1566800	2024-11-26
101342	2022	812300	754500	1566800	2024-11-26
101342	2021	810900	976100	1787000	2024-11-26
101362	2023	444400	258900	703300	2024-11-26
101362	2022	444400	258900	703300	2024-11-26
101362	2021	516900	258900	775800	2024-11-26
101382	2023	244600	228800	473400	2024-11-26
101382	2022	244600	228800	473400	2024-11-26
101382	2021	244400	228800	473200	2024-11-26
101442	2023	3500	400400	403900	2024-11-26
101442	2022	3500	400400	403900	2024-11-26
101442	2021	3500	400400	403900	2024-11-26
101462	2023	926800	191100	1117900	2024-11-26
101462	2022	926800	191100	1117900	2024-11-26
101462	2021	926800	191100	1117900	2024-11-26
101483	2023	200	144400	144600	2024-11-26
101483	2022	200	144400	144600	2024-11-26
101483	2021	200	144400	144600	2024-11-26
101502	2023	0	13400	13400	2024-11-26
101502	2022	0	13400	13400	2024-11-26
101502	2021	0	13400	13400	2024-11-26
101523	2023	319000	277400	596400	2024-11-26
101523	2022	319000	277400	596400	2024-11-26
101523	2021	319000	277400	596400	2024-11-26
101542	2023	203700	1088400	1292100	2024-11-26
101542	2022	203700	1088400	1292100	2024-11-26
101542	2021	203700	1088400	1292100	2024-11-26
101562	2023	900	379100	380000	2024-11-26
101562	2022	900	379100	380000	2024-11-26
101562	2021	900	379100	380000	2024-11-26
101582	2023	0	118800	118800	2024-11-26
101582	2022	0	118800	118800	2024-11-26
101582	2021	0	118800	118800	2024-11-26
101602	2023	243200	0	243200	2024-11-26
101602	2022	243200	0	243200	2024-11-26
101602	2021	243200	0	243200	2024-11-26
101622	2023	365500	174600	540100	2024-11-26
101622	2022	344800	174600	519400	2024-11-26
101622	2021	334300	174600	508900	2024-11-26
101642	2023	281900	144800	426700	2024-11-26
101642	2022	281900	144800	426700	2024-11-26
101642	2021	281900	144800	426700	2024-11-26
102644	2023	6300	141500	147800	2024-11-26
102644	2022	6300	141500	147800	2024-11-26
102644	2021	6300	141500	147800	2024-11-26
102691	2023	793000	474000	1267000	2024-11-26
102691	2022	791100	474000	1265100	2024-11-26
102691	2021	791100	474000	1265100	2024-11-26
102692	2023	645600	228300	873900	2024-11-26
102692	2022	645300	228300	873600	2024-11-26
102692	2021	645300	228300	873600	2024-11-26
102712	2023	11100	246900	258000	2024-11-26
102712	2022	11100	246900	258000	2024-11-26
102712	2021	11100	246900	258000	2024-11-26
102732	2023	36300	69300	105600	2024-11-26
102732	2022	36300	69300	105600	2024-11-26
102732	2021	36300	69300	105600	2024-11-26
102736	2023	425900	267000	692900	2024-11-26
102736	2022	425900	267000	692900	2024-11-26
102736	2021	425900	267000	692900	2024-11-26
102737	2023	672900	368500	1041400	2024-11-26
102737	2022	672900	368500	1041400	2024-11-26
102737	2021	672900	368500	1041400	2024-11-26
102759	2023	0	20100	20100	2024-11-26
102759	2022	0	20100	20100	2024-11-26
102759	2021	0	20100	20100	2024-11-26
102763	2023	0	324900	324900	2024-11-26
102763	2022	0	324900	324900	2024-11-26
102763	2021	0	324900	324900	2024-11-26
102766	2023	205000	174300	379300	2024-11-26
102766	2022	171800	174300	346100	2024-11-26
102766	2021	171800	174300	346100	2024-11-26
102768	2023	0	109300	109300	2024-11-26
102768	2022	0	109300	109300	2024-11-26
102768	2021	0	109300	109300	2024-11-26
102770	2023	692600	356200	1048800	2024-11-26
102770	2022	632600	356200	988800	2024-11-26
102770	2021	632600	356200	988800	2024-11-26
102771	2023	155400	136800	292200	2024-11-26
102771	2022	155400	136800	292200	2024-11-26
102771	2021	155400	136800	292200	2024-11-26
102772	2023	0	519500	519500	2024-11-26
102772	2022	0	519500	519500	2024-11-26
102772	2021	0	519500	519500	2024-11-26
102814	2023	49000	342900	391900	2024-11-26
102814	2022	49000	342900	391900	2024-11-26
102814	2021	49000	342900	391900	2024-11-26
102815	2023	0	126900	126900	2024-11-26
102815	2022	0	126900	126900	2024-11-26
102815	2021	0	126900	126900	2024-11-26
102834	2023	892800	522500	1415300	2024-11-26
102834	2022	860200	522500	1382700	2024-11-26
102834	2021	860200	522500	1382700	2024-11-26
102854	2023	67300	91400	158700	2024-11-26
102854	2022	67300	91400	158700	2024-11-26
102854	2021	67300	91400	158700	2024-11-26
102874	2023	0	207500	207500	2024-11-26
102874	2022	0	207500	207500	2024-11-26
102874	2021	0	207500	207500	2024-11-26
102875	2023	0	848300	848300	2024-11-26
102875	2022	0	848300	848300	2024-11-26
102875	2021	0	848300	848300	2024-11-26
102876	2023	0	327900	327900	2024-11-26
102876	2022	0	327900	327900	2024-11-26
102876	2021	0	327900	327900	2024-11-26
102896	2023	215600	215000	430600	2024-11-26
102896	2022	0	206700	206700	2024-11-26
102896	2021	0	206700	206700	2024-11-26
102897	2023	72500	280300	352800	2024-11-26
102897	2022	72500	280300	352800	2024-11-26
102897	2021	72500	280300	352800	2024-11-26
102916	2023	0	294700	294700	2024-11-26
102916	2022	0	294700	294700	2024-11-26
102916	2021	0	294700	294700	2024-11-26
102937	2023	5100	0	5100	2024-11-26
102937	2022	5700	0	5700	2024-11-26
102937	2021	6000	0	6000	2024-11-26
102956	2023	0	237100	237100	2024-11-26
102956	2022	0	237100	237100	2024-11-26
102956	2021	0	237100	237100	2024-11-26
102976	2023	37100	465700	502800	2024-11-26
102976	2022	37100	465700	502800	2024-11-26
102976	2021	37100	465700	502800	2024-11-26
102996	2023	0	443800	443800	2024-11-26
102996	2022	0	443800	443800	2024-11-26
102996	2021	0	443800	443800	2024-11-26
103016	2023	34800	299900	334700	2024-11-26
103016	2022	34800	299900	334700	2024-11-26
103016	2021	34800	299900	334700	2024-11-26
103036	2023	0	369500	369500	2024-11-26
103036	2022	0	369500	369500	2024-11-26
103036	2021	0	369500	369500	2024-11-26
103057	2023	327800	330000	657800	2024-11-26
103057	2022	327800	330000	657800	2024-11-26
103057	2021	327800	330000	657800	2024-11-26
103079	2023	0	218500	218500	2024-11-26
103079	2022	0	218500	218500	2024-11-26
103079	2021	0	218500	218500	2024-11-26
103097	2023	0	49900	49900	2024-11-26
103097	2022	0	49900	49900	2024-11-26
103097	2021	0	49900	49900	2024-11-26
103117	2023	37000	44500	81500	2024-11-26
103117	2022	37000	44500	81500	2024-11-26
103117	2021	37000	44500	81500	2024-11-26
103137	2023	50000	0	50000	2024-11-26
103137	2022	50000	0	50000	2024-11-26
103137	2021	50000	0	50000	2024-11-26
103157	2023	0	218000	218000	2024-11-26
103157	2022	0	218000	218000	2024-11-26
103157	2021	0	218000	218000	2024-11-26
103178	2023	33600	88000	121600	2024-11-26
103178	2022	33600	88000	121600	2024-11-26
103178	2021	33600	88000	121600	2024-11-26
103197	2023	227700	0	227700	2024-11-26
103197	2022	60000	0	60000	2024-11-26
103197	2021	60000	0	60000	2024-11-26
103218	2023	236500	0	236500	2024-11-26
103218	2022	401300	0	401300	2024-11-26
103218	2021	415200	0	415200	2024-11-26
103220	2023	0	1500	1500	2024-11-26
103220	2022	0	1500	1500	2024-11-26
103222	2023	0	223800	223800	2024-11-26
103222	2022	0	223800	223800	2024-11-26
103224	2023	251200	0	251200	2024-11-26
103224	2022	350700	0	350700	2024-11-26
103225	2023	63700	0	63700	2024-11-26
103225	2022	148500	0	148500	2024-11-26
103226	2023	108500	0	108500	2024-11-26
103226	2022	175000	0	175000	2024-11-26
103227	2023	79200	0	79200	2024-11-26
103227	2022	144800	0	144800	2024-11-26
103228	2023	73200	0	73200	2024-11-26
103228	2022	138900	0	138900	2024-11-26
103229	2023	72500	0	72500	2024-11-26
103229	2022	138000	0	138000	2024-11-26
103230	2023	85500	0	85500	2024-11-26
103230	2022	152100	0	152100	2024-11-26
103233	2023	74900	0	74900	2024-11-26
103233	2022	141100	0	141100	2024-11-26
103237	2023	74900	0	74900	2024-11-26
103237	2022	141000	0	141000	2024-11-26
103238	2023	72800	0	72800	2024-11-26
103238	2022	131100	0	131100	2024-11-26
103239	2023	78800	0	78800	2024-11-26
103239	2022	146200	0	146200	2024-11-26
103240	2023	79700	0	79700	2024-11-26
103240	2022	147300	0	147300	2024-11-26
103242	2023	72700	0	72700	2024-11-26
103242	2022	143100	0	143100	2024-11-26
103243	2023	78200	0	78200	2024-11-26
103243	2022	145400	0	145400	2024-11-26
103244	2023	74600	0	74600	2024-11-26
103244	2022	140800	0	140800	2024-11-26
103245	2023	90300	0	90300	2024-11-26
103245	2022	161100	0	161100	2024-11-26
103246	2023	73900	0	73900	2024-11-26
103246	2022	139800	0	139800	2024-11-26
103247	2023	73900	0	73900	2024-11-26
103247	2022	139800	0	139800	2024-11-26
103248	2023	86300	0	86300	2024-11-26
103248	2022	155900	0	155900	2024-11-26
103249	2023	75800	0	75800	2024-11-26
103249	2022	141600	0	141600	2024-11-26
103250	2023	88600	0	88600	2024-11-26
103250	2022	158900	0	158900	2024-11-26
103251	2023	31300	0	31300	2024-11-26
103251	2022	144800	0	144800	2024-11-26
103252	2023	102100	140400	242500	2024-11-26
103253	2023	0	12400	12400	2024-11-26
103254	2023	33800	154800	188600	2024-11-26
103255	2023	0	151400	151400	2024-11-26
103257	2023	0	137900	137900	2024-11-26
103258	No Data for PID				2024-11-26
103259	No Data for PID				2024-11-26
103260	No Data for PID				2024-11-26
103261	No Data for PID				2024-11-26
103262	No Data for PID				2024-11-26
