PID	App. Year	Improvements	Land	Total	CollectedOn
5	2022	93700	167600	261300	2023-08-17
5	2021	93700	167600	261300	2023-08-17
5	2020	80700	130200	210900	2023-08-17
7	2022	77200	104600	181800	2023-08-17
7	2021	77200	104600	181800	2023-08-17
7	2020	62000	88200	150200	2023-08-17
8	2022	114000	140400	254400	2023-08-17
8	2021	114000	140400	254400	2023-08-17
8	2020	106600	101200	207800	2023-08-17
9	2022	112100	157900	270000	2023-08-17
9	2021	108900	157900	266800	2023-08-17
9	2020	89500	121300	210800	2023-08-17
10	2022	254100	163000	417100	2023-08-17
10	2021	254100	163000	417100	2023-08-17
10	2020	254100	125900	380000	2023-08-17
12	2022	261800	225200	487000	2023-08-17
12	2021	261800	225200	487000	2023-08-17
12	2020	260800	171900	432700	2023-08-17
13	2022	275700	280700	556400	2023-08-17
13	2021	275700	280700	556400	2023-08-17
13	2020	257200	186800	444000	2023-08-17
16	2022	1016100	385700	1401800	2023-08-17
16	2021	1016100	385700	1401800	2023-08-17
16	2020	913900	292700	1206600	2023-08-17
18	2022	194000	139100	333100	2023-08-17
18	2021	162500	139100	301600	2023-08-17
18	2020	161500	138400	299900	2023-08-17
19	2022	125000	62300	187300	2023-08-17
19	2021	91700	62300	154000	2023-08-17
19	2020	82100	53500	135600	2023-08-17
20	2022	381400	234400	615800	2023-08-17
20	2021	381400	234400	615800	2023-08-17
20	2020	367500	206400	573900	2023-08-17
21	2022	398100	288400	686500	2023-08-17
21	2021	398100	288400	686500	2023-08-17
21	2020	409800	203600	613400	2023-08-17
22	2022	269300	179700	449000	2023-08-17
22	2021	269300	179700	449000	2023-08-17
22	2020	211300	178700	390000	2023-08-17
23	2022	233100	245600	478700	2023-08-17
23	2021	233100	245600	478700	2023-08-17
23	2020	227500	214300	441800	2023-08-17
25	2022	378700	170500	549200	2023-08-17
25	2021	410600	170500	581100	2023-08-17
25	2020	319400	149000	468400	2023-08-17
26	2022	144700	205300	350000	2023-08-17
26	2021	151100	205300	356400	2023-08-17
26	2020	143500	150400	293900	2023-08-17
27	2022	327100	210000	537100	2023-08-17
27	2021	326700	210000	536700	2023-08-17
27	2020	325200	184600	509800	2023-08-17
28	2022	298800	244000	542800	2023-08-17
28	2021	292900	244000	536900	2023-08-17
28	2020	284900	215400	500300	2023-08-17
29	2022	420400	235700	656100	2023-08-17
29	2021	420400	235700	656100	2023-08-17
29	2020	393200	207900	601100	2023-08-17
30	2022	275300	218200	493500	2023-08-17
30	2021	275800	218200	494000	2023-08-17
30	2020	273700	161800	435500	2023-08-17
32	2022	131000	146800	277800	2023-08-17
32	2021	131000	146800	277800	2023-08-17
32	2020	119100	154700	273800	2023-08-17
33	2022	176400	151600	328000	2023-08-17
33	2021	176400	151600	328000	2023-08-17
33	2020	148000	153900	301900	2023-08-17
34	2022	395200	157700	552900	2023-08-17
34	2021	395200	157700	552900	2023-08-17
34	2020	391300	166100	557400	2023-08-17
35	2022	0	29200	29200	2023-08-17
35	2021	0	29200	29200	2023-08-17
35	2020	0	24000	24000	2023-08-17
36	2022	303000	416200	719200	2023-08-17
36	2021	303000	416200	719200	2023-08-17
36	2020	404700	318600	723300	2023-08-17
37	2022	297500	353000	650500	2023-08-17
37	2021	297500	353000	650500	2023-08-17
37	2020	199500	286400	485900	2023-08-17
39	2022	569100	237000	806100	2023-08-17
39	2021	339700	237000	576700	2023-08-17
39	2020	421400	208700	630100	2023-08-17
40	2022	0	43000	43000	2023-08-17
40	2021	0	43000	43000	2023-08-17
40	2020	0	37300	37300	2023-08-17
41	2022	447000	186000	633000	2023-08-17
41	2021	447000	186000	633000	2023-08-17
41	2020	441600	175800	617400	2023-08-17
42	2022	269800	218700	488500	2023-08-17
42	2021	269800	218700	488500	2023-08-17
42	2020	246800	192400	439200	2023-08-17
43	2022	137300	208300	345600	2023-08-17
43	2021	137300	208300	345600	2023-08-17
43	2020	156300	163100	319400	2023-08-17
50	2022	194300	0	194300	2023-08-17
50	2021	194300	0	194300	2023-08-17
50	2020	150100	0	150100	2023-08-17
51	2022	197400	0	197400	2023-08-17
51	2021	197400	0	197400	2023-08-17
51	2020	144300	0	144300	2023-08-17
52	2022	184100	0	184100	2023-08-17
52	2021	184100	0	184100	2023-08-17
52	2020	141100	0	141100	2023-08-17
53	2022	208500	0	208500	2023-08-17
53	2021	208500	0	208500	2023-08-17
53	2020	162700	0	162700	2023-08-17
54	2022	179900	0	179900	2023-08-17
54	2021	179900	0	179900	2023-08-17
54	2020	137400	0	137400	2023-08-17
55	2022	195600	0	195600	2023-08-17
55	2021	195600	0	195600	2023-08-17
55	2020	151200	0	151200	2023-08-17
56	2022	976100	234500	1210600	2023-08-17
56	2021	926400	234500	1160900	2023-08-17
56	2020	908500	186700	1095200	2023-08-17
57	2022	734700	230000	964700	2023-08-17
57	2021	734700	230000	964700	2023-08-17
57	2020	714200	202400	916600	2023-08-17
58	2022	653600	262000	915600	2023-08-17
58	2021	653600	262000	915600	2023-08-17
58	2020	604000	255500	859500	2023-08-17
59	2022	355300	156500	511800	2023-08-17
59	2021	355300	156500	511800	2023-08-17
59	2020	331100	165000	496100	2023-08-17
60	2022	485100	218900	704000	2023-08-17
60	2021	485100	218900	704000	2023-08-17
60	2020	442800	192600	635400	2023-08-17
62	2022	498400	163900	662300	2023-08-17
62	2021	485300	163900	649200	2023-08-17
62	2020	404000	172100	576100	2023-08-17
63	2022	258400	232100	490500	2023-08-17
63	2021	258400	232100	490500	2023-08-17
63	2020	182300	204300	386600	2023-08-17
64	2022	103900	218200	322100	2023-08-17
64	2021	103900	218200	322100	2023-08-17
64	2020	100700	161800	262500	2023-08-17
65	2022	436100	228900	665000	2023-08-17
65	2021	316000	228900	544900	2023-08-17
65	2020	288100	201400	489500	2023-08-17
66	2022	218800	230900	449700	2023-08-17
66	2021	218800	230900	449700	2023-08-17
66	2020	205200	203200	408400	2023-08-17
67	2022	0	103200	103200	2023-08-17
67	2021	0	103200	103200	2023-08-17
67	2020	0	87400	87400	2023-08-17
68	2022	127000	157100	284100	2023-08-17
68	2021	127000	157100	284100	2023-08-17
68	2020	136000	120600	256600	2023-08-17
69	2022	0	8600	8600	2023-08-17
69	2021	0	8600	8600	2023-08-17
69	2020	0	8400	8400	2023-08-17
76	2022	519800	234400	754200	2023-08-17
76	2021	519800	234400	754200	2023-08-17
76	2020	537500	206400	743900	2023-08-17
77	2022	343500	234900	578400	2023-08-17
77	2021	343500	234900	578400	2023-08-17
77	2020	338100	206800	544900	2023-08-17
78	2022	173800	216500	390300	2023-08-17
78	2021	173800	216500	390300	2023-08-17
78	2020	132600	190400	323000	2023-08-17
79	2022	116800	216500	333300	2023-08-17
79	2021	116800	216500	333300	2023-08-17
79	2020	105400	190200	295600	2023-08-17
80	2022	301600	317200	618800	2023-08-17
80	2021	301600	317200	618800	2023-08-17
80	2020	226900	265000	491900	2023-08-17
81	2022	92200	233300	325500	2023-08-17
81	2021	139400	290400	429800	2023-08-17
81	2020	119100	255500	374600	2023-08-17
82	2022	217700	199300	417000	2023-08-17
82	2021	217700	199300	417000	2023-08-17
82	2020	157800	186800	344600	2023-08-17
83	2022	190300	161800	352100	2023-08-17
83	2021	189900	161800	351700	2023-08-17
83	2020	151100	170400	321500	2023-08-17
84	2022	3187200	2000100	5187300	2023-08-17
84	2021	3187200	2000100	5187300	2023-08-17
84	2020	2800400	1387500	4187900	2023-08-17
85	2022	0	16900	16900	2023-08-17
85	2021	0	16900	16900	2023-08-17
85	2020	0	16400	16400	2023-08-17
86	2022	471700	228900	700600	2023-08-17
86	2021	471700	228900	700600	2023-08-17
86	2020	422300	201400	623700	2023-08-17
87	2022	379700	256000	635700	2023-08-17
87	2021	379700	256000	635700	2023-08-17
87	2020	373400	225400	598800	2023-08-17
88	2022	43200	113400	156600	2023-08-17
88	2021	43200	113400	156600	2023-08-17
88	2020	36900	75200	112100	2023-08-17
89	2022	252300	375600	627900	2023-08-17
89	2021	252300	375600	627900	2023-08-17
89	2020	272500	334800	607300	2023-08-17
91	2022	526300	277000	803300	2023-08-17
91	2021	526300	277000	803300	2023-08-17
91	2020	548900	191900	740800	2023-08-17
92	2022	77800	179500	257300	2023-08-17
92	2021	77800	179500	257300	2023-08-17
92	2020	63100	149400	212500	2023-08-17
93	2022	548900	204300	753200	2023-08-17
93	2021	475800	204300	680100	2023-08-17
93	2020	298700	188200	486900	2023-08-17
94	2022	385500	179200	564700	2023-08-17
94	2021	385500	179200	564700	2023-08-17
94	2020	266600	178700	445300	2023-08-17
95	2022	410100	207600	617700	2023-08-17
95	2021	410100	207600	617700	2023-08-17
95	2020	287100	189100	476200	2023-08-17
99	2022	328500	0	328500	2023-08-17
99	2021	328500	0	328500	2023-08-17
99	2020	308800	0	308800	2023-08-17
101	2022	543900	0	543900	2023-08-17
101	2021	543900	0	543900	2023-08-17
101	2020	543200	0	543200	2023-08-17
102	2022	7500	104000	111500	2023-08-17
102	2021	7500	104000	111500	2023-08-17
102	2020	7500	91900	99400	2023-08-17
103	2022	121800	185100	306900	2023-08-17
103	2021	121800	185100	306900	2023-08-17
103	2020	116200	162700	278900	2023-08-17
104	2022	1055000	394300	1449300	2023-08-17
104	2021	1055000	394300	1449300	2023-08-17
104	2020	923900	298600	1222500	2023-08-17
105	2022	236100	274300	510400	2023-08-17
105	2021	236100	274300	510400	2023-08-17
105	2020	219000	249200	468200	2023-08-17
106	2022	1421000	488300	1909300	2023-08-17
106	2021	1421000	488300	1909300	2023-08-17
106	2020	1164400	388300	1552700	2023-08-17
107	2022	359500	263700	623200	2023-08-17
107	2021	359500	263700	623200	2023-08-17
107	2020	340500	233900	574400	2023-08-17
111	2022	4400	424700	429100	2023-08-17
111	2021	4400	424700	429100	2023-08-17
111	2020	4000	337700	341700	2023-08-17
115	2022	51000	194200	245200	2023-08-17
115	2021	221200	258500	479700	2023-08-17
115	2020	168500	214900	383400	2023-08-17
116	2022	249500	148200	397700	2023-08-17
116	2021	249500	148200	397700	2023-08-17
116	2020	222400	119300	341700	2023-08-17
117	2022	426300	0	426300	2023-08-17
117	2021	426300	0	426300	2023-08-17
117	2020	388500	0	388500	2023-08-17
118	2022	155800	405100	560900	2023-08-17
118	2021	155800	405100	560900	2023-08-17
118	2020	143400	287600	431000	2023-08-17
120	2022	462100	360800	822900	2023-08-17
120	2021	462100	360800	822900	2023-08-17
120	2020	461500	277700	739200	2023-08-17
121	2022	2900	143700	146600	2023-08-17
121	2021	2400	143700	146100	2023-08-17
121	2020	73600	115200	188800	2023-08-17
122	2022	273000	133300	406300	2023-08-17
122	2021	273000	133300	406300	2023-08-17
122	2020	223700	105800	329500	2023-08-17
123	2022	151900	132200	284100	2023-08-17
123	2021	151900	132200	284100	2023-08-17
123	2020	120600	105500	226100	2023-08-17
124	2022	354900	223000	577900	2023-08-17
124	2021	354900	223000	577900	2023-08-17
124	2020	326200	140700	466900	2023-08-17
125	2022	272000	155700	427700	2023-08-17
125	2021	272000	155700	427700	2023-08-17
125	2020	227400	119300	346700	2023-08-17
127	2022	240200	153300	393500	2023-08-17
127	2021	240200	153300	393500	2023-08-17
127	2020	263100	114100	377200	2023-08-17
128	2022	395000	188500	583500	2023-08-17
128	2021	395000	188500	583500	2023-08-17
128	2020	416100	111500	527600	2023-08-17
129	2022	182300	157500	339800	2023-08-17
129	2021	182300	157500	339800	2023-08-17
129	2020	170700	124600	295300	2023-08-17
132	2022	0	40300	40300	2023-08-17
132	2021	0	40300	40300	2023-08-17
132	2020	0	33700	33700	2023-08-17
133	2022	42000	0	42000	2023-08-17
133	2021	42000	0	42000	2023-08-17
133	2020	38500	0	38500	2023-08-17
136	2022	15200	12200	27400	2023-08-17
136	2021	15200	12200	27400	2023-08-17
136	2020	13400	9700	23100	2023-08-17
137	2022	46900	189400	236300	2023-08-17
137	2021	46900	189400	236300	2023-08-17
137	2020	42400	154600	197000	2023-08-17
138	2022	1194500	246000	1440500	2023-08-17
138	2021	1194500	246000	1440500	2023-08-17
138	2020	1092000	237600	1329600	2023-08-17
139	2022	81400	166400	247800	2023-08-17
139	2021	81400	166400	247800	2023-08-17
139	2020	73400	132400	205800	2023-08-17
140	2022	575300	151500	726800	2023-08-17
140	2021	575300	151500	726800	2023-08-17
140	2020	531800	156000	687800	2023-08-17
142	2022	183800	209900	393700	2023-08-17
142	2021	183800	209900	393700	2023-08-17
142	2020	190500	184600	375100	2023-08-17
143	2022	334100	206900	541000	2023-08-17
143	2021	334100	206900	541000	2023-08-17
143	2020	289400	181800	471200	2023-08-17
144	2022	145200	133000	278200	2023-08-17
144	2021	144800	133000	277800	2023-08-17
144	2020	138000	111800	249800	2023-08-17
148	2022	163800	142700	306500	2023-08-17
148	2021	163800	142700	306500	2023-08-17
148	2020	138200	108700	246900	2023-08-17
149	2022	385600	171200	556800	2023-08-17
149	2021	385600	171200	556800	2023-08-17
149	2020	290200	130100	420300	2023-08-17
150	2022	410700	170200	580900	2023-08-17
150	2021	410700	170200	580900	2023-08-17
150	2020	124300	129200	253500	2023-08-17
151	2022	0	218500	218500	2023-08-17
151	2021	0	218500	218500	2023-08-17
151	2020	0	137300	137300	2023-08-17
152	2022	176000	84800	260800	2023-08-17
152	2021	175200	84800	260000	2023-08-17
152	2020	130800	70400	201200	2023-08-17
153	2022	149400	111300	260700	2023-08-17
153	2021	149400	111300	260700	2023-08-17
153	2020	138400	90300	228700	2023-08-17
154	2022	82500	82400	164900	2023-08-17
154	2021	82500	82400	164900	2023-08-17
154	2020	66800	72000	138800	2023-08-17
159	2022	21200	166100	187300	2023-08-17
159	2021	21200	166100	187300	2023-08-17
159	2020	17900	127200	145100	2023-08-17
161	2022	562100	219600	781700	2023-08-17
161	2021	562100	219600	781700	2023-08-17
161	2020	592300	158900	751200	2023-08-17
162	2022	165400	126800	292200	2023-08-17
162	2021	165400	126800	292200	2023-08-17
162	2020	165400	97100	262500	2023-08-17
163	2022	269600	158900	428500	2023-08-17
163	2021	269600	158900	428500	2023-08-17
163	2020	298800	97300	396100	2023-08-17
164	2022	46200	98300	144500	2023-08-17
164	2021	46200	98300	144500	2023-08-17
164	2020	38900	83100	122000	2023-08-17
167	2022	289300	224000	513300	2023-08-17
167	2021	289300	224000	513300	2023-08-17
167	2020	279800	110300	390100	2023-08-17
168	2022	174500	129600	304100	2023-08-17
168	2021	174500	129600	304100	2023-08-17
168	2020	146700	98800	245500	2023-08-17
169	2022	154200	111100	265300	2023-08-17
169	2021	154200	111100	265300	2023-08-17
169	2020	130800	92200	223000	2023-08-17
170	2022	1225500	266800	1492300	2023-08-17
170	2021	1225500	266800	1492300	2023-08-17
170	2020	1095300	204200	1299500	2023-08-17
171	2022	0	144500	144500	2023-08-17
171	2021	0	144500	144500	2023-08-17
171	2020	0	106000	106000	2023-08-17
172	2022	0	161400	161400	2023-08-17
172	2021	0	161400	161400	2023-08-17
172	2020	0	119400	119400	2023-08-17
173	2022	465200	146600	611800	2023-08-17
173	2021	465200	154000	619200	2023-08-17
173	2020	361400	117800	479200	2023-08-17
174	2022	152300	132200	284500	2023-08-17
174	2021	152300	132200	284500	2023-08-17
174	2020	136900	100500	237400	2023-08-17
176	2022	156600	137900	294500	2023-08-17
176	2021	156600	137900	294500	2023-08-17
176	2020	116500	105000	221500	2023-08-17
177	2022	81400	129800	211200	2023-08-17
177	2021	85100	129800	214900	2023-08-17
177	2020	92300	88300	180600	2023-08-17
178	2022	231800	126600	358400	2023-08-17
178	2021	231800	126600	358400	2023-08-17
178	2020	205300	97000	302300	2023-08-17
179	2022	149400	138100	287500	2023-08-17
179	2021	149400	138100	287500	2023-08-17
179	2020	140700	105200	245900	2023-08-17
180	2022	597800	284700	882500	2023-08-17
180	2021	597800	284700	882500	2023-08-17
180	2020	557700	289900	847600	2023-08-17
181	2022	0	333600	333600	2023-08-17
181	2021	0	333600	333600	2023-08-17
181	2020	0	246600	246600	2023-08-17
182	2022	507900	233200	741100	2023-08-17
182	2021	507900	233200	741100	2023-08-17
182	2020	520800	267400	788200	2023-08-17
183	2022	282900	103000	385900	2023-08-17
183	2021	10900	103000	113900	2023-08-17
183	2020	12500	67000	79500	2023-08-17
187	2022	314000	322400	636400	2023-08-17
187	2021	351200	344600	695800	2023-08-17
187	2020	259400	268200	527600	2023-08-17
188	2022	613900	312400	926300	2023-08-17
188	2021	329500	275100	604600	2023-08-17
188	2020	234300	213100	447400	2023-08-17
189	2022	8500	129600	138100	2023-08-17
189	2021	8500	129600	138100	2023-08-17
189	2020	7800	111900	119700	2023-08-17
190	2022	0	59200	59200	2023-08-17
190	2021	0	59200	59200	2023-08-17
190	2020	0	52800	52800	2023-08-17
191	2022	0	204100	204100	2023-08-17
191	2021	0	204100	204100	2023-08-17
191	2020	0	184700	184700	2023-08-17
192	2022	0	689600	689600	2023-08-17
192	2021	0	689600	689600	2023-08-17
192	2020	0	576600	576600	2023-08-17
194	2022	0	22300	22300	2023-08-17
194	2021	0	22300	22300	2023-08-17
194	2020	0	10800	10800	2023-08-17
195	2022	343500	176200	519700	2023-08-17
195	2021	343500	176200	519700	2023-08-17
195	2020	328100	138000	466100	2023-08-17
197	2022	0	166600	166600	2023-08-17
197	2021	0	166600	166600	2023-08-17
197	2020	0	154300	154300	2023-08-17
201	2022	322700	251700	574400	2023-08-17
201	2021	322700	251700	574400	2023-08-17
201	2020	350000	229300	579300	2023-08-17
202	2022	418600	774500	1193100	2023-08-17
202	2021	392300	774500	1166800	2023-08-17
202	2020	377800	664500	1042300	2023-08-17
203	2022	232400	125100	357500	2023-08-17
203	2021	232400	125100	357500	2023-08-17
203	2020	195200	93600	288800	2023-08-17
204	2022	396000	484700	880700	2023-08-17
204	2021	396000	484700	880700	2023-08-17
204	2020	256600	318000	574600	2023-08-17
206	2022	606800	227800	834600	2023-08-17
206	2021	606800	227800	834600	2023-08-17
206	2020	566800	186800	753600	2023-08-17
207	2022	1700	647500	649200	2023-08-17
207	2021	1700	647500	649200	2023-08-17
207	2020	1500	578300	579800	2023-08-17
208	2022	180600	142400	323000	2023-08-17
208	2021	180600	142400	323000	2023-08-17
208	2020	172800	98300	271100	2023-08-17
209	2022	124500	143300	267800	2023-08-17
209	2021	119000	143300	262300	2023-08-17
209	2020	102800	99100	201900	2023-08-17
210	2022	193800	143300	337100	2023-08-17
210	2021	193800	143300	337100	2023-08-17
210	2020	186600	99100	285700	2023-08-17
217	2022	0	476800	476800	2023-08-17
217	2021	0	476800	476800	2023-08-17
217	2020	0	259100	259100	2023-08-17
219	2022	176100	164500	340600	2023-08-17
219	2021	176100	164500	340600	2023-08-17
219	2020	189400	99100	288500	2023-08-17
220	2022	180400	108100	288500	2023-08-17
220	2021	180400	108100	288500	2023-08-17
220	2020	140700	82700	223400	2023-08-17
221	2022	221900	95600	317500	2023-08-17
221	2021	221900	95600	317500	2023-08-17
221	2020	173600	73500	247100	2023-08-17
222	2022	269100	168700	437800	2023-08-17
222	2021	269100	168700	437800	2023-08-17
222	2020	232300	126700	359000	2023-08-17
223	2022	334100	175300	509400	2023-08-17
223	2021	322900	175300	498200	2023-08-17
223	2020	288000	157200	445200	2023-08-17
224	2022	234300	215300	449600	2023-08-17
224	2021	234300	215300	449600	2023-08-17
224	2020	222000	167900	389900	2023-08-17
225	2022	86100	176600	262700	2023-08-17
225	2021	86100	176600	262700	2023-08-17
225	2020	73100	113900	187000	2023-08-17
229	2022	312700	179600	492300	2023-08-17
229	2021	312700	179600	492300	2023-08-17
229	2020	290000	105400	395400	2023-08-17
230	2022	0	218200	218200	2023-08-17
230	2021	0	218200	218200	2023-08-17
230	2020	0	175200	175200	2023-08-17
231	2022	82800	91300	174100	2023-08-17
231	2021	82800	91300	174100	2023-08-17
231	2020	57100	69500	126600	2023-08-17
232	2022	72200	57800	130000	2023-08-17
232	2021	72200	57800	130000	2023-08-17
232	2020	54200	52500	106700	2023-08-17
233	2022	81500	65100	146600	2023-08-17
233	2021	81500	65100	146600	2023-08-17
233	2020	59900	59000	118900	2023-08-17
234	2022	228500	134400	362900	2023-08-17
234	2021	228500	134400	362900	2023-08-17
234	2020	234500	78100	312600	2023-08-17
235	2022	455900	169300	625200	2023-08-17
235	2021	455900	169300	625200	2023-08-17
235	2020	403100	107900	511000	2023-08-17
236	2022	184400	119700	304100	2023-08-17
236	2021	184400	119700	304100	2023-08-17
236	2020	152400	67800	220200	2023-08-17
237	2022	45100	88200	133300	2023-08-17
237	2021	45100	88200	133300	2023-08-17
237	2020	39500	53000	92500	2023-08-17
238	2022	149100	133300	282400	2023-08-17
238	2021	149100	133300	282400	2023-08-17
238	2020	108100	93500	201600	2023-08-17
241	2022	143900	719400	863300	2023-08-17
241	2021	143900	719400	863300	2023-08-17
241	2020	120900	621400	742300	2023-08-17
243	2022	0	9700	9700	2023-08-17
243	2021	0	9700	9700	2023-08-17
243	2020	0	8800	8800	2023-08-17
244	2022	0	800	800	2023-08-17
244	2021	0	800	800	2023-08-17
244	2020	0	700	700	2023-08-17
245	2022	193200	115700	308900	2023-08-17
245	2021	193200	115700	308900	2023-08-17
245	2020	98100	86300	184400	2023-08-17
246	2022	0	300300	300300	2023-08-17
246	2021	0	300300	300300	2023-08-17
246	2020	0	253600	253600	2023-08-17
247	2022	13400	149200	162600	2023-08-17
247	2021	13400	149200	162600	2023-08-17
247	2020	10400	92900	103300	2023-08-17
248	2022	126300	137700	264000	2023-08-17
248	2021	126300	137700	264000	2023-08-17
248	2020	144000	105500	249500	2023-08-17
249	2022	155900	144300	300200	2023-08-17
249	2021	155900	144300	300200	2023-08-17
249	2020	167400	122000	289400	2023-08-17
250	2022	0	341700	341700	2023-08-17
250	2021	0	341700	341700	2023-08-17
250	2020	0	280000	280000	2023-08-17
251	2022	367000	349100	716100	2023-08-17
251	2021	367000	349100	716100	2023-08-17
251	2020	163700	287200	450900	2023-08-17
252	2022	176700	251500	428200	2023-08-17
252	2021	176700	251500	428200	2023-08-17
252	2020	155600	191800	347400	2023-08-17
253	2022	212100	150400	362500	2023-08-17
253	2021	212100	150400	362500	2023-08-17
253	2020	187200	116400	303600	2023-08-17
254	2022	356800	460900	817700	2023-08-17
254	2021	356800	460900	817700	2023-08-17
254	2020	243100	398600	641700	2023-08-17
255	2022	471100	129400	600500	2023-08-17
255	2021	435400	129400	564800	2023-08-17
255	2020	188200	99500	287700	2023-08-17
256	2022	1367900	364300	1732200	2023-08-17
256	2021	1367900	364300	1732200	2023-08-17
256	2020	1251500	237700	1489200	2023-08-17
257	2022	56900	130700	187600	2023-08-17
257	2021	56900	130700	187600	2023-08-17
257	2020	67900	100700	168600	2023-08-17
258	2022	378800	0	378800	2023-08-17
258	2021	378800	0	378800	2023-08-17
258	2020	347600	0	347600	2023-08-17
259	2022	2454700	592700	3047400	2023-08-17
259	2021	2454700	592700	3047400	2023-08-17
259	2020	2190400	492700	2683100	2023-08-17
260	2022	82600	164500	247100	2023-08-17
260	2021	82600	164500	247100	2023-08-17
260	2020	61100	157300	218400	2023-08-17
267	2022	66900	122600	189500	2023-08-17
267	2021	66900	122600	189500	2023-08-17
267	2020	36300	96600	132900	2023-08-17
270	2022	54400	117800	172200	2023-08-17
270	2021	54400	117800	172200	2023-08-17
270	2020	33700	92300	126000	2023-08-17
271	2022	293800	127600	421400	2023-08-17
271	2021	293800	127600	421400	2023-08-17
271	2020	313300	78200	391500	2023-08-17
272	2022	0	11300	11300	2023-08-17
272	2021	0	11300	11300	2023-08-17
272	2020	0	9000	9000	2023-08-17
273	2022	32800	100700	133500	2023-08-17
273	2021	32800	100700	133500	2023-08-17
273	2020	25700	69300	95000	2023-08-17
274	2022	230700	139000	369700	2023-08-17
274	2021	230700	139000	369700	2023-08-17
274	2020	197900	101700	299600	2023-08-17
275	2022	15500	109800	125300	2023-08-17
275	2021	30200	109800	140000	2023-08-17
275	2020	14200	84200	98400	2023-08-17
276	2022	133100	173400	306500	2023-08-17
276	2021	133100	173400	306500	2023-08-17
276	2020	122700	167400	290100	2023-08-17
277	2022	0	58200	58200	2023-08-17
277	2021	0	58200	58200	2023-08-17
277	2020	0	48300	48300	2023-08-17
278	2022	147100	303100	450200	2023-08-17
278	2021	159300	313600	472900	2023-08-17
278	2020	72200	277900	350100	2023-08-17
279	2022	161300	176800	338100	2023-08-17
279	2021	161300	176800	338100	2023-08-17
279	2020	123600	148700	272300	2023-08-17
280	2022	0	431500	431500	2023-08-17
280	2021	0	431500	431500	2023-08-17
280	2020	0	351300	351300	2023-08-17
283	2022	25500	171600	197100	2023-08-17
283	2021	25500	171600	197100	2023-08-17
283	2020	32600	130600	163200	2023-08-17
287	2022	566500	297100	863600	2023-08-17
287	2021	566500	297100	863600	2023-08-17
287	2020	518800	278200	797000	2023-08-17
288	2022	245600	328100	573700	2023-08-17
288	2021	245600	328100	573700	2023-08-17
288	2020	204100	307200	511300	2023-08-17
290	2022	618200	454000	1072200	2023-08-17
290	2021	618200	454000	1072200	2023-08-17
290	2020	269000	476100	745100	2023-08-17
291	2022	0	139200	139200	2023-08-17
291	2021	0	139200	139200	2023-08-17
291	2020	0	117400	117400	2023-08-17
292	2022	"($18,800)"	569300	550500	2023-08-17
292	2021	376400	569300	945700	2023-08-17
292	2020	317300	495300	812600	2023-08-17
294	2022	411100	386400	797500	2023-08-17
294	2021	411100	386400	797500	2023-08-17
294	2020	378500	325400	703900	2023-08-17
295	2022	132400	104100	236500	2023-08-17
295	2021	132400	104100	236500	2023-08-17
295	2020	130300	90500	220800	2023-08-17
296	2022	131100	0	131100	2023-08-17
296	2021	131100	0	131100	2023-08-17
296	2020	127600	0	127600	2023-08-17
297	2022	40800	88400	129200	2023-08-17
297	2021	40800	88400	129200	2023-08-17
297	2020	31400	70400	101800	2023-08-17
298	2022	168100	118200	286300	2023-08-17
298	2021	168100	118200	286300	2023-08-17
298	2020	130400	95400	225800	2023-08-17
299	2022	108200	133400	241600	2023-08-17
299	2021	108200	133400	241600	2023-08-17
299	2020	100300	95400	195700	2023-08-17
300	2022	116500	93400	209900	2023-08-17
300	2021	116500	93400	209900	2023-08-17
300	2020	105200	84900	190100	2023-08-17
301	2022	197200	235000	432200	2023-08-17
301	2021	197200	235000	432200	2023-08-17
301	2020	150800	189000	339800	2023-08-17
303	2022	392100	179200	571300	2023-08-17
303	2021	392100	179200	571300	2023-08-17
303	2020	310800	142900	453700	2023-08-17
306	2022	252100	220000	472100	2023-08-17
306	2021	254500	220000	474500	2023-08-17
306	2020	173800	201400	375200	2023-08-17
307	2022	498100	362500	860600	2023-08-17
307	2021	498100	362500	860600	2023-08-17
307	2020	498800	322000	820800	2023-08-17
308	2022	280100	196600	476700	2023-08-17
308	2021	280100	196600	476700	2023-08-17
308	2020	274500	150300	424800	2023-08-17
309	2022	283000	571900	854900	2023-08-17
309	2021	283000	571900	854900	2023-08-17
309	2020	264700	473100	737800	2023-08-17
310	2022	511300	244800	756100	2023-08-17
310	2021	511300	244800	756100	2023-08-17
310	2020	475100	234000	709100	2023-08-17
311	2022	0	637800	637800	2023-08-17
311	2021	0	637800	637800	2023-08-17
311	2020	0	537000	537000	2023-08-17
313	2022	675600	661400	1337000	2023-08-17
313	2021	675600	661400	1337000	2023-08-17
313	2020	606600	695100	1301700	2023-08-17
315	2022	484200	174900	659100	2023-08-17
315	2021	484200	174900	659100	2023-08-17
315	2020	437000	136800	573800	2023-08-17
316	2022	229500	180700	410200	2023-08-17
316	2021	229500	180700	410200	2023-08-17
316	2020	228100	143200	371300	2023-08-17
317	2022	361800	152900	514700	2023-08-17
317	2021	361800	152900	514700	2023-08-17
317	2020	361600	127700	489300	2023-08-17
319	2022	381800	222900	604700	2023-08-17
319	2021	381800	222900	604700	2023-08-17
319	2020	351600	172500	524100	2023-08-17
320	2022	0	433100	433100	2023-08-17
320	2021	0	433100	433100	2023-08-17
320	2020	0	395000	395000	2023-08-17
321	2022	74900	140500	215400	2023-08-17
321	2021	74900	140500	215400	2023-08-17
321	2020	67200	99000	166200	2023-08-17
322	2022	0	273200	273200	2023-08-17
322	2021	0	273200	273200	2023-08-17
322	2020	0	226200	226200	2023-08-17
323	2022	150100	143800	293900	2023-08-17
323	2021	149300	143800	293100	2023-08-17
323	2020	119400	110400	229800	2023-08-17
324	2022	319900	137800	457700	2023-08-17
324	2021	319900	137800	457700	2023-08-17
324	2020	303200	99600	402800	2023-08-17
325	2022	750700	251100	1001800	2023-08-17
325	2021	750700	251100	1001800	2023-08-17
325	2020	713100	197900	911000	2023-08-17
326	2022	327800	180100	507900	2023-08-17
326	2021	327800	180100	507900	2023-08-17
326	2020	338700	138200	476900	2023-08-17
327	2022	252500	153200	405700	2023-08-17
327	2021	244400	153200	397600	2023-08-17
327	2020	166900	103600	270500	2023-08-17
328	2022	178800	161000	339800	2023-08-17
328	2021	178800	161000	339800	2023-08-17
328	2020	201300	124200	325500	2023-08-17
329	2022	110800	93200	204000	2023-08-17
329	2021	130800	93200	224000	2023-08-17
329	2020	105000	83900	188900	2023-08-17
330	2022	216200	201200	417400	2023-08-17
330	2021	228000	201200	429200	2023-08-17
330	2020	176300	161800	338100	2023-08-17
331	2022	62500	131800	194300	2023-08-17
331	2021	62500	131800	194300	2023-08-17
331	2020	75800	95300	171100	2023-08-17
333	2022	0	15700	15700	2023-08-17
333	2021	0	15700	15700	2023-08-17
333	2020	0	12100	12100	2023-08-17
334	2022	459600	318400	778000	2023-08-17
334	2021	459600	318400	778000	2023-08-17
334	2020	375400	284300	659700	2023-08-17
335	2022	103500	157100	260600	2023-08-17
335	2021	103500	157100	260600	2023-08-17
335	2020	121500	119100	240600	2023-08-17
336	2022	210700	158300	369000	2023-08-17
336	2021	210700	158300	369000	2023-08-17
336	2020	205600	120200	325800	2023-08-17
337	2022	630400	197400	827800	2023-08-17
337	2021	630400	197400	827800	2023-08-17
337	2020	656400	120600	777000	2023-08-17
339	2022	153000	140300	293300	2023-08-17
339	2021	153000	140300	293300	2023-08-17
339	2020	170300	89400	259700	2023-08-17
340	2022	382600	176700	559300	2023-08-17
340	2021	389200	199000	588200	2023-08-17
340	2020	350400	132800	483200	2023-08-17
341	2022	191600	123800	315400	2023-08-17
341	2021	191600	123800	315400	2023-08-17
341	2020	149100	80700	229800	2023-08-17
343	2022	238400	197200	435600	2023-08-17
343	2021	238400	197200	435600	2023-08-17
343	2020	220700	159000	379700	2023-08-17
344	2022	265500	504500	770000	2023-08-17
344	2021	265500	504500	770000	2023-08-17
344	2020	178700	452100	630800	2023-08-17
345	2022	288300	153300	441600	2023-08-17
345	2021	288300	153300	441600	2023-08-17
345	2020	248600	119100	367700	2023-08-17
346	2022	256900	159200	416100	2023-08-17
346	2021	256900	159200	416100	2023-08-17
346	2020	195900	119000	314900	2023-08-17
347	2022	8800	293500	302300	2023-08-17
347	2021	8800	293500	302300	2023-08-17
347	2020	8200	241900	250100	2023-08-17
348	2022	287400	149400	436800	2023-08-17
348	2021	287400	149400	436800	2023-08-17
348	2020	301800	115500	417300	2023-08-17
349	2022	0	102600	102600	2023-08-17
349	2021	0	102600	102600	2023-08-17
349	2020	0	93300	93300	2023-08-17
350	2022	0	52200	52200	2023-08-17
350	2021	0	52200	52200	2023-08-17
350	2020	0	45700	45700	2023-08-17
351	2022	284700	148900	433600	2023-08-17
351	2021	284700	148900	433600	2023-08-17
351	2020	276100	115000	391100	2023-08-17
355	2022	0	330300	330300	2023-08-17
355	2021	0	330300	330300	2023-08-17
355	2020	0	279100	279100	2023-08-17
357	2022	0	159000	159000	2023-08-17
357	2021	0	159000	159000	2023-08-17
357	2020	0	124500	124500	2023-08-17
358	2022	0	9300	9300	2023-08-17
358	2021	0	9300	9300	2023-08-17
358	2020	0	8400	8400	2023-08-17
359	2022	92400	135100	227500	2023-08-17
359	2021	92400	135100	227500	2023-08-17
359	2020	71900	97200	169100	2023-08-17
360	2022	128100	101800	229900	2023-08-17
360	2021	128100	101800	229900	2023-08-17
360	2020	93600	84300	177900	2023-08-17
361	2022	344600	367400	712000	2023-08-17
361	2021	344600	367400	712000	2023-08-17
361	2020	315000	311700	626700	2023-08-17
363	2022	392400	128100	520500	2023-08-17
363	2021	391000	128100	519100	2023-08-17
363	2020	314800	108300	423100	2023-08-17
364	2022	114400	98300	212700	2023-08-17
364	2021	114400	98300	212700	2023-08-17
364	2020	83300	72900	156200	2023-08-17
365	2022	544900	502900	1047800	2023-08-17
365	2021	544900	502900	1047800	2023-08-17
365	2020	538500	426400	964900	2023-08-17
368	2022	242900	111700	354600	2023-08-17
368	2021	242900	111700	354600	2023-08-17
368	2020	238100	102400	340500	2023-08-17
369	2022	477100	445900	923000	2023-08-17
369	2021	477100	445900	923000	2023-08-17
369	2020	450900	417800	868700	2023-08-17
370	2022	0	312000	312000	2023-08-17
370	2021	0	312000	312000	2023-08-17
370	2020	0	255600	255600	2023-08-17
371	2022	342300	166800	509100	2023-08-17
371	2021	342300	166800	509100	2023-08-17
371	2020	323100	154400	477500	2023-08-17
372	2022	219900	208700	428600	2023-08-17
372	2021	219900	208700	428600	2023-08-17
372	2020	209400	199900	409300	2023-08-17
375	2022	0	244100	244100	2023-08-17
375	2021	0	303100	303100	2023-08-17
375	2020	0	156600	156600	2023-08-17
376	2022	387900	326200	714100	2023-08-17
376	2021	387900	326200	714100	2023-08-17
376	2020	330500	292100	622600	2023-08-17
377	2022	34900	462600	497500	2023-08-17
377	2021	34900	462600	497500	2023-08-17
377	2020	42400	386700	429100	2023-08-17
378	2022	345600	142700	488300	2023-08-17
378	2021	345600	142700	488300	2023-08-17
378	2020	266300	122400	388700	2023-08-17
379	2022	65300	118000	183300	2023-08-17
379	2021	60600	118000	178600	2023-08-17
379	2020	39200	104100	143300	2023-08-17
380	2022	184800	157400	342200	2023-08-17
380	2021	184800	157400	342200	2023-08-17
380	2020	156000	125500	281500	2023-08-17
381	2022	73000	107800	180800	2023-08-17
381	2021	73000	107800	180800	2023-08-17
381	2020	61200	86800	148000	2023-08-17
382	2022	150900	158900	309800	2023-08-17
382	2021	150900	158900	309800	2023-08-17
382	2020	131200	139200	270400	2023-08-17
383	2022	0	376700	376700	2023-08-17
383	2021	0	376700	376700	2023-08-17
383	2020	0	314100	314100	2023-08-17
384	2022	115100	446700	561800	2023-08-17
384	2021	115100	446700	561800	2023-08-17
384	2020	34500	404600	439100	2023-08-17
385	2022	285900	172600	458500	2023-08-17
385	2021	285900	172600	458500	2023-08-17
385	2020	248400	188900	437300	2023-08-17
387	2022	0	32300	32300	2023-08-17
387	2021	0	32300	32300	2023-08-17
387	2020	0	23100	23100	2023-08-17
388	2022	0	73500	73500	2023-08-17
388	2021	0	73500	73500	2023-08-17
388	2020	0	60800	60800	2023-08-17
389	2022	267800	112600	380400	2023-08-17
389	2021	267800	112600	380400	2023-08-17
389	2020	266600	100400	367000	2023-08-17
390	2022	0	454600	454600	2023-08-17
390	2021	0	454600	454600	2023-08-17
390	2020	0	397500	397500	2023-08-17
391	2022	147800	321300	469100	2023-08-17
391	2021	147800	321300	469100	2023-08-17
391	2020	78600	252200	330800	2023-08-17
392	2022	490000	360400	850400	2023-08-17
392	2021	490100	360300	850400	2023-08-17
392	2020	439200	285600	724800	2023-08-17
394	2022	371100	355400	726500	2023-08-17
394	2021	371100	355400	726500	2023-08-17
394	2020	366000	281200	647200	2023-08-17
395	2022	332100	335700	667800	2023-08-17
395	2021	319100	335700	654800	2023-08-17
395	2020	289500	314100	603600	2023-08-17
398	2022	777200	1621300	2398500	2023-08-17
398	2021	777200	1621300	2398500	2023-08-17
398	2020	601100	327800	928900	2023-08-17
399	2022	354400	297700	652100	2023-08-17
399	2021	352100	297700	649800	2023-08-17
399	2020	312000	312000	624000	2023-08-17
400	2022	339100	163100	502200	2023-08-17
400	2021	339100	163100	502200	2023-08-17
400	2020	312500	136600	449100	2023-08-17
401	2022	0	1188900	1188900	2023-08-17
401	2021	0	1188900	1188900	2023-08-17
401	2020	0	1058500	1058500	2023-08-17
402	2022	1367100	1205000	2572100	2023-08-17
402	2021	1367100	1205000	2572100	2023-08-17
402	2020	1353500	950900	2304400	2023-08-17
405	2022	146300	143300	289600	2023-08-17
405	2021	147800	143300	291100	2023-08-17
405	2020	109200	109200	218400	2023-08-17
407	2022	0	420900	420900	2023-08-17
407	2021	0	420900	420900	2023-08-17
407	2020	0	339600	339600	2023-08-17
408	2022	171500	148500	320000	2023-08-17
408	2021	171500	148500	320000	2023-08-17
408	2020	139800	163400	303200	2023-08-17
415	2022	242800	371700	614500	2023-08-17
415	2021	242800	371700	614500	2023-08-17
415	2020	184700	317800	502500	2023-08-17
417	2022	34800	608700	643500	2023-08-17
417	2021	34800	608700	643500	2023-08-17
417	2020	34200	509600	543800	2023-08-17
418	2022	432100	205700	637800	2023-08-17
418	2021	442900	205700	648600	2023-08-17
418	2020	404000	207500	611500	2023-08-17
427	2022	317000	162800	479800	2023-08-17
427	2021	317000	162800	479800	2023-08-17
427	2020	260700	131000	391700	2023-08-17
429	2022	553700	262800	816500	2023-08-17
429	2021	553700	262800	816500	2023-08-17
429	2020	474700	322700	797400	2023-08-17
432	2022	0	23700	23700	2023-08-17
432	2021	0	23700	23700	2023-08-17
432	2020	0	19200	19200	2023-08-17
433	2022	37700	104500	142200	2023-08-17
433	2021	37700	104500	142200	2023-08-17
433	2020	53300	76500	129800	2023-08-17
434	2022	58600	184300	242900	2023-08-17
434	2021	58600	184300	242900	2023-08-17
434	2020	50400	122300	172700	2023-08-17
435	2022	104100	221200	325300	2023-08-17
435	2021	104100	221200	325300	2023-08-17
435	2020	112300	164300	276600	2023-08-17
436	2022	57700	187000	244700	2023-08-17
436	2021	60300	205800	266100	2023-08-17
436	2020	37300	165200	202500	2023-08-17
437	2022	682800	378100	1060900	2023-08-17
437	2021	674600	378100	1052700	2023-08-17
437	2020	475100	298400	773500	2023-08-17
438	2022	308800	261700	570500	2023-08-17
438	2021	308800	261700	570500	2023-08-17
438	2020	254000	232800	486800	2023-08-17
439	2022	0	6400	6400	2023-08-17
439	2021	0	6400	6400	2023-08-17
439	2020	0	5000	5000	2023-08-17
440	2022	53000	228900	281900	2023-08-17
440	2021	53000	228900	281900	2023-08-17
440	2020	43900	179000	222900	2023-08-17
441	2022	404100	455200	859300	2023-08-17
441	2021	393000	455200	848200	2023-08-17
441	2020	382300	346700	729000	2023-08-17
442	2022	229500	196700	426200	2023-08-17
442	2021	229500	196700	426200	2023-08-17
442	2020	240600	162200	402800	2023-08-17
446	2022	417800	344100	761900	2023-08-17
446	2021	417800	344100	761900	2023-08-17
446	2020	433400	828900	1262300	2023-08-17
447	2022	191200	228500	419700	2023-08-17
447	2021	191200	228500	419700	2023-08-17
447	2020	151800	246200	398000	2023-08-17
448	2022	396900	307500	704400	2023-08-17
448	2021	396900	307500	704400	2023-08-17
448	2020	379100	235200	614300	2023-08-17
450	2022	561400	1063100	1624500	2023-08-17
450	2021	561400	1057000	1618400	2023-08-17
450	2020	483000	994400	1477400	2023-08-17
454	2022	586600	840000	1426600	2023-08-17
454	2021	586400	840000	1426400	2023-08-17
454	2020	471100	750400	1221500	2023-08-17
457	2022	818800	409400	1228200	2023-08-17
457	2021	818800	409400	1228200	2023-08-17
457	2020	666000	459900	1125900	2023-08-17
458	2022	234800	272600	507400	2023-08-17
458	2021	234800	272600	507400	2023-08-17
458	2020	239700	235400	475100	2023-08-17
459	2022	293400	192000	485400	2023-08-17
459	2021	293400	192000	485400	2023-08-17
459	2020	235200	206500	441700	2023-08-17
460	2022	479100	279000	758100	2023-08-17
460	2021	479100	279000	758100	2023-08-17
460	2020	391500	236900	628400	2023-08-17
461	2022	714600	311800	1026400	2023-08-17
461	2021	673400	311800	985200	2023-08-17
461	2020	299300	249700	549000	2023-08-17
462	2022	544600	246100	790700	2023-08-17
462	2021	544600	246100	790700	2023-08-17
462	2020	438100	167700	605800	2023-08-17
463	2022	0	372200	372200	2023-08-17
463	2021	0	372200	372200	2023-08-17
463	2020	0	295500	295500	2023-08-17
465	2022	0	250900	250900	2023-08-17
465	2021	0	250900	250900	2023-08-17
465	2020	0	195500	195500	2023-08-17
469	2022	725500	271500	997000	2023-08-17
469	2021	725500	271500	997000	2023-08-17
469	2020	598800	240800	839600	2023-08-17
472	2022	715000	241600	956600	2023-08-17
472	2021	715000	241600	956600	2023-08-17
472	2020	586900	214600	801500	2023-08-17
473	2022	535100	210400	745500	2023-08-17
473	2021	535100	210400	745500	2023-08-17
473	2020	427400	186100	613500	2023-08-17
474	2022	358800	200000	558800	2023-08-17
474	2021	358800	200000	558800	2023-08-17
474	2020	322500	176700	499200	2023-08-17
475	2022	472000	379600	851600	2023-08-17
475	2021	472000	379600	851600	2023-08-17
475	2020	492300	317100	809400	2023-08-17
476	2022	285600	334600	620200	2023-08-17
476	2021	285600	334600	620200	2023-08-17
476	2020	261600	345100	606700	2023-08-17
478	2022	270800	522200	793000	2023-08-17
478	2021	270800	522200	793000	2023-08-17
478	2020	218200	506600	724800	2023-08-17
479	2022	750500	609400	1359900	2023-08-17
479	2021	750500	609400	1359900	2023-08-17
479	2020	724800	582700	1307500	2023-08-17
480	2022	233500	232000	465500	2023-08-17
480	2021	247100	232000	479100	2023-08-17
480	2020	182700	192300	375000	2023-08-17
482	2022	308300	229800	538100	2023-08-17
482	2021	308300	229800	538100	2023-08-17
482	2020	302700	189400	492100	2023-08-17
483	2022	0	700	700	2023-08-17
483	2021	0	700	700	2023-08-17
483	2020	0	600	600	2023-08-17
484	2022	431700	182200	613900	2023-08-17
484	2021	431700	182200	613900	2023-08-17
484	2020	387300	164200	551500	2023-08-17
486	2022	367800	218100	585900	2023-08-17
486	2021	367800	218100	585900	2023-08-17
486	2020	269200	196800	466000	2023-08-17
487	2022	165100	180000	345100	2023-08-17
487	2021	165100	180000	345100	2023-08-17
487	2020	163300	162200	325500	2023-08-17
488	2022	309400	248800	558200	2023-08-17
488	2021	309400	248800	558200	2023-08-17
488	2020	228000	265200	493200	2023-08-17
489	2022	225500	253700	479200	2023-08-17
489	2021	225500	253700	479200	2023-08-17
489	2020	306000	244300	550300	2023-08-17
490	2022	289700	211700	501400	2023-08-17
490	2021	289700	211700	501400	2023-08-17
490	2020	195900	249200	445100	2023-08-17
491	2022	311300	608300	919600	2023-08-17
491	2021	311300	608300	919600	2023-08-17
491	2020	439800	607900	1047700	2023-08-17
492	2022	146800	198600	345400	2023-08-17
492	2021	124500	198600	323100	2023-08-17
492	2020	112200	145600	257800	2023-08-17
493	2022	442700	693200	1135900	2023-08-17
493	2021	442700	693200	1135900	2023-08-17
493	2020	367000	683200	1050200	2023-08-17
494	2022	978200	559900	1538100	2023-08-17
494	2021	978200	559900	1538100	2023-08-17
494	2020	888400	515400	1403800	2023-08-17
495	2022	308000	333700	641700	2023-08-17
495	2021	308000	333700	641700	2023-08-17
495	2020	240400	323400	563800	2023-08-17
501	2022	63500	199300	262800	2023-08-17
501	2021	63500	199300	262800	2023-08-17
501	2020	65000	159200	224200	2023-08-17
505	2022	704800	688900	1393700	2023-08-17
505	2021	704800	688900	1393700	2023-08-17
505	2020	615900	571800	1187700	2023-08-17
506	2022	580400	356800	937200	2023-08-17
506	2021	580400	356800	937200	2023-08-17
506	2020	490100	315000	805100	2023-08-17
507	2022	"($43,300)"	653800	610500	2023-08-17
507	2021	326000	653800	979800	2023-08-17
507	2020	283000	562500	845500	2023-08-17
509	2022	339400	260800	600200	2023-08-17
509	2021	339400	260800	600200	2023-08-17
509	2020	346600	229600	576200	2023-08-17
510	2022	406200	343100	749300	2023-08-17
510	2021	406200	343100	749300	2023-08-17
510	2020	383700	348900	732600	2023-08-17
511	2022	196100	212500	408600	2023-08-17
511	2021	196100	212500	408600	2023-08-17
511	2020	190500	202000	392500	2023-08-17
512	2022	0	265100	265100	2023-08-17
512	2021	0	265100	265100	2023-08-17
512	2020	0	212700	212700	2023-08-17
513	2022	275900	214600	490500	2023-08-17
513	2021	275900	214600	490500	2023-08-17
513	2020	233800	249000	482800	2023-08-17
514	2022	365300	357000	722300	2023-08-17
514	2021	365300	357000	722300	2023-08-17
514	2020	330700	373200	703900	2023-08-17
515	2022	173600	187700	361300	2023-08-17
515	2021	173600	187700	361300	2023-08-17
515	2020	156900	180400	337300	2023-08-17
517	2022	331700	281800	613500	2023-08-17
517	2021	331700	281800	613500	2023-08-17
517	2020	279200	262000	541200	2023-08-17
518	2022	290800	217800	508600	2023-08-17
518	2021	290800	217800	508600	2023-08-17
518	2020	275100	177700	452800	2023-08-17
519	2022	142100	156900	299000	2023-08-17
519	2021	142100	156900	299000	2023-08-17
519	2020	124600	125100	249700	2023-08-17
520	2022	482800	204900	687700	2023-08-17
520	2021	482800	204900	687700	2023-08-17
520	2020	392700	164000	556700	2023-08-17
522	2022	133200	162100	295300	2023-08-17
522	2021	133200	162100	295300	2023-08-17
522	2020	118100	116600	234700	2023-08-17
526	2022	133300	217300	350600	2023-08-17
526	2021	133300	217300	350600	2023-08-17
526	2020	112300	155900	268200	2023-08-17
527	2022	312700	207400	520100	2023-08-17
527	2021	312700	207400	520100	2023-08-17
527	2020	342300	166300	508600	2023-08-17
529	2022	159300	181700	341000	2023-08-17
529	2021	159300	181700	341000	2023-08-17
529	2020	138200	145200	283400	2023-08-17
530	2022	458500	301900	760400	2023-08-17
530	2021	458500	301900	760400	2023-08-17
530	2020	496700	258000	754700	2023-08-17
532	2022	58700	182400	241100	2023-08-17
532	2021	58700	182400	241100	2023-08-17
532	2020	54400	160700	215100	2023-08-17
533	2022	561200	270000	831200	2023-08-17
533	2021	561200	270000	831200	2023-08-17
533	2020	497900	324100	822000	2023-08-17
537	2022	544100	312100	856200	2023-08-17
537	2021	544100	312100	856200	2023-08-17
537	2020	601700	274900	876600	2023-08-17
538	2022	379300	259400	638700	2023-08-17
538	2021	377000	259400	636400	2023-08-17
538	2020	336800	252900	589700	2023-08-17
540	2022	296800	300900	597700	2023-08-17
540	2021	296800	300900	597700	2023-08-17
540	2020	244500	305400	549900	2023-08-17
542	2022	184300	147700	332000	2023-08-17
542	2021	177800	147700	325500	2023-08-17
542	2020	164900	130300	295200	2023-08-17
543	2022	0	54100	54100	2023-08-17
543	2021	0	54100	54100	2023-08-17
543	2020	0	44300	44300	2023-08-17
544	2022	62700	171200	233900	2023-08-17
544	2021	62700	171200	233900	2023-08-17
544	2020	47900	113500	161400	2023-08-17
545	2022	109800	168200	278000	2023-08-17
545	2021	102700	168200	270900	2023-08-17
545	2020	86300	111000	197300	2023-08-17
546	2022	115400	217500	332900	2023-08-17
546	2021	115400	217500	332900	2023-08-17
546	2020	107900	178400	286300	2023-08-17
547	2022	175800	185500	361300	2023-08-17
547	2021	175800	185500	361300	2023-08-17
547	2020	168900	156700	325600	2023-08-17
552	2022	3600	276400	280000	2023-08-17
552	2021	3600	276400	280000	2023-08-17
552	2020	3500	247500	251000	2023-08-17
557	2022	114900	203800	318700	2023-08-17
557	2021	114900	203800	318700	2023-08-17
557	2020	91600	151000	242600	2023-08-17
558	2022	45800	161200	207000	2023-08-17
558	2021	45800	161200	207000	2023-08-17
558	2020	50400	127300	177700	2023-08-17
559	2022	300300	270400	570700	2023-08-17
559	2021	300300	270400	570700	2023-08-17
559	2020	257700	278200	535900	2023-08-17
560	2022	123400	162900	286300	2023-08-17
560	2021	123400	162900	286300	2023-08-17
560	2020	123500	128700	252200	2023-08-17
561	2022	0	12200	12200	2023-08-17
561	2021	0	12200	12200	2023-08-17
561	2020	0	11900	11900	2023-08-17
563	2022	344200	236700	580900	2023-08-17
563	2021	344200	236700	580900	2023-08-17
563	2020	299500	204300	503800	2023-08-17
564	2022	497800	657500	1155300	2023-08-17
564	2021	497800	657500	1155300	2023-08-17
564	2020	421500	550300	971800	2023-08-17
565	2022	247800	332200	580000	2023-08-17
565	2021	247800	332200	580000	2023-08-17
565	2020	256000	250200	506200	2023-08-17
569	2022	730600	508400	1239000	2023-08-17
569	2021	732700	508400	1241100	2023-08-17
569	2020	802700	447800	1250500	2023-08-17
570	2022	184400	577900	762300	2023-08-17
570	2021	184400	578000	762400	2023-08-17
570	2020	138500	487100	625600	2023-08-17
571	2022	169100	180000	349100	2023-08-17
571	2021	169100	180000	349100	2023-08-17
571	2020	120400	158500	278900	2023-08-17
572	2022	155200	183900	339100	2023-08-17
572	2021	181000	183900	364900	2023-08-17
572	2020	31500	117100	148600	2023-08-17
575	2022	862000	1131400	1993400	2023-08-17
575	2021	862000	1131400	1993400	2023-08-17
575	2020	731800	765900	1497700	2023-08-17
576	2022	2084100	1274800	3358900	2023-08-17
576	2021	2084100	1349300	3433400	2023-08-17
576	2020	1802900	943100	2746000	2023-08-17
578	2022	881300	822200	1703500	2023-08-17
578	2021	881300	1036100	1917400	2023-08-17
578	2020	931500	654800	1586300	2023-08-17
579	2022	443300	267200	710500	2023-08-17
579	2021	443300	267200	710500	2023-08-17
579	2020	360800	284400	645200	2023-08-17
580	2022	0	19300	19300	2023-08-17
580	2021	0	19300	19300	2023-08-17
580	2020	0	17500	17500	2023-08-17
581	2022	174700	567800	742500	2023-08-17
581	2021	169200	567800	737000	2023-08-17
581	2020	153400	521200	674600	2023-08-17
582	2022	1700400	671400	2371800	2023-08-17
582	2021	971900	671400	1643300	2023-08-17
582	2020	519000	518200	1037200	2023-08-17
584	2022	561900	531100	1093000	2023-08-17
584	2021	561900	531100	1093000	2023-08-17
584	2020	454200	550800	1005000	2023-08-17
591	2022	0	346300	346300	2023-08-17
591	2021	0	346300	346300	2023-08-17
591	2020	0	258900	258900	2023-08-17
592	2022	0	190200	190200	2023-08-17
592	2021	0	190200	190200	2023-08-17
592	2020	0	144900	144900	2023-08-17
593	2022	234800	372000	606800	2023-08-17
593	2021	234800	372000	606800	2023-08-17
593	2020	155100	330600	485700	2023-08-17
594	2022	541800	257000	798800	2023-08-17
594	2021	541800	257000	798800	2023-08-17
594	2020	459400	257300	716700	2023-08-17
597	2022	689900	399500	1089400	2023-08-17
597	2021	689900	399500	1089400	2023-08-17
597	2020	623600	376500	1000100	2023-08-17
598	2022	0	35000	35000	2023-08-17
598	2021	0	35000	35000	2023-08-17
598	2020	0	30000	30000	2023-08-17
600	2022	133000	128800	261800	2023-08-17
600	2021	133000	128800	261800	2023-08-17
600	2020	137600	109600	247200	2023-08-17
603	2022	0	250000	250000	2023-08-17
603	2021	0	250000	250000	2023-08-17
603	2020	0	254000	254000	2023-08-17
605	2022	189700	133300	323000	2023-08-17
605	2021	189700	133300	323000	2023-08-17
605	2020	192500	100000	292500	2023-08-17
607	2022	243800	191800	435600	2023-08-17
607	2021	243800	191800	435600	2023-08-17
607	2020	236400	133400	369800	2023-08-17
611	2022	672000	460500	1132500	2023-08-17
611	2021	672000	460500	1132500	2023-08-17
611	2020	600800	416800	1017600	2023-08-17
616	2022	403700	153200	556900	2023-08-17
616	2021	403700	153200	556900	2023-08-17
616	2020	285900	118900	404800	2023-08-17
617	2022	175400	155200	330600	2023-08-17
617	2021	153300	155200	308500	2023-08-17
617	2020	133900	126800	260700	2023-08-17
618	2022	83100	280100	363200	2023-08-17
618	2021	83100	280100	363200	2023-08-17
618	2020	89400	223900	313300	2023-08-17
620	2022	0	70300	70300	2023-08-17
620	2021	0	70300	70300	2023-08-17
620	2020	0	63800	63800	2023-08-17
621	2022	147500	203200	350700	2023-08-17
621	2021	147400	203200	350600	2023-08-17
621	2020	107100	169600	276700	2023-08-17
622	2022	97700	138300	236000	2023-08-17
622	2021	97700	138300	236000	2023-08-17
622	2020	94200	110600	204800	2023-08-17
623	2022	89500	210200	299700	2023-08-17
623	2021	89500	210200	299700	2023-08-17
623	2020	63100	155500	218600	2023-08-17
624	2022	301300	291700	593000	2023-08-17
624	2021	301300	291700	593000	2023-08-17
624	2020	281600	254600	536200	2023-08-17
625	2022	553700	220500	774200	2023-08-17
625	2021	553700	220500	774200	2023-08-17
625	2020	583700	191200	774900	2023-08-17
626	2022	428100	297700	725800	2023-08-17
626	2021	428100	297700	725800	2023-08-17
626	2020	317100	265600	582700	2023-08-17
627	2022	0	32700	32700	2023-08-17
627	2021	0	32700	32700	2023-08-17
627	2020	0	29800	29800	2023-08-17
633	2022	0	585800	585800	2023-08-17
633	2021	0	585800	585800	2023-08-17
633	2020	0	521100	521100	2023-08-17
634	2022	0	287800	287800	2023-08-17
634	2021	0	287800	287800	2023-08-17
634	2020	0	260700	260700	2023-08-17
635	2022	0	4200	4200	2023-08-17
635	2021	0	4200	4200	2023-08-17
635	2020	0	2900	2900	2023-08-17
636	2022	0	4200	4200	2023-08-17
636	2021	0	4200	4200	2023-08-17
636	2020	0	3300	3300	2023-08-17
637	2022	228800	81000	309800	2023-08-17
637	2021	228800	81000	309800	2023-08-17
637	2020	224000	48100	272100	2023-08-17
638	2022	279300	245000	524300	2023-08-17
638	2021	279300	245000	524300	2023-08-17
638	2020	267000	201900	468900	2023-08-17
639	2022	1610400	809400	2419800	2023-08-17
639	2021	1610400	809400	2419800	2023-08-17
639	2020	1516800	479600	1996400	2023-08-17
643	2022	0	40400	40400	2023-08-17
643	2021	0	40400	40400	2023-08-17
643	2020	0	37000	37000	2023-08-17
645	2022	243400	133300	376700	2023-08-17
645	2021	243400	133300	376700	2023-08-17
645	2020	240600	101500	342100	2023-08-17
647	2022	30000	302800	332800	2023-08-17
647	2021	30000	302800	332800	2023-08-17
647	2020	21600	233000	254600	2023-08-17
648	2022	838300	492700	1331000	2023-08-17
648	2021	838300	492700	1331000	2023-08-17
648	2020	685900	638500	1324400	2023-08-17
649	2022	318500	254900	573400	2023-08-17
649	2021	318500	254900	573400	2023-08-17
649	2020	282700	268400	551100	2023-08-17
650	2022	183500	235400	418900	2023-08-17
650	2021	183500	235400	418900	2023-08-17
650	2020	187900	222000	409900	2023-08-17
651	2022	183300	278100	461400	2023-08-17
651	2021	183300	278100	461400	2023-08-17
651	2020	180700	244500	425200	2023-08-17
652	2022	23900	208300	232200	2023-08-17
652	2021	23900	208300	232200	2023-08-17
652	2020	32100	154400	186500	2023-08-17
653	2022	68500	262400	330900	2023-08-17
653	2021	68500	262400	330900	2023-08-17
653	2020	94600	198400	293000	2023-08-17
654	2022	107000	377200	484200	2023-08-17
654	2021	107000	377200	484200	2023-08-17
654	2020	80800	294600	375400	2023-08-17
655	2022	480400	433200	913600	2023-08-17
655	2021	480400	433200	913600	2023-08-17
655	2020	421300	275600	696900	2023-08-17
659	2022	0	13900	13900	2023-08-17
659	2021	0	13900	13900	2023-08-17
659	2020	0	12100	12100	2023-08-17
664	2022	55700	128400	184100	2023-08-17
664	2021	55700	128400	184100	2023-08-17
664	2020	69800	107300	177100	2023-08-17
667	2022	18200	100700	118900	2023-08-17
667	2021	18200	100700	118900	2023-08-17
667	2020	21800	65500	87300	2023-08-17
673	2022	44600	225800	270400	2023-08-17
673	2021	44600	225800	270400	2023-08-17
673	2020	51500	169300	220800	2023-08-17
675	2022	0	52400	52400	2023-08-17
675	2021	0	52400	52400	2023-08-17
675	2020	0	47600	47600	2023-08-17
686	2022	0	11600	11600	2023-08-17
686	2021	0	11600	11600	2023-08-17
686	2020	0	10500	10500	2023-08-17
688	2022	2600	47600	50200	2023-08-17
688	2021	2600	47600	50200	2023-08-17
688	2020	2300	50000	52300	2023-08-17
689	2022	309800	207100	516900	2023-08-17
689	2021	301300	207100	508400	2023-08-17
689	2020	223400	183700	407100	2023-08-17
690	2022	726400	200500	926900	2023-08-17
690	2021	726400	200500	926900	2023-08-17
690	2020	591800	191700	783500	2023-08-17
691	2022	400600	265800	666400	2023-08-17
691	2021	400600	265800	666400	2023-08-17
691	2020	405100	217300	622400	2023-08-17
692	2022	578500	227500	806000	2023-08-17
692	2021	578500	227500	806000	2023-08-17
692	2020	516900	151300	668200	2023-08-17
694	2022	192900	152200	345100	2023-08-17
694	2021	191000	152200	343200	2023-08-17
694	2020	163000	114700	277700	2023-08-17
695	2022	179300	193800	373100	2023-08-17
695	2021	179300	193800	373100	2023-08-17
695	2020	138900	157700	296600	2023-08-17
696	2022	324100	191200	515300	2023-08-17
696	2021	301800	191200	493000	2023-08-17
696	2020	294500	165700	460200	2023-08-17
697	2022	227900	214600	442500	2023-08-17
697	2021	227900	214600	442500	2023-08-17
697	2020	169800	208400	378200	2023-08-17
698	2022	486500	179200	665700	2023-08-17
698	2021	486500	179200	665700	2023-08-17
698	2020	463100	180800	643900	2023-08-17
700	2022	48900	77600	126500	2023-08-17
700	2021	48900	77600	126500	2023-08-17
700	2020	40900	72900	113800	2023-08-17
701	2022	208100	176600	384700	2023-08-17
701	2021	208100	176600	384700	2023-08-17
701	2020	151100	142000	293100	2023-08-17
702	2022	216000	149500	365500	2023-08-17
702	2021	216000	149500	365500	2023-08-17
702	2020	213600	119400	333000	2023-08-17
703	2022	66400	191800	258200	2023-08-17
703	2021	66400	191800	258200	2023-08-17
703	2020	57500	143600	201100	2023-08-17
704	2022	146600	149000	295600	2023-08-17
704	2021	146600	149000	295600	2023-08-17
704	2020	128500	111800	240300	2023-08-17
705	2022	2000	8800	10800	2023-08-17
705	2021	2000	8800	10800	2023-08-17
705	2020	2000	8000	10000	2023-08-17
706	2022	213600	196500	410100	2023-08-17
706	2021	213600	196500	410100	2023-08-17
706	2020	202400	158400	360800	2023-08-17
707	2022	210800	170800	381600	2023-08-17
707	2021	210800	170800	381600	2023-08-17
707	2020	218500	139600	358100	2023-08-17
708	2022	144900	157600	302500	2023-08-17
708	2021	144900	157600	302500	2023-08-17
708	2020	153200	119600	272800	2023-08-17
711	2022	162700	125900	288600	2023-08-17
711	2021	162700	125900	288600	2023-08-17
711	2020	157400	96300	253700	2023-08-17
717	2022	0	447800	447800	2023-08-17
717	2021	0	447800	447800	2023-08-17
717	2020	0	405000	405000	2023-08-17
719	2022	347200	280700	627900	2023-08-17
719	2021	341500	280700	622200	2023-08-17
719	2020	222600	143600	366200	2023-08-17
720	2022	213000	175200	388200	2023-08-17
720	2021	213000	175200	388200	2023-08-17
720	2020	153400	137000	290400	2023-08-17
723	2022	249500	145600	395100	2023-08-17
723	2021	209100	145600	354700	2023-08-17
723	2020	136500	112000	248500	2023-08-17
724	2022	0	466700	466700	2023-08-17
724	2021	0	466700	466700	2023-08-17
724	2020	0	425900	425900	2023-08-17
725	2022	446600	301400	748000	2023-08-17
725	2021	446600	301400	748000	2023-08-17
725	2020	390300	268000	658300	2023-08-17
734	2022	559500	267700	827200	2023-08-17
734	2021	559500	267700	827200	2023-08-17
734	2020	527600	227300	754900	2023-08-17
735	2022	0	258100	258100	2023-08-17
735	2021	0	270500	270500	2023-08-17
735	2020	0	205100	205100	2023-08-17
736	2022	1054700	284700	1339400	2023-08-17
736	2021	1054700	284700	1339400	2023-08-17
736	2020	977700	289500	1267200	2023-08-17
737	2022	854300	389700	1244000	2023-08-17
737	2021	854300	389700	1244000	2023-08-17
737	2020	732000	254800	986800	2023-08-17
738	2022	375400	271100	646500	2023-08-17
738	2021	375400	271100	646500	2023-08-17
738	2020	354000	183600	537600	2023-08-17
739	2022	471700	329500	801200	2023-08-17
739	2021	540400	329500	869900	2023-08-17
739	2020	409400	265000	674400	2023-08-17
740	2022	668000	334400	1002400	2023-08-17
740	2021	668000	334400	1002400	2023-08-17
740	2020	651900	298400	950300	2023-08-17
741	2022	136000	320100	456100	2023-08-17
741	2021	146100	363400	509500	2023-08-17
741	2020	120000	270700	390700	2023-08-17
742	2022	602000	344800	946800	2023-08-17
742	2021	602000	344800	946800	2023-08-17
742	2020	562800	316100	878900	2023-08-17
743	2022	258000	268600	526600	2023-08-17
743	2021	256800	294500	551300	2023-08-17
743	2020	254400	215800	470200	2023-08-17
744	2022	525500	352900	878400	2023-08-17
744	2021	525500	352900	878400	2023-08-17
744	2020	446100	333200	779300	2023-08-17
745	2022	0	273700	273700	2023-08-17
745	2021	0	273700	273700	2023-08-17
745	2020	0	290000	290000	2023-08-17
746	2022	657300	297600	954900	2023-08-17
746	2021	657300	297600	954900	2023-08-17
746	2020	609500	263000	872500	2023-08-17
747	2022	454400	330800	785200	2023-08-17
747	2021	394000	330800	724800	2023-08-17
747	2020	362200	228900	591100	2023-08-17
748	2022	424400	417700	842100	2023-08-17
748	2021	424400	417700	842100	2023-08-17
748	2020	373100	349200	722300	2023-08-17
749	2022	1062400	588700	1651100	2023-08-17
749	2021	1062400	588700	1651100	2023-08-17
749	2020	1049800	498000	1547800	2023-08-17
750	2022	1008100	272500	1280600	2023-08-17
750	2021	926200	272500	1198700	2023-08-17
750	2020	822300	206900	1029200	2023-08-17
751	2022	311800	228100	539900	2023-08-17
751	2021	299700	228100	527800	2023-08-17
751	2020	284300	194800	479100	2023-08-17
752	2022	335600	256700	592300	2023-08-17
752	2021	335600	256700	592300	2023-08-17
752	2020	293500	257900	551400	2023-08-17
753	2022	475900	560300	1036200	2023-08-17
753	2021	475900	560300	1036200	2023-08-17
753	2020	415300	446400	861700	2023-08-17
754	2022	506500	426100	932600	2023-08-17
754	2021	506500	426100	932600	2023-08-17
754	2020	499500	397100	896600	2023-08-17
755	2022	173500	173400	346900	2023-08-17
755	2021	167000	173400	340400	2023-08-17
755	2020	139600	115500	255100	2023-08-17
756	2022	363200	548200	911400	2023-08-17
756	2021	363200	548200	911400	2023-08-17
756	2020	350100	482200	832300	2023-08-17
757	2022	0	251800	251800	2023-08-17
757	2021	0	251800	251800	2023-08-17
757	2020	0	226900	226900	2023-08-17
758	2022	122500	223700	346200	2023-08-17
758	2021	122500	223700	346200	2023-08-17
758	2020	108400	181200	289600	2023-08-17
759	2022	103400	177900	281300	2023-08-17
759	2021	103400	177900	281300	2023-08-17
759	2020	95400	139500	234900	2023-08-17
760	2022	0	289600	289600	2023-08-17
760	2021	0	289600	289600	2023-08-17
760	2020	0	252100	252100	2023-08-17
762	2022	0	181700	181700	2023-08-17
762	2021	0	181700	181700	2023-08-17
762	2020	0	147200	147200	2023-08-17
764	2022	53400	141100	194500	2023-08-17
764	2021	53400	141100	194500	2023-08-17
764	2020	55500	84500	140000	2023-08-17
765	2022	313700	222400	536100	2023-08-17
765	2021	313700	222400	536100	2023-08-17
765	2020	313300	247800	561100	2023-08-17
767	2022	8700	483700	492400	2023-08-17
767	2021	8700	483700	492400	2023-08-17
767	2020	7400	437800	445200	2023-08-17
768	2022	639200	215800	855000	2023-08-17
768	2021	627900	215800	843700	2023-08-17
768	2020	464000	168200	632200	2023-08-17
769	2022	195800	149200	345000	2023-08-17
769	2021	195800	149200	345000	2023-08-17
769	2020	193700	115300	309000	2023-08-17
770	2022	0	269900	269900	2023-08-17
770	2021	0	269900	269900	2023-08-17
770	2020	0	233200	233200	2023-08-17
771	2022	283000	205900	488900	2023-08-17
771	2021	283000	205900	488900	2023-08-17
771	2020	216300	160700	377000	2023-08-17
772	2022	256700	176600	433300	2023-08-17
772	2021	256700	176600	433300	2023-08-17
772	2020	250900	124800	375700	2023-08-17
773	2022	0	142900	142900	2023-08-17
773	2021	0	142900	142900	2023-08-17
773	2020	0	107300	107300	2023-08-17
774	2022	161200	147700	308900	2023-08-17
774	2021	161200	147700	308900	2023-08-17
774	2020	125900	107500	233400	2023-08-17
775	2022	127300	164800	292100	2023-08-17
775	2021	127300	164800	292100	2023-08-17
775	2020	91900	123000	214900	2023-08-17
776	2022	404000	206900	610900	2023-08-17
776	2021	404000	206900	610900	2023-08-17
776	2020	370200	131400	501600	2023-08-17
782	2022	831100	401000	1232100	2023-08-17
782	2021	831100	401000	1232100	2023-08-17
782	2020	760400	412300	1172700	2023-08-17
783	2022	94200	152700	246900	2023-08-17
783	2021	94200	152700	246900	2023-08-17
783	2020	117400	106300	223700	2023-08-17
784	2022	11200	149400	160600	2023-08-17
784	2021	11200	149400	160600	2023-08-17
784	2020	10400	140300	150700	2023-08-17
785	2022	857100	551300	1408400	2023-08-17
785	2021	857100	551300	1408400	2023-08-17
785	2020	701000	613600	1314600	2023-08-17
786	2022	484200	382900	867100	2023-08-17
786	2021	484200	382900	867100	2023-08-17
786	2020	419400	379600	799000	2023-08-17
787	2022	238800	166500	405300	2023-08-17
787	2021	238800	166500	405300	2023-08-17
787	2020	247800	95100	342900	2023-08-17
788	2022	136300	156300	292600	2023-08-17
788	2021	136300	156300	292600	2023-08-17
788	2020	95300	122000	217300	2023-08-17
789	2022	288700	222700	511400	2023-08-17
789	2021	273500	222700	496200	2023-08-17
789	2020	194500	185600	380100	2023-08-17
792	2022	413000	181300	594300	2023-08-17
792	2021	413000	181300	594300	2023-08-17
792	2020	408600	137100	545700	2023-08-17
793	2022	0	268100	268100	2023-08-17
793	2021	0	268100	268100	2023-08-17
793	2020	0	222500	222500	2023-08-17
795	2022	236000	161200	397200	2023-08-17
795	2021	236000	161200	397200	2023-08-17
795	2020	200700	124300	325000	2023-08-17
796	2022	55500	94000	149500	2023-08-17
796	2021	55500	94000	149500	2023-08-17
796	2020	48000	53000	101000	2023-08-17
797	2022	535400	214900	750300	2023-08-17
797	2021	535400	214900	750300	2023-08-17
797	2020	529200	183900	713100	2023-08-17
798	2022	5400	457100	462500	2023-08-17
798	2021	5400	457100	462500	2023-08-17
798	2020	5200	411900	417100	2023-08-17
799	2022	375900	182900	558800	2023-08-17
799	2021	375900	182900	558800	2023-08-17
799	2020	363200	161600	524800	2023-08-17
800	2022	1185500	377100	1562600	2023-08-17
800	2021	1185500	377100	1562600	2023-08-17
800	2020	1126900	354200	1481100	2023-08-17
801	2022	395700	679100	1074800	2023-08-17
801	2021	395700	679100	1074800	2023-08-17
801	2020	384700	612000	996700	2023-08-17
804	2022	453900	446200	900100	2023-08-17
804	2021	453900	446200	900100	2023-08-17
804	2020	364800	361800	726600	2023-08-17
806	2022	715100	336900	1052000	2023-08-17
806	2021	715100	336900	1052000	2023-08-17
806	2020	545900	294800	840700	2023-08-17
807	2022	0	722500	722500	2023-08-17
807	2021	0	722500	722500	2023-08-17
807	2020	0	628800	628800	2023-08-17
808	2022	268500	184100	452600	2023-08-17
808	2021	268500	184100	452600	2023-08-17
808	2020	227400	162700	390100	2023-08-17
809	2022	194900	182800	377700	2023-08-17
809	2021	194900	182800	377700	2023-08-17
809	2020	157100	169000	326100	2023-08-17
810	2022	747800	384400	1132200	2023-08-17
810	2021	747800	384400	1132200	2023-08-17
810	2020	780200	375200	1155400	2023-08-17
811	2022	17300	352400	369700	2023-08-17
811	2021	17300	352400	369700	2023-08-17
811	2020	15100	315900	331000	2023-08-17
812	2022	261500	214500	476000	2023-08-17
812	2021	256800	214500	471300	2023-08-17
812	2020	207600	174900	382500	2023-08-17
814	2022	494100	176200	670300	2023-08-17
814	2021	494100	176200	670300	2023-08-17
814	2020	513600	155000	668600	2023-08-17
815	2022	378600	252100	630700	2023-08-17
815	2021	378600	252100	630700	2023-08-17
815	2020	334900	200900	535800	2023-08-17
816	2022	611800	303400	915200	2023-08-17
816	2021	611800	303400	915200	2023-08-17
816	2020	559700	240100	799800	2023-08-17
820	2022	954300	279300	1233600	2023-08-17
820	2021	954300	279300	1233600	2023-08-17
820	2020	839700	271700	1111400	2023-08-17
821	2022	0	243100	243100	2023-08-17
821	2021	0	243100	243100	2023-08-17
821	2020	0	200300	200300	2023-08-17
824	2022	38200	190600	228800	2023-08-17
824	2021	38200	190600	228800	2023-08-17
824	2020	31300	146500	177800	2023-08-17
826	2022	301900	308300	610200	2023-08-17
826	2021	301900	308300	610200	2023-08-17
826	2020	278700	244700	523400	2023-08-17
827	2022	749700	900000	1649700	2023-08-17
827	2021	749700	900000	1649700	2023-08-17
827	2020	728500	834100	1562600	2023-08-17
829	2022	393900	358200	752100	2023-08-17
829	2021	393900	358200	752100	2023-08-17
829	2020	325300	267600	592900	2023-08-17
830	2022	159900	138800	298700	2023-08-17
830	2021	159900	138800	298700	2023-08-17
830	2020	133400	93400	226800	2023-08-17
831	2022	1136400	699600	1836000	2023-08-17
831	2021	1136400	699600	1836000	2023-08-17
831	2020	1092100	661200	1753300	2023-08-17
832	2022	0	100800	100800	2023-08-17
832	2021	0	100800	100800	2023-08-17
832	2020	0	69000	69000	2023-08-17
833	2022	342900	180000	522900	2023-08-17
833	2021	392400	180000	572400	2023-08-17
833	2020	287200	122800	410000	2023-08-17
834	2022	156300	120200	276500	2023-08-17
834	2021	156300	120200	276500	2023-08-17
834	2020	150100	100700	250800	2023-08-17
835	2022	342000	236200	578200	2023-08-17
835	2021	342000	236200	578200	2023-08-17
835	2020	325000	172600	497600	2023-08-17
836	2022	0	258500	258500	2023-08-17
836	2021	0	258500	258500	2023-08-17
836	2020	7700	196600	204300	2023-08-17
837	2022	498200	245900	744100	2023-08-17
837	2021	484200	245900	730100	2023-08-17
837	2020	355900	147100	503000	2023-08-17
838	2022	258600	142000	400600	2023-08-17
838	2021	258300	142000	400300	2023-08-17
838	2020	236500	110900	347400	2023-08-17
839	2022	534600	365900	900500	2023-08-17
839	2021	534600	365900	900500	2023-08-17
839	2020	470800	303000	773800	2023-08-17
840	2022	107300	130700	238000	2023-08-17
840	2021	106100	130700	236800	2023-08-17
840	2020	19400	99100	118500	2023-08-17
841	2022	543500	205900	749400	2023-08-17
841	2021	543500	205900	749400	2023-08-17
841	2020	507800	156800	664600	2023-08-17
842	2022	127100	93200	220300	2023-08-17
842	2021	127100	93200	220300	2023-08-17
842	2020	116200	83900	200100	2023-08-17
843	2022	83600	152200	235800	2023-08-17
843	2021	83600	152200	235800	2023-08-17
843	2020	75700	118000	193700	2023-08-17
844	2022	4300	297500	301800	2023-08-17
844	2021	4300	297500	301800	2023-08-17
844	2020	5900	263800	269700	2023-08-17
845	2022	211500	141600	353100	2023-08-17
845	2021	211500	141600	353100	2023-08-17
845	2020	180800	108400	289200	2023-08-17
846	2022	0	113800	113800	2023-08-17
846	2021	0	113800	113800	2023-08-17
846	2020	0	87900	87900	2023-08-17
849	2022	0	117700	117700	2023-08-17
849	2021	0	117700	117700	2023-08-17
849	2020	0	104600	104600	2023-08-17
850	2022	33500	152200	185700	2023-08-17
850	2021	33500	152200	185700	2023-08-17
850	2020	45400	99500	144900	2023-08-17
851	2022	1500	156500	158000	2023-08-17
851	2021	1500	156500	158000	2023-08-17
851	2020	1400	140300	141700	2023-08-17
852	2022	35100	139500	174600	2023-08-17
852	2021	35100	139500	174600	2023-08-17
852	2020	45000	85400	130400	2023-08-17
853	2022	79000	125500	204500	2023-08-17
853	2021	79000	125500	204500	2023-08-17
853	2020	104000	64000	168000	2023-08-17
855	2022	42800	128800	171600	2023-08-17
855	2021	42800	128800	171600	2023-08-17
855	2020	52900	77600	130500	2023-08-17
858	2022	0	290600	290600	2023-08-17
858	2021	0	290600	290600	2023-08-17
858	2020	0	266300	266300	2023-08-17
860	2022	0	422400	422400	2023-08-17
860	2021	0	422400	422400	2023-08-17
860	2020	0	359700	359700	2023-08-17
861	2022	203600	139000	342600	2023-08-17
861	2021	203600	139000	342600	2023-08-17
861	2020	217300	106000	323300	2023-08-17
862	2022	714100	334100	1048200	2023-08-17
862	2021	714500	334100	1048600	2023-08-17
862	2020	750000	273400	1023400	2023-08-17
863	2022	0	165600	165600	2023-08-17
863	2021	0	165600	165600	2023-08-17
863	2020	0	123700	123700	2023-08-17
864	2022	0	156600	156600	2023-08-17
864	2021	0	156600	156600	2023-08-17
864	2020	0	115500	115500	2023-08-17
865	2022	913800	367800	1281600	2023-08-17
865	2021	913800	367800	1281600	2023-08-17
865	2020	722900	486600	1209500	2023-08-17
867	2022	1064900	808600	1873500	2023-08-17
867	2021	1064900	808600	1873500	2023-08-17
867	2020	1013800	752400	1766200	2023-08-17
868	2022	314000	269600	583600	2023-08-17
868	2021	314000	269600	583600	2023-08-17
868	2020	306200	224700	530900	2023-08-17
869	2022	209700	155600	365300	2023-08-17
869	2021	209700	155600	365300	2023-08-17
869	2020	163800	126000	289800	2023-08-17
871	2022	367100	181500	548600	2023-08-17
871	2021	367100	181500	548600	2023-08-17
871	2020	313200	182700	495900	2023-08-17
872	2022	397900	289300	687200	2023-08-17
872	2021	397900	289300	687200	2023-08-17
872	2020	411800	220100	631900	2023-08-17
873	2022	525300	788000	1313300	2023-08-17
873	2021	525300	788000	1313300	2023-08-17
873	2020	504500	749800	1254300	2023-08-17
874	2022	146500	300200	446700	2023-08-17
874	2021	146500	300200	446700	2023-08-17
874	2020	117400	287800	405200	2023-08-17
875	2022	434800	228300	663100	2023-08-17
875	2021	434800	228300	663100	2023-08-17
875	2020	411400	201500	612900	2023-08-17
876	2022	187900	352500	540400	2023-08-17
876	2021	187900	352500	540400	2023-08-17
876	2020	157300	327700	485000	2023-08-17
877	2022	468400	403300	871700	2023-08-17
877	2021	468400	403300	871700	2023-08-17
877	2020	401000	402000	803000	2023-08-17
878	2022	325900	465800	791700	2023-08-17
878	2021	325900	465800	791700	2023-08-17
878	2020	294700	339300	634000	2023-08-17
879	2022	183200	218400	401600	2023-08-17
879	2021	183200	218400	401600	2023-08-17
879	2020	167000	179100	346100	2023-08-17
880	2022	384400	224300	608700	2023-08-17
880	2021	384400	224300	608700	2023-08-17
880	2020	345800	198700	544500	2023-08-17
881	2022	1268800	371500	1640300	2023-08-17
881	2021	1268800	371500	1640300	2023-08-17
881	2020	990200	435700	1425900	2023-08-17
883	2022	21300	143600	164900	2023-08-17
883	2021	21300	143600	164900	2023-08-17
883	2020	31000	164600	195600	2023-08-17
884	2022	191000	235500	426500	2023-08-17
884	2021	191000	235500	426500	2023-08-17
884	2020	169000	209500	378500	2023-08-17
887	2022	998100	474700	1472800	2023-08-17
887	2021	998100	474700	1472800	2023-08-17
887	2020	950800	500700	1451500	2023-08-17
888	2022	0	160200	160200	2023-08-17
888	2021	0	160200	160200	2023-08-17
888	2020	0	163200	163200	2023-08-17
891	2022	403600	192900	596500	2023-08-17
891	2021	403600	192900	596500	2023-08-17
891	2020	334900	178600	513500	2023-08-17
892	2022	0	554000	554000	2023-08-17
892	2021	0	554000	554000	2023-08-17
892	2020	0	310700	310700	2023-08-17
895	2022	786900	282800	1069700	2023-08-17
895	2021	743700	282800	1026500	2023-08-17
895	2020	574400	269500	843900	2023-08-17
896	2022	1117300	352700	1470000	2023-08-17
896	2021	1117300	352700	1470000	2023-08-17
896	2020	885800	382200	1268000	2023-08-17
897	2022	0	138700	138700	2023-08-17
897	2021	0	138700	138700	2023-08-17
897	2020	0	359800	359800	2023-08-17
898	2022	0	425300	425300	2023-08-17
898	2021	0	425300	425300	2023-08-17
898	2020	0	316200	316200	2023-08-17
899	2022	581100	515300	1096400	2023-08-17
899	2021	738600	515300	1253900	2023-08-17
899	2020	604100	468800	1072900	2023-08-17
900	2022	563900	675100	1239000	2023-08-17
900	2021	563900	675100	1239000	2023-08-17
900	2020	517700	604500	1122200	2023-08-17
901	2022	114200	178100	292300	2023-08-17
901	2021	114200	178100	292300	2023-08-17
901	2020	96400	109300	205700	2023-08-17
907	2022	0	375900	375900	2023-08-17
907	2021	0	375900	375900	2023-08-17
907	2020	0	240800	240800	2023-08-17
908	2022	0	428000	428000	2023-08-17
908	2021	0	428000	428000	2023-08-17
908	2020	0	313900	313900	2023-08-17
909	2022	1264700	1184800	2449500	2023-08-17
909	2021	1264700	1184800	2449500	2023-08-17
909	2020	1308200	979200	2287400	2023-08-17
910	2022	487700	403500	891200	2023-08-17
910	2021	487700	403500	891200	2023-08-17
910	2020	411800	382200	794000	2023-08-17
911	2022	420600	852600	1273200	2023-08-17
911	2021	420600	852600	1273200	2023-08-17
911	2020	382300	795200	1177500	2023-08-17
912	2022	0	81400	81400	2023-08-17
912	2021	0	81400	81400	2023-08-17
912	2020	0	69200	69200	2023-08-17
913	2022	25900	149300	175200	2023-08-17
913	2021	25900	149300	175200	2023-08-17
913	2020	26500	100800	127300	2023-08-17
915	2022	133700	155800	289500	2023-08-17
915	2021	133700	155800	289500	2023-08-17
915	2020	134200	110300	244500	2023-08-17
916	2022	171000	178500	349500	2023-08-17
916	2021	171000	178500	349500	2023-08-17
916	2020	143400	141200	284600	2023-08-17
917	2022	250500	235300	485800	2023-08-17
917	2021	250500	235300	485800	2023-08-17
917	2020	249900	163200	413100	2023-08-17
920	2022	403900	335600	739500	2023-08-17
920	2021	399600	335600	735200	2023-08-17
920	2020	360500	275400	635900	2023-08-17
921	2022	302400	249100	551500	2023-08-17
921	2021	302400	249100	551500	2023-08-17
921	2020	267600	168600	436200	2023-08-17
923	2022	29900	171500	201400	2023-08-17
923	2021	29900	171500	201400	2023-08-17
923	2020	26300	128300	154600	2023-08-17
924	2022	0	477500	477500	2023-08-17
924	2021	0	477500	477500	2023-08-17
924	2020	0	393000	393000	2023-08-17
925	2022	0	400	400	2023-08-17
925	2021	0	400	400	2023-08-17
925	2020	0	400	400	2023-08-17
934	2022	0	222900	222900	2023-08-17
934	2021	0	222900	222900	2023-08-17
934	2020	0	174700	174700	2023-08-17
935	2022	458600	263000	721600	2023-08-17
935	2021	458600	263000	721600	2023-08-17
935	2020	412900	232400	645300	2023-08-17
939	2022	596300	440400	1036700	2023-08-17
939	2021	596300	440400	1036700	2023-08-17
939	2020	518000	472700	990700	2023-08-17
940	2022	432600	276100	708700	2023-08-17
940	2021	432600	276100	708700	2023-08-17
940	2020	406400	248200	654600	2023-08-17
941	2022	397900	168600	566500	2023-08-17
941	2021	397900	168600	566500	2023-08-17
941	2020	361200	163000	524200	2023-08-17
942	2022	402700	227300	630000	2023-08-17
942	2021	402700	227300	630000	2023-08-17
942	2020	377500	222300	599800	2023-08-17
943	2022	324200	261900	586100	2023-08-17
943	2021	324200	261900	586100	2023-08-17
943	2020	301800	186200	488000	2023-08-17
944	2022	331800	297200	629000	2023-08-17
944	2021	393600	339500	733100	2023-08-17
944	2020	309200	313100	622300	2023-08-17
947	2022	334800	143600	478400	2023-08-17
947	2021	334800	143600	478400	2023-08-17
947	2020	311900	93500	405400	2023-08-17
949	2022	423400	386900	810300	2023-08-17
949	2021	383600	386900	770500	2023-08-17
949	2020	349600	651800	1001400	2023-08-17
951	2022	161600	106600	268200	2023-08-17
951	2021	161600	106600	268200	2023-08-17
951	2020	181500	74700	256200	2023-08-17
952	2022	122200	125500	247700	2023-08-17
952	2021	134400	133800	268200	2023-08-17
952	2020	94600	97000	191600	2023-08-17
953	2022	183800	126300	310100	2023-08-17
953	2021	183800	126300	310100	2023-08-17
953	2020	196900	129800	326700	2023-08-17
954	2022	134700	156100	290800	2023-08-17
954	2021	134700	156100	290800	2023-08-17
954	2020	128500	135400	263900	2023-08-17
955	2022	91100	124900	216000	2023-08-17
955	2021	91100	124900	216000	2023-08-17
955	2020	78700	94100	172800	2023-08-17
958	2022	311600	108600	420200	2023-08-17
958	2021	311600	108600	420200	2023-08-17
958	2020	254000	114300	368300	2023-08-17
959	2022	229100	112600	341700	2023-08-17
959	2021	229100	112600	341700	2023-08-17
959	2020	201500	106300	307800	2023-08-17
960	2022	209600	115100	324700	2023-08-17
960	2021	209600	115100	324700	2023-08-17
960	2020	196300	111100	307400	2023-08-17
961	2022	383800	243800	627600	2023-08-17
961	2021	383800	243800	627600	2023-08-17
961	2020	349400	201300	550700	2023-08-17
962	2022	371900	112400	484300	2023-08-17
962	2021	371900	112400	484300	2023-08-17
962	2020	311100	118200	429300	2023-08-17
963	2022	245600	239300	484900	2023-08-17
963	2021	245600	239300	484900	2023-08-17
963	2020	261400	167800	429200	2023-08-17
964	2022	0	211200	211200	2023-08-17
964	2021	0	211200	211200	2023-08-17
964	2020	79100	153500	232600	2023-08-17
965	2022	528500	231100	759600	2023-08-17
965	2021	524400	231100	755500	2023-08-17
965	2020	459700	188600	648300	2023-08-17
966	2022	376200	166000	542200	2023-08-17
966	2021	376200	166000	542200	2023-08-17
966	2020	330800	144000	474800	2023-08-17
967	2022	467700	172900	640600	2023-08-17
967	2021	467700	172900	640600	2023-08-17
967	2020	438500	152000	590500	2023-08-17
968	2022	215000	278700	493700	2023-08-17
968	2021	207300	302900	510200	2023-08-17
968	2020	168400	253200	421600	2023-08-17
969	2022	143300	156100	299400	2023-08-17
969	2021	143300	156100	299400	2023-08-17
969	2020	118900	103800	222700	2023-08-17
971	2022	207900	172600	380500	2023-08-17
971	2021	207900	172600	380500	2023-08-17
971	2020	191500	136900	328400	2023-08-17
972	2022	0	158100	158100	2023-08-17
972	2021	0	158100	158100	2023-08-17
972	2020	0	122200	122200	2023-08-17
973	2022	253200	151600	404800	2023-08-17
973	2021	245500	151600	397100	2023-08-17
973	2020	246700	116700	363400	2023-08-17
974	2022	463100	266000	729100	2023-08-17
974	2021	463100	266000	729100	2023-08-17
974	2020	395700	260100	655800	2023-08-17
975	2022	0	221300	221300	2023-08-17
975	2021	0	221300	221300	2023-08-17
975	2020	0	202400	202400	2023-08-17
976	2022	261400	211800	473200	2023-08-17
976	2021	262700	211800	474500	2023-08-17
976	2020	198300	167700	366000	2023-08-17
977	2022	584200	192500	776700	2023-08-17
977	2021	584200	192500	776700	2023-08-17
977	2020	565300	152800	718100	2023-08-17
978	2022	26100	134100	160200	2023-08-17
978	2021	26100	134100	160200	2023-08-17
978	2020	22400	101900	124300	2023-08-17
979	2022	94700	130300	225000	2023-08-17
979	2021	94700	130300	225000	2023-08-17
979	2020	87600	98700	186300	2023-08-17
981	2022	270900	128900	399800	2023-08-17
981	2021	270900	128900	399800	2023-08-17
981	2020	226600	97500	324100	2023-08-17
982	2022	112400	137000	249400	2023-08-17
982	2021	112400	137000	249400	2023-08-17
982	2020	72500	104800	177300	2023-08-17
983	2022	12100	137300	149400	2023-08-17
983	2021	12100	137300	149400	2023-08-17
983	2020	4600	106700	111300	2023-08-17
984	2022	90800	118300	209100	2023-08-17
984	2021	90800	118300	209100	2023-08-17
984	2020	78500	90100	168600	2023-08-17
986	2022	107000	139600	246600	2023-08-17
986	2021	107000	139600	246600	2023-08-17
986	2020	122600	96500	219100	2023-08-17
987	2022	258800	411500	670300	2023-08-17
987	2021	258800	411500	670300	2023-08-17
987	2020	231400	341500	572900	2023-08-17
990	2022	4100	12000	16100	2023-08-17
990	2021	4100	12000	16100	2023-08-17
990	2020	3800	10900	14700	2023-08-17
991	2022	77800	131000	208800	2023-08-17
991	2021	77800	131000	208800	2023-08-17
991	2020	73200	99300	172500	2023-08-17
992	2022	0	680300	680300	2023-08-17
992	2021	0	680300	680300	2023-08-17
992	2020	0	599100	599100	2023-08-17
993	2022	226300	135900	362200	2023-08-17
993	2021	210700	135900	346600	2023-08-17
993	2020	194900	99100	294000	2023-08-17
994	2022	145200	171100	316300	2023-08-17
994	2021	145200	171100	316300	2023-08-17
994	2020	121500	122900	244400	2023-08-17
995	2022	165900	84200	250100	2023-08-17
995	2021	165900	89400	255300	2023-08-17
995	2020	111000	49900	160900	2023-08-17
996	2022	336100	186700	522800	2023-08-17
996	2021	336100	186700	522800	2023-08-17
996	2020	310800	163900	474700	2023-08-17
997	2022	212500	160700	373200	2023-08-17
997	2021	212500	160700	373200	2023-08-17
997	2020	208500	141500	350000	2023-08-17
998	2022	442600	379500	822100	2023-08-17
998	2021	442600	379500	822100	2023-08-17
998	2020	435600	314800	750400	2023-08-17
1002	2022	0	141700	141700	2023-08-17
1002	2021	0	141700	141700	2023-08-17
1002	2020	0	125300	125300	2023-08-17
1003	2022	167600	361400	529000	2023-08-17
1003	2021	179900	361400	541300	2023-08-17
1003	2020	198500	254300	452800	2023-08-17
1004	2022	370900	175200	546100	2023-08-17
1004	2021	370900	175200	546100	2023-08-17
1004	2020	289200	166000	455200	2023-08-17
1005	2022	348300	184800	533100	2023-08-17
1005	2021	348300	184800	533100	2023-08-17
1005	2020	303600	124000	427600	2023-08-17
1006	2022	131500	140300	271800	2023-08-17
1006	2021	131500	140300	271800	2023-08-17
1006	2020	113800	106500	220300	2023-08-17
1009	2022	0	366700	366700	2023-08-17
1009	2021	0	366700	366700	2023-08-17
1009	2020	0	306500	306500	2023-08-17
1015	2022	56500	122100	178600	2023-08-17
1015	2021	56500	122100	178600	2023-08-17
1015	2020	49200	95200	144400	2023-08-17
1016	2022	122600	155100	277700	2023-08-17
1016	2021	122600	155100	277700	2023-08-17
1016	2020	111500	118800	230300	2023-08-17
1018	2022	43400	191800	235200	2023-08-17
1018	2021	43400	191800	235200	2023-08-17
1018	2020	39600	161500	201100	2023-08-17
1019	2022	265300	163000	428300	2023-08-17
1019	2021	265300	163000	428300	2023-08-17
1019	2020	253200	126000	379200	2023-08-17
1020	2022	81200	169000	250200	2023-08-17
1020	2021	81200	169000	250200	2023-08-17
1020	2020	102200	131400	233600	2023-08-17
1022	2022	370500	395200	765700	2023-08-17
1022	2021	370500	395200	765700	2023-08-17
1022	2020	256100	333400	589500	2023-08-17
1023	2022	160500	195700	356200	2023-08-17
1023	2021	160500	195700	356200	2023-08-17
1023	2020	139700	158800	298500	2023-08-17
1024	2022	142900	148400	291300	2023-08-17
1024	2021	142900	148400	291300	2023-08-17
1024	2020	121200	102400	223600	2023-08-17
1025	2022	296500	202000	498500	2023-08-17
1025	2021	277500	202000	479500	2023-08-17
1025	2020	201800	189300	391100	2023-08-17
1026	2022	261400	264800	526200	2023-08-17
1026	2021	261400	264800	526200	2023-08-17
1026	2020	248000	218500	466500	2023-08-17
1027	2022	0	401100	401100	2023-08-17
1027	2021	0	401100	401100	2023-08-17
1027	2020	0	354800	354800	2023-08-17
1028	2022	0	12200	12200	2023-08-17
1028	2021	0	12200	12200	2023-08-17
1028	2020	0	10500	10500	2023-08-17
1030	2022	368900	354100	723000	2023-08-17
1030	2021	368900	354100	723000	2023-08-17
1030	2020	320700	310300	631000	2023-08-17
1031	2022	145000	176700	321700	2023-08-17
1031	2021	145000	176700	321700	2023-08-17
1031	2020	114500	145200	259700	2023-08-17
1033	2022	298200	306900	605100	2023-08-17
1033	2021	298200	306900	605100	2023-08-17
1033	2020	229300	255300	484600	2023-08-17
1034	2022	17100	103900	121000	2023-08-17
1034	2021	17100	103900	121000	2023-08-17
1034	2020	15300	92400	107700	2023-08-17
1035	2022	162400	251800	414200	2023-08-17
1035	2021	162400	251800	414200	2023-08-17
1035	2020	140800	195200	336000	2023-08-17
1037	2022	53700	226100	279800	2023-08-17
1037	2021	53700	226100	279800	2023-08-17
1037	2020	29400	226000	255400	2023-08-17
1038	2022	114400	97000	211400	2023-08-17
1038	2021	103600	97000	200600	2023-08-17
1038	2020	70800	87600	158400	2023-08-17
1039	2022	0	402900	402900	2023-08-17
1039	2021	0	422400	422400	2023-08-17
1039	2020	0	407700	407700	2023-08-17
1040	2022	391100	143100	534200	2023-08-17
1040	2021	355700	143100	498800	2023-08-17
1040	2020	332600	144300	476900	2023-08-17
1041	2022	348600	147700	496300	2023-08-17
1041	2021	348600	147700	496300	2023-08-17
1041	2020	301900	152300	454200	2023-08-17
1042	2022	245800	152800	398600	2023-08-17
1042	2021	245800	152800	398600	2023-08-17
1042	2020	228600	139800	368400	2023-08-17
1043	2022	125600	100500	226100	2023-08-17
1043	2021	125600	100500	226100	2023-08-17
1043	2020	122000	80700	202700	2023-08-17
1045	2022	68200	105400	173600	2023-08-17
1045	2021	68200	105400	173600	2023-08-17
1045	2020	65600	96400	162000	2023-08-17
1046	2022	128000	131300	259300	2023-08-17
1046	2021	128000	131300	259300	2023-08-17
1046	2020	121700	99600	221300	2023-08-17
1048	2022	0	4400	4400	2023-08-17
1048	2021	0	4400	4400	2023-08-17
1048	2020	0	4100	4100	2023-08-17
1049	2022	31100	161400	192500	2023-08-17
1049	2021	31100	161400	192500	2023-08-17
1049	2020	28800	132700	161500	2023-08-17
1051	2022	73600	147200	220800	2023-08-17
1051	2021	73600	147200	220800	2023-08-17
1051	2020	66800	114100	180900	2023-08-17
1052	2022	118300	260900	379200	2023-08-17
1052	2021	118300	260900	379200	2023-08-17
1052	2020	73500	207500	281000	2023-08-17
1053	2022	859100	1044500	1903600	2023-08-17
1053	2021	859100	1044500	1903600	2023-08-17
1053	2020	779800	1015800	1795600	2023-08-17
1054	2022	1622000	804100	2426100	2023-08-17
1054	2021	1616600	865600	2482200	2023-08-17
1054	2020	1158900	776400	1935300	2023-08-17
1055	2022	0	327000	327000	2023-08-17
1055	2021	0	327000	327000	2023-08-17
1055	2020	0	199100	199100	2023-08-17
1057	2022	0	72300	72300	2023-08-17
1057	2021	0	72300	72300	2023-08-17
1057	2020	0	64800	64800	2023-08-17
1058	2022	9400	270800	280200	2023-08-17
1058	2021	9400	270800	280200	2023-08-17
1058	2020	8900	213800	222700	2023-08-17
1060	2022	952200	438500	1390700	2023-08-17
1060	2021	952200	438500	1390700	2023-08-17
1060	2020	766000	362100	1128100	2023-08-17
1061	2022	132200	194200	326400	2023-08-17
1061	2021	132200	194200	326400	2023-08-17
1061	2020	123300	155500	278800	2023-08-17
1064	2022	536700	476500	1013200	2023-08-17
1064	2021	536700	476500	1013200	2023-08-17
1064	2020	492900	412100	905000	2023-08-17
1068	2022	620900	336000	956900	2023-08-17
1068	2021	620900	336000	956900	2023-08-17
1068	2020	607300	278500	885800	2023-08-17
1069	2022	0	180000	180000	2023-08-17
1069	2021	0	180000	180000	2023-08-17
1069	2020	0	142400	142400	2023-08-17
1070	2022	62100	169800	231900	2023-08-17
1070	2021	62100	169800	231900	2023-08-17
1070	2020	48800	134300	183100	2023-08-17
1071	2022	496200	139200	635400	2023-08-17
1071	2021	496200	139200	635400	2023-08-17
1071	2020	452100	106500	558600	2023-08-17
1076	2022	0	220200	220200	2023-08-17
1076	2021	0	220200	220200	2023-08-17
1076	2020	0	180600	180600	2023-08-17
1077	2022	0	997900	997900	2023-08-17
1077	2021	0	997900	997900	2023-08-17
1077	2020	0	909100	909100	2023-08-17
1078	2022	200900	103900	304800	2023-08-17
1078	2021	200900	103900	304800	2023-08-17
1078	2020	166600	82200	248800	2023-08-17
1079	2022	0	66800	66800	2023-08-17
1079	2021	0	66800	66800	2023-08-17
1079	2020	0	56200	56200	2023-08-17
1081	2022	0	92100	92100	2023-08-17
1081	2021	0	92100	92100	2023-08-17
1081	2020	0	63500	63500	2023-08-17
1082	2022	33700	95900	129600	2023-08-17
1082	2021	33700	95900	129600	2023-08-17
1082	2020	49500	72100	121600	2023-08-17
1083	2022	0	572000	572000	2023-08-17
1083	2021	0	572000	572000	2023-08-17
1083	2020	0	491600	491600	2023-08-17
1084	2022	0	33700	33700	2023-08-17
1084	2021	0	33700	33700	2023-08-17
1084	2020	0	23200	23200	2023-08-17
1085	2022	0	140400	140400	2023-08-17
1085	2021	0	140400	140400	2023-08-17
1085	2020	0	108100	108100	2023-08-17
1087	2022	0	83500	83500	2023-08-17
1087	2021	0	83500	83500	2023-08-17
1087	2020	0	68100	68100	2023-08-17
1091	2022	80800	145200	226000	2023-08-17
1091	2021	89200	145200	234400	2023-08-17
1091	2020	76500	99500	176000	2023-08-17
1092	2022	309500	161300	470800	2023-08-17
1092	2021	309500	161300	470800	2023-08-17
1092	2020	308900	125600	434500	2023-08-17
1093	2022	0	139200	139200	2023-08-17
1093	2021	0	139200	139200	2023-08-17
1093	2020	0	113400	113400	2023-08-17
1094	2022	179900	240600	420500	2023-08-17
1094	2021	179900	240600	420500	2023-08-17
1094	2020	161200	186300	347500	2023-08-17
1096	2022	1589900	780600	2370500	2023-08-17
1096	2021	1543900	780600	2324500	2023-08-17
1096	2020	1186300	632300	1818600	2023-08-17
1097	2022	0	197900	197900	2023-08-17
1097	2021	0	197900	197900	2023-08-17
1097	2020	0	152500	152500	2023-08-17
1098	2022	0	227800	227800	2023-08-17
1098	2021	0	227800	227800	2023-08-17
1098	2020	0	184200	184200	2023-08-17
1099	2022	257600	194800	452400	2023-08-17
1099	2021	237600	194800	432400	2023-08-17
1099	2020	190800	109900	300700	2023-08-17
1100	2022	0	23100	23100	2023-08-17
1100	2021	0	23100	23100	2023-08-17
1100	2020	0	21000	21000	2023-08-17
1101	2022	176500	127400	303900	2023-08-17
1101	2021	176500	127400	303900	2023-08-17
1101	2020	157500	86200	243700	2023-08-17
1102	2022	94200	134800	229000	2023-08-17
1102	2021	94200	134800	229000	2023-08-17
1102	2020	79300	92900	172200	2023-08-17
1103	2022	0	353700	353700	2023-08-17
1103	2021	0	353700	353700	2023-08-17
1103	2020	0	299000	299000	2023-08-17
1104	2022	535000	434700	969700	2023-08-17
1104	2021	535000	434700	969700	2023-08-17
1104	2020	527000	372600	899600	2023-08-17
1105	2022	538000	432800	970800	2023-08-17
1105	2021	538000	432800	970800	2023-08-17
1105	2020	498600	382200	880800	2023-08-17
1109	2022	653900	489400	1143300	2023-08-17
1109	2021	653900	489400	1143300	2023-08-17
1109	2020	600500	458600	1059100	2023-08-17
1111	2022	0	128800	128800	2023-08-17
1111	2021	0	128800	128800	2023-08-17
1111	2020	0	103700	103700	2023-08-17
1112	2022	196600	168700	365300	2023-08-17
1112	2021	196600	168700	365300	2023-08-17
1112	2020	161500	134800	296300	2023-08-17
1113	2022	73200	455600	528800	2023-08-17
1113	2021	73200	455600	528800	2023-08-17
1113	2020	46300	389600	435900	2023-08-17
1118	2022	204900	130200	335100	2023-08-17
1118	2021	204900	130200	335100	2023-08-17
1118	2020	195400	93200	288600	2023-08-17
1119	2022	0	290700	290700	2023-08-17
1119	2021	0	290700	290700	2023-08-17
1119	2020	0	243100	243100	2023-08-17
1120	2022	370500	232200	602700	2023-08-17
1120	2021	370500	232200	602700	2023-08-17
1120	2020	336800	202600	539400	2023-08-17
1121	2022	221000	148900	369900	2023-08-17
1121	2021	221000	148900	369900	2023-08-17
1121	2020	195500	102800	298300	2023-08-17
1122	2022	27800	97300	125100	2023-08-17
1122	2021	27800	97300	125100	2023-08-17
1122	2020	10300	67100	77400	2023-08-17
1123	2022	37100	140400	177500	2023-08-17
1123	2021	37100	140400	177500	2023-08-17
1123	2020	14500	115400	129900	2023-08-17
1124	2022	39500	95000	134500	2023-08-17
1124	2021	39500	95000	134500	2023-08-17
1124	2020	120300	68900	189200	2023-08-17
1125	2022	27000	50400	77400	2023-08-17
1125	2021	27000	50400	77400	2023-08-17
1125	2020	12200	44600	56800	2023-08-17
1126	2022	194300	103600	297900	2023-08-17
1126	2021	194300	103600	297900	2023-08-17
1126	2020	168200	79300	247500	2023-08-17
1127	2022	50200	304400	354600	2023-08-17
1127	2021	50200	304400	354600	2023-08-17
1127	2020	39800	264200	304000	2023-08-17
1129	2022	0	107900	107900	2023-08-17
1129	2021	0	107900	107900	2023-08-17
1129	2020	0	71800	71800	2023-08-17
1131	2022	54200	338100	392300	2023-08-17
1131	2021	54200	338100	392300	2023-08-17
1131	2020	30900	289900	320800	2023-08-17
1132	2022	605600	531100	1136700	2023-08-17
1132	2021	605600	534600	1140200	2023-08-17
1132	2020	529300	479100	1008400	2023-08-17
1133	2022	121200	111300	232500	2023-08-17
1133	2021	121200	111300	232500	2023-08-17
1133	2020	85800	88100	173900	2023-08-17
1136	2022	82700	92300	175000	2023-08-17
1136	2021	82700	92300	175000	2023-08-17
1136	2020	68400	70500	138900	2023-08-17
1137	2022	26500	75000	101500	2023-08-17
1137	2021	26500	75000	101500	2023-08-17
1137	2020	12800	62700	75500	2023-08-17
1138	2022	40000	46500	86500	2023-08-17
1138	2021	40000	46500	86500	2023-08-17
1138	2020	32600	36700	69300	2023-08-17
1140	2022	233000	150300	383300	2023-08-17
1140	2021	275600	143300	418900	2023-08-17
1140	2020	211300	84300	295600	2023-08-17
1141	2022	0	3300	3300	2023-08-17
1141	2021	0	3300	3300	2023-08-17
1141	2020	0	3000	3000	2023-08-17
1142	2022	252600	151900	404500	2023-08-17
1142	2021	68200	151900	220100	2023-08-17
1142	2020	61500	96900	158400	2023-08-17
1144	2022	380000	190600	570600	2023-08-17
1144	2021	380000	266400	646400	2023-08-17
1144	2020	395700	305400	701100	2023-08-17
1149	2022	164600	275900	440500	2023-08-17
1149	2021	165700	275900	441600	2023-08-17
1149	2020	127500	226300	353800	2023-08-17
1150	2022	195100	190700	385800	2023-08-17
1150	2021	195100	190700	385800	2023-08-17
1150	2020	217700	164100	381800	2023-08-17
1151	2022	0	347500	347500	2023-08-17
1151	2021	0	347500	347500	2023-08-17
1151	2020	0	299700	299700	2023-08-17
1152	2022	0	311600	311600	2023-08-17
1152	2021	0	311600	311600	2023-08-17
1152	2020	0	260400	260400	2023-08-17
1154	2022	0	100400	100400	2023-08-17
1154	2021	0	100400	100400	2023-08-17
1154	2020	0	79000	79000	2023-08-17
1155	2022	0	217300	217300	2023-08-17
1155	2021	0	217300	217300	2023-08-17
1155	2020	0	168200	168200	2023-08-17
1156	2022	343100	221600	564700	2023-08-17
1156	2021	343100	221600	564700	2023-08-17
1156	2020	333100	179300	512400	2023-08-17
1157	2022	77200	178200	255400	2023-08-17
1157	2021	77200	178200	255400	2023-08-17
1157	2020	87100	143800	230900	2023-08-17
1158	2022	0	304500	304500	2023-08-17
1158	2021	0	304500	304500	2023-08-17
1158	2020	0	249000	249000	2023-08-17
1163	2022	0	205000	205000	2023-08-17
1163	2021	0	205000	205000	2023-08-17
1163	2020	0	172600	172600	2023-08-17
1164	2022	0	2792500	2792500	2023-08-17
1164	2021	0	2792500	2792500	2023-08-17
1164	2020	0	2526900	2526900	2023-08-17
1165	2022	70500	85100	155600	2023-08-17
1165	2021	70500	85100	155600	2023-08-17
1165	2020	57300	71800	129100	2023-08-17
1166	2022	182400	154900	337300	2023-08-17
1166	2021	182400	154900	337300	2023-08-17
1166	2020	191000	121100	312100	2023-08-17
1167	2022	154000	142600	296600	2023-08-17
1167	2021	154000	142600	296600	2023-08-17
1167	2020	132500	111500	244000	2023-08-17
1169	2022	527000	253000	780000	2023-08-17
1169	2021	527000	253000	780000	2023-08-17
1169	2020	509600	202000	711600	2023-08-17
1170	2022	261600	299800	561400	2023-08-17
1170	2021	261600	299800	561400	2023-08-17
1170	2020	274400	259300	533700	2023-08-17
1171	2022	0	83700	83700	2023-08-17
1171	2021	0	83700	83700	2023-08-17
1171	2020	0	65400	65400	2023-08-17
1173	2022	58600	258000	316600	2023-08-17
1173	2021	58600	258000	316600	2023-08-17
1173	2020	52300	167000	219300	2023-08-17
1177	2022	0	324600	324600	2023-08-17
1177	2021	0	324600	324600	2023-08-17
1177	2020	0	292700	292700	2023-08-17
1186	2022	0	59000	59000	2023-08-17
1186	2021	0	59000	59000	2023-08-17
1186	2020	0	52600	52600	2023-08-17
1187	2022	0	72300	72300	2023-08-17
1187	2021	0	72300	72300	2023-08-17
1187	2020	0	55000	55000	2023-08-17
1188	2022	477000	348700	825700	2023-08-17
1188	2021	477000	348700	825700	2023-08-17
1188	2020	464400	294800	759200	2023-08-17
1189	2022	0	290400	290400	2023-08-17
1189	2021	0	290400	290400	2023-08-17
1189	2020	0	242900	242900	2023-08-17
1190	2022	1200	113100	114300	2023-08-17
1190	2021	1200	113100	114300	2023-08-17
1190	2020	1000	87200	88200	2023-08-17
1191	2022	0	110100	110100	2023-08-17
1191	2021	0	110100	110100	2023-08-17
1191	2020	0	84500	84500	2023-08-17
1192	2022	0	22300	22300	2023-08-17
1192	2021	0	22300	22300	2023-08-17
1192	2020	0	18100	18100	2023-08-17
1193	2022	0	77500	77500	2023-08-17
1193	2021	0	77500	77500	2023-08-17
1193	2020	0	68300	68300	2023-08-17
1195	2022	318700	160200	478900	2023-08-17
1195	2021	314400	160200	474600	2023-08-17
1195	2020	289100	125600	414700	2023-08-17
1196	2022	325600	168700	494300	2023-08-17
1196	2021	325600	168700	494300	2023-08-17
1196	2020	347600	106300	453900	2023-08-17
1197	2022	4300	63600	67900	2023-08-17
1197	2021	4300	63600	67900	2023-08-17
1197	2020	3900	48900	52800	2023-08-17
1198	2022	0	0	0	2023-08-17
1198	2021	0	0	0	2023-08-17
1198	2020	0	0	0	2023-08-17
1199	2022	119800	138500	258300	2023-08-17
1199	2021	119800	138500	258300	2023-08-17
1199	2020	106300	100200	206500	2023-08-17
1200	2022	165800	130700	296500	2023-08-17
1200	2021	165800	130700	296500	2023-08-17
1200	2020	121900	99800	221700	2023-08-17
1201	2022	284500	138100	422600	2023-08-17
1201	2021	284500	138100	422600	2023-08-17
1201	2020	271600	105500	377100	2023-08-17
1202	2022	294100	138100	432200	2023-08-17
1202	2021	294100	138100	432200	2023-08-17
1202	2020	308300	105500	413800	2023-08-17
1203	2022	189100	138100	327200	2023-08-17
1203	2021	189100	138100	327200	2023-08-17
1203	2020	169000	99800	268800	2023-08-17
1204	2022	187600	145500	333100	2023-08-17
1204	2021	187600	145500	333100	2023-08-17
1204	2020	223100	105500	328600	2023-08-17
1206	2022	0	625400	625400	2023-08-17
1206	2021	0	625400	625400	2023-08-17
1206	2020	0	565200	565200	2023-08-17
1207	2022	0	16100	16100	2023-08-17
1207	2021	0	16100	16100	2023-08-17
1207	2020	0	12600	12600	2023-08-17
1208	2022	293700	162800	456500	2023-08-17
1208	2021	293700	162800	456500	2023-08-17
1208	2020	288100	141600	429700	2023-08-17
1209	2022	294100	199500	493600	2023-08-17
1209	2021	294100	199500	493600	2023-08-17
1209	2020	278000	156700	434700	2023-08-17
1211	2022	116300	167700	284000	2023-08-17
1211	2021	116300	167700	284000	2023-08-17
1211	2020	112900	120000	232900	2023-08-17
1212	2022	474700	190000	664700	2023-08-17
1212	2021	470800	190000	660800	2023-08-17
1212	2020	369200	160700	529900	2023-08-17
1213	2022	390400	189300	579700	2023-08-17
1213	2021	390400	189300	579700	2023-08-17
1213	2020	393500	160800	554300	2023-08-17
1214	2022	0	33200	33200	2023-08-17
1214	2021	0	33200	33200	2023-08-17
1214	2020	0	30200	30200	2023-08-17
1215	2022	0	419900	419900	2023-08-17
1215	2021	0	419900	419900	2023-08-17
1215	2020	0	331500	331500	2023-08-17
1222	2022	428200	268300	696500	2023-08-17
1222	2021	376600	268300	644900	2023-08-17
1222	2020	316000	221100	537100	2023-08-17
1223	2022	0	428700	428700	2023-08-17
1223	2021	0	428700	428700	2023-08-17
1223	2020	0	403400	403400	2023-08-17
1225	2022	222900	218500	441400	2023-08-17
1225	2021	222900	218500	441400	2023-08-17
1225	2020	215800	190500	406300	2023-08-17
1226	2022	831300	714300	1545600	2023-08-17
1226	2021	831300	714300	1545600	2023-08-17
1226	2020	828300	617400	1445700	2023-08-17
1227	2022	425300	360300	785600	2023-08-17
1227	2021	425300	360300	785600	2023-08-17
1227	2020	404100	338100	742200	2023-08-17
1228	2022	162200	344400	506600	2023-08-17
1228	2021	162200	344400	506600	2023-08-17
1228	2020	139600	303900	443500	2023-08-17
1229	2022	34700	80000	114700	2023-08-17
1229	2021	34700	80000	114700	2023-08-17
1229	2020	38700	71600	110300	2023-08-17
1230	2022	358200	279000	637200	2023-08-17
1230	2021	358200	279000	637200	2023-08-17
1230	2020	302600	233900	536500	2023-08-17
1232	2022	156500	147100	303600	2023-08-17
1232	2021	156500	147100	303600	2023-08-17
1232	2020	157000	113400	270400	2023-08-17
1233	2022	304300	176600	480900	2023-08-17
1233	2021	304300	176600	480900	2023-08-17
1233	2020	277100	166400	443500	2023-08-17
1234	2022	129400	136700	266100	2023-08-17
1234	2021	129400	136700	266100	2023-08-17
1234	2020	100400	93900	194300	2023-08-17
1235	2022	114800	120800	235600	2023-08-17
1235	2021	114800	120800	235600	2023-08-17
1235	2020	71100	91700	162800	2023-08-17
1236	2022	66500	143200	209700	2023-08-17
1236	2021	66500	143200	209700	2023-08-17
1236	2020	51800	106900	158700	2023-08-17
1243	2022	0	299900	299900	2023-08-17
1243	2021	0	299900	299900	2023-08-17
1243	2020	0	249500	249500	2023-08-17
1247	2022	510900	415900	926800	2023-08-17
1247	2021	510900	415900	926800	2023-08-17
1247	2020	426000	358400	784400	2023-08-17
1248	2022	455900	319500	775400	2023-08-17
1248	2021	455900	319500	775400	2023-08-17
1248	2020	431100	293900	725000	2023-08-17
1249	2022	176600	414100	590700	2023-08-17
1249	2021	176600	414100	590700	2023-08-17
1249	2020	161600	375100	536700	2023-08-17
1250	2022	278300	168700	447000	2023-08-17
1250	2021	278300	168700	447000	2023-08-17
1250	2020	275100	134800	409900	2023-08-17
1251	2022	457500	190500	648000	2023-08-17
1251	2021	457500	190500	648000	2023-08-17
1251	2020	382500	155000	537500	2023-08-17
1255	2022	363500	157800	521300	2023-08-17
1255	2021	363500	157800	521300	2023-08-17
1255	2020	284600	125300	409900	2023-08-17
1256	2022	238500	140300	378800	2023-08-17
1256	2021	238500	140300	378800	2023-08-17
1256	2020	244700	109400	354100	2023-08-17
1257	2022	149000	130700	279700	2023-08-17
1257	2021	149000	130700	279700	2023-08-17
1257	2020	130800	90300	221100	2023-08-17
1263	2022	156000	409000	565000	2023-08-17
1263	2021	156000	409000	565000	2023-08-17
1263	2020	156600	345300	501900	2023-08-17
1265	2022	255500	146600	402100	2023-08-17
1265	2021	255500	146600	402100	2023-08-17
1265	2020	249900	118100	368000	2023-08-17
1266	2022	324100	173300	497400	2023-08-17
1266	2021	324100	173300	497400	2023-08-17
1266	2020	302300	140100	442400	2023-08-17
1267	2022	278100	149300	427400	2023-08-17
1267	2021	278100	149300	427400	2023-08-17
1267	2020	209900	103700	313600	2023-08-17
1268	2022	21400	118300	139700	2023-08-17
1268	2021	28300	126800	155100	2023-08-17
1268	2020	13000	91900	104900	2023-08-17
1269	2022	184700	232400	417100	2023-08-17
1269	2021	184700	232400	417100	2023-08-17
1269	2020	190400	186900	377300	2023-08-17
1270	2022	0	5200	5200	2023-08-17
1270	2021	0	5200	5200	2023-08-17
1270	2020	0	4500	4500	2023-08-17
1271	2022	312500	150800	463300	2023-08-17
1271	2021	312500	150800	463300	2023-08-17
1271	2020	321200	111500	432700	2023-08-17
1272	2022	389400	369100	758500	2023-08-17
1272	2021	369200	369100	738300	2023-08-17
1272	2020	367100	317300	684400	2023-08-17
1274	2022	312200	168100	480300	2023-08-17
1274	2021	312200	168100	480300	2023-08-17
1274	2020	306100	128300	434400	2023-08-17
1277	2022	0	294200	294200	2023-08-17
1277	2021	0	294200	294200	2023-08-17
1277	2020	0	261000	261000	2023-08-17
1282	2022	0	304600	304600	2023-08-17
1282	2021	0	304600	304600	2023-08-17
1282	2020	0	261200	261200	2023-08-17
1289	2022	0	181900	181900	2023-08-17
1289	2021	0	181900	181900	2023-08-17
1289	2020	0	165300	165300	2023-08-17
1291	2022	0	33700	33700	2023-08-17
1291	2021	0	33700	33700	2023-08-17
1291	2020	0	30600	30600	2023-08-17
1292	2022	0	186800	186800	2023-08-17
1292	2021	0	186800	186800	2023-08-17
1292	2020	0	168000	168000	2023-08-17
1298	2022	1014200	308700	1322900	2023-08-17
1298	2021	1009200	308700	1317900	2023-08-17
1298	2020	900600	349700	1250300	2023-08-17
1299	2022	329400	124400	453800	2023-08-17
1299	2021	329400	124400	453800	2023-08-17
1299	2020	312600	93000	405600	2023-08-17
1302	2022	0	191600	191600	2023-08-17
1302	2021	0	191600	191600	2023-08-17
1302	2020	0	157900	157900	2023-08-17
1304	2022	830300	1532600	2362900	2023-08-17
1304	2021	830300	1532600	2362900	2023-08-17
1304	2020	782300	1155300	1937600	2023-08-17
1305	2022	3697300	337000	4034300	2023-08-17
1305	2021	3697300	337000	4034300	2023-08-17
1305	2020	3564000	286000	3850000	2023-08-17
1309	2022	0	198000	198000	2023-08-17
1309	2021	0	198000	198000	2023-08-17
1309	2020	0	180000	180000	2023-08-17
1311	2022	441600	237500	679100	2023-08-17
1311	2021	441600	237500	679100	2023-08-17
1311	2020	411300	215900	627200	2023-08-17
1312	2022	0	778800	778800	2023-08-17
1312	2021	0	778800	778800	2023-08-17
1312	2020	0	708000	708000	2023-08-17
1313	2022	241900	187800	429700	2023-08-17
1313	2021	241900	187800	429700	2023-08-17
1313	2020	235400	146100	381500	2023-08-17
1319	2022	5700	193700	199400	2023-08-17
1319	2021	5700	193700	199400	2023-08-17
1319	2020	3900	159300	163200	2023-08-17
1323	2022	402700	163300	566000	2023-08-17
1323	2021	402700	163300	566000	2023-08-17
1323	2020	368900	171300	540200	2023-08-17
1325	2022	207200	252600	459800	2023-08-17
1325	2021	207200	252600	459800	2023-08-17
1325	2020	176000	193300	369300	2023-08-17
1326	2022	780700	402300	1183000	2023-08-17
1326	2021	780700	402300	1183000	2023-08-17
1326	2020	693500	391100	1084600	2023-08-17
1327	2022	0	435200	435200	2023-08-17
1327	2021	0	435200	435200	2023-08-17
1327	2020	0	396800	396800	2023-08-17
1332	2022	0	48800	48800	2023-08-17
1332	2021	0	48800	48800	2023-08-17
1332	2020	0	44400	44400	2023-08-17
1333	2022	527300	330300	857600	2023-08-17
1333	2021	527300	330300	857600	2023-08-17
1333	2020	417400	314400	731800	2023-08-17
1335	2022	307900	254700	562600	2023-08-17
1335	2021	307900	254700	562600	2023-08-17
1335	2020	309700	243500	553200	2023-08-17
1336	2022	0	259300	259300	2023-08-17
1336	2021	0	259300	259300	2023-08-17
1336	2020	0	235600	235600	2023-08-17
1337	2022	0	253000	253000	2023-08-17
1337	2021	0	253000	253000	2023-08-17
1337	2020	0	188900	188900	2023-08-17
1338	2022	546500	204400	750900	2023-08-17
1338	2021	546500	204400	750900	2023-08-17
1338	2020	518300	174200	692500	2023-08-17
1340	2022	225000	195500	420500	2023-08-17
1340	2021	225000	195500	420500	2023-08-17
1340	2020	306100	194900	501000	2023-08-17
1341	2022	644800	202500	847300	2023-08-17
1341	2021	644800	202500	847300	2023-08-17
1341	2020	540800	231100	771900	2023-08-17
1342	2022	456000	230800	686800	2023-08-17
1342	2021	456000	230800	686800	2023-08-17
1342	2020	405700	196500	602200	2023-08-17
1343	2022	100700	198500	299200	2023-08-17
1343	2021	100700	198500	299200	2023-08-17
1343	2020	111900	160500	272400	2023-08-17
1344	2022	518400	1101700	1620100	2023-08-17
1344	2021	518400	1101700	1620100	2023-08-17
1344	2020	503200	733300	1236500	2023-08-17
1352	2022	280600	456900	737500	2023-08-17
1352	2021	280600	456900	737500	2023-08-17
1352	2020	248600	450500	699100	2023-08-17
1353	2022	716800	336300	1053100	2023-08-17
1353	2021	716800	336300	1053100	2023-08-17
1353	2020	674200	295200	969400	2023-08-17
1354	2022	328100	423800	751900	2023-08-17
1354	2021	328100	423800	751900	2023-08-17
1354	2020	390500	315700	706200	2023-08-17
1355	2022	0	251200	251200	2023-08-17
1355	2021	0	251200	251200	2023-08-17
1355	2020	0	227300	227300	2023-08-17
1356	2022	0	2464300	2464300	2023-08-17
1356	2021	0	2464300	2464300	2023-08-17
1356	2020	0	2254200	2254200	2023-08-17
1358	2022	0	30700	30700	2023-08-17
1358	2021	0	30700	30700	2023-08-17
1358	2020	0	27900	27900	2023-08-17
1360	2022	0	228600	228600	2023-08-17
1360	2021	0	228600	228600	2023-08-17
1360	2020	0	206800	206800	2023-08-17
1361	2022	0	142400	142400	2023-08-17
1361	2021	0	142400	142400	2023-08-17
1361	2020	0	128500	128500	2023-08-17
1362	2022	0	96100	96100	2023-08-17
1362	2021	0	96100	96100	2023-08-17
1362	2020	0	86900	86900	2023-08-17
1363	2022	0	89400	89400	2023-08-17
1363	2021	0	89400	89400	2023-08-17
1363	2020	0	80700	80700	2023-08-17
1364	2022	0	221800	221800	2023-08-17
1364	2021	0	221800	221800	2023-08-17
1364	2020	0	168500	168500	2023-08-17
1365	2022	0	29900	29900	2023-08-17
1365	2021	0	29900	29900	2023-08-17
1365	2020	0	22400	22400	2023-08-17
1366	2022	0	208500	208500	2023-08-17
1366	2021	0	208500	208500	2023-08-17
1366	2020	0	184800	184800	2023-08-17
1367	2022	1900	207700	209600	2023-08-17
1367	2021	1900	207700	209600	2023-08-17
1367	2020	3300	162900	166200	2023-08-17
1373	2022	970800	628900	1599700	2023-08-17
1373	2021	970800	628900	1599700	2023-08-17
1373	2020	946000	580800	1526800	2023-08-17
1374	2022	271300	225400	496700	2023-08-17
1374	2021	271300	225400	496700	2023-08-17
1374	2020	181700	207800	389500	2023-08-17
1375	2022	1454000	1846700	3300700	2023-08-17
1375	2021	1454000	1846700	3300700	2023-08-17
1375	2020	1201400	1462100	2663500	2023-08-17
1379	2022	0	144500	144500	2023-08-17
1379	2021	0	144500	144500	2023-08-17
1379	2020	0	131400	131400	2023-08-17
1382	2022	613200	345400	958600	2023-08-17
1382	2021	613200	345400	958600	2023-08-17
1382	2020	495200	390700	885900	2023-08-17
1384	2022	633900	589900	1223800	2023-08-17
1384	2021	633900	589900	1223800	2023-08-17
1384	2020	514900	553900	1068800	2023-08-17
1385	2022	485800	282700	768500	2023-08-17
1385	2021	596200	282700	878900	2023-08-17
1385	2020	468200	313500	781700	2023-08-17
1386	2022	800900	729700	1530600	2023-08-17
1386	2021	800900	729700	1530600	2023-08-17
1386	2020	843000	684800	1527800	2023-08-17
1387	2022	0	356000	356000	2023-08-17
1387	2021	0	356000	356000	2023-08-17
1387	2020	0	283500	283500	2023-08-17
1388	2022	0	264000	264000	2023-08-17
1388	2021	0	264000	264000	2023-08-17
1388	2020	0	234700	234700	2023-08-17
1389	2022	159400	206300	365700	2023-08-17
1389	2021	159400	206300	365700	2023-08-17
1389	2020	111500	179500	291000	2023-08-17
1394	2022	0	166300	166300	2023-08-17
1394	2021	0	166300	166300	2023-08-17
1394	2020	0	151200	151200	2023-08-17
1399	2022	0	61600	61600	2023-08-17
1399	2021	0	61600	61600	2023-08-17
1399	2020	0	56000	56000	2023-08-17
1400	2022	0	93700	93700	2023-08-17
1400	2021	0	93700	93700	2023-08-17
1400	2020	0	85200	85200	2023-08-17
1401	2022	0	49300	49300	2023-08-17
1401	2021	0	49300	49300	2023-08-17
1401	2020	0	44800	44800	2023-08-17
1402	2022	0	305600	305600	2023-08-17
1402	2021	0	305600	305600	2023-08-17
1402	2020	0	220100	220100	2023-08-17
1403	2022	0	8500	8500	2023-08-17
1403	2021	0	8500	8500	2023-08-17
1403	2020	0	7800	7800	2023-08-17
1406	2022	703700	684800	1388500	2023-08-17
1406	2021	703700	684800	1388500	2023-08-17
1406	2020	754700	546800	1301500	2023-08-17
1410	2022	165400	192800	358200	2023-08-17
1410	2021	165400	192800	358200	2023-08-17
1410	2020	153800	184100	337900	2023-08-17
1412	2022	105000	206900	311900	2023-08-17
1412	2021	105000	206900	311900	2023-08-17
1412	2020	96200	174600	270800	2023-08-17
1413	2022	0	86600	86600	2023-08-17
1413	2021	0	86600	86600	2023-08-17
1413	2020	0	78800	78800	2023-08-17
1417	2022	0	345400	345400	2023-08-17
1417	2021	0	345400	345400	2023-08-17
1417	2020	0	374000	374000	2023-08-17
1423	2022	0	342200	342200	2023-08-17
1423	2021	0	342200	342200	2023-08-17
1423	2020	0	311000	311000	2023-08-17
1435	2022	0	88300	88300	2023-08-17
1435	2021	0	88300	88300	2023-08-17
1435	2020	0	80300	80300	2023-08-17
1436	2022	0	57100	57100	2023-08-17
1436	2021	0	57100	57100	2023-08-17
1436	2020	0	51900	51900	2023-08-17
1437	2022	0	183500	183500	2023-08-17
1437	2021	0	183500	183500	2023-08-17
1437	2020	0	166900	166900	2023-08-17
1438	2022	0	177200	177200	2023-08-17
1438	2021	0	177200	177200	2023-08-17
1438	2020	0	159300	159300	2023-08-17
1439	2022	0	85000	85000	2023-08-17
1439	2021	0	85000	85000	2023-08-17
1439	2020	0	77200	77200	2023-08-17
1440	2022	0	404400	404400	2023-08-17
1440	2021	0	404400	404400	2023-08-17
1440	2020	0	367600	367600	2023-08-17
1441	2022	0	7500	7500	2023-08-17
1441	2021	0	7500	7500	2023-08-17
1441	2020	0	6800	6800	2023-08-17
1442	2022	0	10900	10900	2023-08-17
1442	2021	0	10900	10900	2023-08-17
1442	2020	0	9200	9200	2023-08-17
1443	2022	0	589400	589400	2023-08-17
1443	2021	0	589400	589400	2023-08-17
1443	2020	0	512400	512400	2023-08-17
1446	2022	0	630500	630500	2023-08-17
1446	2021	0	630500	630500	2023-08-17
1446	2020	0	595200	595200	2023-08-17
1447	2022	200	269800	270000	2023-08-17
1447	2021	200	269800	270000	2023-08-17
1447	2020	200	230100	230300	2023-08-17
1448	2022	0	282000	282000	2023-08-17
1448	2021	0	282000	282000	2023-08-17
1448	2020	0	241500	241500	2023-08-17
1449	2022	60700	274900	335600	2023-08-17
1449	2021	60700	274900	335600	2023-08-17
1449	2020	79000	179900	258900	2023-08-17
1450	2022	18900	73200	92100	2023-08-17
1450	2021	18900	73200	92100	2023-08-17
1450	2020	16600	64000	80600	2023-08-17
1451	2022	109100	145500	254600	2023-08-17
1451	2021	109100	145500	254600	2023-08-17
1451	2020	86700	118800	205500	2023-08-17
1455	2022	224900	230900	455800	2023-08-17
1455	2021	219200	230900	450100	2023-08-17
1455	2020	208300	142200	350500	2023-08-17
1456	2022	18300	173700	192000	2023-08-17
1456	2021	34800	173700	208500	2023-08-17
1456	2020	27700	110900	138600	2023-08-17
1457	2022	122000	159100	281100	2023-08-17
1457	2021	122000	159100	281100	2023-08-17
1457	2020	123200	132400	255600	2023-08-17
1462	2022	316800	439000	755800	2023-08-17
1462	2021	316800	439000	755800	2023-08-17
1462	2020	280900	362400	643300	2023-08-17
1464	2022	0	138700	138700	2023-08-17
1464	2021	0	138700	138700	2023-08-17
1464	2020	0	113000	113000	2023-08-17
1466	2022	0	368800	368800	2023-08-17
1466	2021	0	368800	368800	2023-08-17
1466	2020	0	315900	315900	2023-08-17
1468	2022	280800	366800	647600	2023-08-17
1468	2021	280800	366800	647600	2023-08-17
1468	2020	232700	285200	517900	2023-08-17
1469	2022	0	75600	75600	2023-08-17
1469	2021	0	75600	75600	2023-08-17
1469	2020	0	70600	70600	2023-08-17
1471	2022	13000	165800	178800	2023-08-17
1471	2021	13000	165800	178800	2023-08-17
1471	2020	13000	67300	80300	2023-08-17
1472	2022	56000	236400	292400	2023-08-17
1472	2021	51300	236400	287700	2023-08-17
1472	2020	44100	156400	200500	2023-08-17
1473	2022	163200	320800	484000	2023-08-17
1473	2021	163200	320800	484000	2023-08-17
1473	2020	165800	201100	366900	2023-08-17
1475	2022	64200	275600	339800	2023-08-17
1475	2021	32700	275600	308300	2023-08-17
1475	2020	46200	157600	203800	2023-08-17
1477	2022	94400	139000	233400	2023-08-17
1477	2021	95100	139000	234100	2023-08-17
1477	2020	79700	106000	185700	2023-08-17
1484	2022	105200	166100	271300	2023-08-17
1484	2021	105200	166100	271300	2023-08-17
1484	2020	87300	123600	210900	2023-08-17
1485	2022	152700	201200	353900	2023-08-17
1485	2021	152700	201200	353900	2023-08-17
1485	2020	120000	148400	268400	2023-08-17
1486	2022	270400	350100	620500	2023-08-17
1486	2021	270400	350100	620500	2023-08-17
1486	2020	256300	253200	509500	2023-08-17
1488	2022	0	332900	332900	2023-08-17
1488	2021	0	332900	332900	2023-08-17
1488	2020	0	296300	296300	2023-08-17
1489	2022	0	459000	459000	2023-08-17
1489	2021	0	459000	459000	2023-08-17
1489	2020	0	277900	277900	2023-08-17
100000	2022	765900	240800	1006700	2023-08-17
100000	2021	765900	240800	1006700	2023-08-17
100000	2020	681800	237700	919500	2023-08-17
100021	2022	1128800	520300	1649100	2023-08-17
100021	2021	1128800	520300	1649100	2023-08-17
100021	2020	1046600	542000	1588600	2023-08-17
100041	2022	0	338400	338400	2023-08-17
100041	2021	0	338400	338400	2023-08-17
100041	2020	0	286400	286400	2023-08-17
100103	2022	234700	229200	463900	2023-08-17
100103	2021	234700	229200	463900	2023-08-17
100103	2020	243600	190700	434300	2023-08-17
100122	2022	386900	280400	667300	2023-08-17
100122	2021	386900	280400	667300	2023-08-17
100122	2020	316200	234500	550700	2023-08-17
100142	2022	217500	0	217500	2023-08-17
100142	2021	217500	0	217500	2023-08-17
100142	2020	185200	0	185200	2023-08-17
100162	2022	217500	0	217500	2023-08-17
100162	2021	217500	0	217500	2023-08-17
100162	2020	185200	0	185200	2023-08-17
100163	2022	251600	0	251600	2023-08-17
100163	2021	251600	0	251600	2023-08-17
100163	2020	229300	0	229300	2023-08-17
100164	2022	244700	0	244700	2023-08-17
100164	2021	244700	0	244700	2023-08-17
100164	2020	213500	0	213500	2023-08-17
100182	2022	377100	0	377100	2023-08-17
100182	2021	377100	0	377100	2023-08-17
100182	2020	326100	0	326100	2023-08-17
100184	2022	349600	0	349600	2023-08-17
100184	2021	349600	0	349600	2023-08-17
100184	2020	356600	0	356600	2023-08-17
100202	2022	0	848400	848400	2023-08-17
100202	2021	0	848400	848400	2023-08-17
100202	2020	0	766400	766400	2023-08-17
100243	2022	478200	229900	708100	2023-08-17
100243	2021	478200	229900	708100	2023-08-17
100243	2020	388000	194600	582600	2023-08-17
100262	2022	826700	257900	1084600	2023-08-17
100262	2021	826700	257900	1084600	2023-08-17
100262	2020	685200	263500	948700	2023-08-17
100263	2022	609800	202300	812100	2023-08-17
100263	2021	609800	202300	812100	2023-08-17
100263	2020	516000	171900	687900	2023-08-17
100264	2022	0	208200	208200	2023-08-17
100264	2021	0	208200	208200	2023-08-17
100264	2020	0	185900	185900	2023-08-17
100265	2022	431900	203100	635000	2023-08-17
100265	2021	431900	203100	635000	2023-08-17
100265	2020	345400	170500	515900	2023-08-17
100282	2022	545900	190100	736000	2023-08-17
100282	2021	545900	190100	736000	2023-08-17
100282	2020	447700	161300	609000	2023-08-17
100302	2022	263600	206300	469900	2023-08-17
100302	2021	263600	206300	469900	2023-08-17
100302	2020	221900	159500	381400	2023-08-17
100322	2022	0	77200	77200	2023-08-17
100322	2021	0	77200	77200	2023-08-17
100322	2020	0	70300	70300	2023-08-17
100361	2022	0	83150	83150	2023-08-17
100361	2021	0	83150	83150	2023-08-17
100361	2020	0	83150	83150	2023-08-17
100401	2022	0	315200	315200	2023-08-17
100401	2021	0	315200	315200	2023-08-17
100401	2020	0	263300	263300	2023-08-17
100422	2022	451200	0	451200	2023-08-17
100422	2021	451200	0	451200	2023-08-17
100422	2020	416300	0	416300	2023-08-17
100442	2022	387700	0	387700	2023-08-17
100442	2021	387700	0	387700	2023-08-17
100442	2020	355600	0	355600	2023-08-17
100462	2022	204700	0	204700	2023-08-17
100462	2021	204700	0	204700	2023-08-17
100462	2020	188700	0	188700	2023-08-17
100463	2022	398200	0	398200	2023-08-17
100463	2021	398200	0	398200	2023-08-17
100463	2020	364500	0	364500	2023-08-17
100482	2022	212900	0	212900	2023-08-17
100482	2021	212900	0	212900	2023-08-17
100482	2020	197100	0	197100	2023-08-17
100502	2022	421200	0	421200	2023-08-17
100502	2021	421200	0	421200	2023-08-17
100502	2020	385100	0	385100	2023-08-17
100503	2022	261900	0	261900	2023-08-17
100503	2021	261900	0	261900	2023-08-17
100503	2020	197400	0	197400	2023-08-17
100522	2022	184400	0	184400	2023-08-17
100522	2021	184400	0	184400	2023-08-17
100522	2020	171300	0	171300	2023-08-17
100523	2022	332100	0	332100	2023-08-17
100523	2021	332100	0	332100	2023-08-17
100523	2020	306200	0	306200	2023-08-17
100542	2022	473800	0	473800	2023-08-17
100542	2021	473800	0	473800	2023-08-17
100542	2020	429200	0	429200	2023-08-17
100543	2022	543400	0	543400	2023-08-17
100543	2021	543400	0	543400	2023-08-17
100543	2020	496700	0	496700	2023-08-17
100562	2022	427400	0	427400	2023-08-17
100562	2021	427400	0	427400	2023-08-17
100562	2020	393600	0	393600	2023-08-17
100563	2022	340300	0	340300	2023-08-17
100563	2021	340300	0	340300	2023-08-17
100563	2020	313300	0	313300	2023-08-17
100582	2022	385200	0	385200	2023-08-17
100582	2021	385200	0	385200	2023-08-17
100582	2020	346100	0	346100	2023-08-17
100583	2022	1848200	0	1848200	2023-08-17
100583	2021	1848200	0	1848200	2023-08-17
100583	2020	1690400	0	1690400	2023-08-17
100602	2022	0	92900	92900	2023-08-17
100602	2021	0	92900	92900	2023-08-17
100602	2020	0	84500	84500	2023-08-17
100622	2022	0	54500	54500	2023-08-17
100622	2021	0	54500	54500	2023-08-17
100622	2020	0	49600	49600	2023-08-17
100642	2022	0	33000	33000	2023-08-17
100642	2021	0	33000	33000	2023-08-17
100642	2020	0	30000	30000	2023-08-17
100662	2022	0	354300	354300	2023-08-17
100662	2021	0	354300	354300	2023-08-17
100662	2020	0	289000	289000	2023-08-17
100722	2022	374200	176700	550900	2023-08-17
100722	2021	359600	176700	536300	2023-08-17
100722	2020	248500	192600	441100	2023-08-17
100742	2022	674200	317100	991300	2023-08-17
100742	2021	674200	317100	991300	2023-08-17
100742	2020	346600	283500	630100	2023-08-17
100822	2022	147600	633900	781500	2023-08-17
100822	2021	147600	633900	781500	2023-08-17
100822	2020	134100	557300	691400	2023-08-17
100863	2022	162900	104400	267300	2023-08-17
100863	2021	162900	104400	267300	2023-08-17
100863	2020	154900	81500	236400	2023-08-17
101082	2022	0	179500	179500	2023-08-17
101082	2021	0	179500	179500	2023-08-17
101082	2020	0	135200	135200	2023-08-17
101143	2022	531300	268600	799900	2023-08-17
101143	2021	588800	295700	884500	2023-08-17
101143	2020	503500	222700	726200	2023-08-17
101162	2022	273300	253100	526400	2023-08-17
101162	2021	273300	253100	526400	2023-08-17
101162	2020	234200	253100	487300	2023-08-17
101182	2022	457000	332800	789800	2023-08-17
101182	2021	457000	332800	789800	2023-08-17
101182	2020	363200	293700	656900	2023-08-17
101183	2022	0	65400	65400	2023-08-17
101183	2021	0	65400	65400	2023-08-17
101183	2020	0	39600	39600	2023-08-17
101202	2022	0	231200	231200	2023-08-17
101202	2021	0	231200	231200	2023-08-17
101202	2020	0	183200	183200	2023-08-17
101203	2022	0	244300	244300	2023-08-17
101203	2021	0	244300	244300	2023-08-17
101203	2020	0	195100	195100	2023-08-17
101204	2022	0	206800	206800	2023-08-17
101204	2021	0	206800	206800	2023-08-17
101204	2020	0	161000	161000	2023-08-17
101205	2022	0	213100	213100	2023-08-17
101205	2021	0	213100	213100	2023-08-17
101205	2020	0	159500	159500	2023-08-17
101224	2022	521700	249600	771300	2023-08-17
101224	2021	484500	249600	734100	2023-08-17
101224	2020	389900	227100	617000	2023-08-17
101242	2022	660000	249300	909300	2023-08-17
101242	2021	660000	249300	909300	2023-08-17
101242	2020	533100	220700	753800	2023-08-17
101243	2022	621200	221300	842500	2023-08-17
101243	2021	621200	221300	842500	2023-08-17
101243	2020	486400	188500	674900	2023-08-17
101262	2022	408800	243800	652600	2023-08-17
101262	2021	405400	243800	649200	2023-08-17
101262	2020	380700	216300	597000	2023-08-17
101282	2022	384200	458200	842400	2023-08-17
101282	2021	384200	458200	842400	2023-08-17
101282	2020	267400	388500	655900	2023-08-17
101325	2022	628800	454300	1083100	2023-08-17
101325	2021	628800	454300	1083100	2023-08-17
101325	2020	594700	486400	1081100	2023-08-17
101342	2022	812300	754500	1566800	2023-08-17
101342	2021	810900	976100	1787000	2023-08-17
101342	2020	811100	610500	1421600	2023-08-17
101362	2022	444400	258900	703300	2023-08-17
101362	2021	516900	258900	775800	2023-08-17
101362	2020	108200	185500	293700	2023-08-17
101382	2022	244600	228800	473400	2023-08-17
101382	2021	244400	228800	473200	2023-08-17
101382	2020	246400	225000	471400	2023-08-17
101442	2022	3500	400400	403900	2023-08-17
101442	2021	3500	400400	403900	2023-08-17
101442	2020	3300	274600	277900	2023-08-17
101462	2022	926800	191100	1117900	2023-08-17
101462	2021	926800	191100	1117900	2023-08-17
101462	2020	840900	176500	1017400	2023-08-17
101483	2022	200	144400	144600	2023-08-17
101483	2021	200	144400	144600	2023-08-17
101483	2020	0	119900	119900	2023-08-17
101502	2022	0	13400	13400	2023-08-17
101502	2021	0	13400	13400	2023-08-17
101502	2020	0	11600	11600	2023-08-17
101523	2022	319000	277400	596400	2023-08-17
101523	2021	319000	277400	596400	2023-08-17
101523	2020	295500	201800	497300	2023-08-17
101542	2022	203700	1088400	1292100	2023-08-17
101542	2021	203700	1088400	1292100	2023-08-17
101542	2020	109800	931600	1041400	2023-08-17
101562	2022	900	379100	380000	2023-08-17
101562	2021	900	379100	380000	2023-08-17
101562	2020	800	338100	338900	2023-08-17
101582	2022	0	118800	118800	2023-08-17
101582	2021	0	118800	118800	2023-08-17
101582	2020	0	108000	108000	2023-08-17
101602	2022	243200	0	243200	2023-08-17
101602	2021	243200	0	243200	2023-08-17
101602	2020	217800	0	217800	2023-08-17
101622	2022	344800	174600	519400	2023-08-17
101622	2021	334300	174600	508900	2023-08-17
101622	2020	139800	150500	290300	2023-08-17
101642	2022	281900	144800	426700	2023-08-17
101642	2021	281900	144800	426700	2023-08-17
101642	2020	260900	111600	372500	2023-08-17
102644	2022	6300	141500	147800	2023-08-17
102644	2021	6300	141500	147800	2023-08-17
102644	2020	8300	113200	121500	2023-08-17
102691	2022	791100	474000	1265100	2023-08-17
102691	2021	791100	474000	1265100	2023-08-17
102691	2020	718300	475300	1193600	2023-08-17
102692	2022	645300	228300	873600	2023-08-17
102692	2021	645300	228300	873600	2023-08-17
102692	2020	522900	201600	724500	2023-08-17
102712	2022	11100	246900	258000	2023-08-17
102712	2021	11100	246900	258000	2023-08-17
102712	2020	8300	183700	192000	2023-08-17
102732	2022	36300	69300	105600	2023-08-17
102732	2021	36300	69300	105600	2023-08-17
102732	2020	16600	62700	79300	2023-08-17
102736	2022	425900	267000	692900	2023-08-17
102736	2021	425900	267000	692900	2023-08-17
102736	2020	394900	259700	654600	2023-08-17
102737	2022	672900	368500	1041400	2023-08-17
102737	2021	672900	368500	1041400	2023-08-17
102737	2020	569100	324800	893900	2023-08-17
102759	2022	0	20100	20100	2023-08-17
102759	2021	0	20100	20100	2023-08-17
102759	2020	0	16900	16900	2023-08-17
102763	2022	0	324900	324900	2023-08-17
102763	2021	0	324900	324900	2023-08-17
102763	2020	0	267300	267300	2023-08-17
102766	2022	171800	174300	346100	2023-08-17
102766	2021	171800	174300	346100	2023-08-17
102766	2020	169600	153300	322900	2023-08-17
102768	2022	0	109300	109300	2023-08-17
102768	2021	0	109300	109300	2023-08-17
102768	2020	0	83800	83800	2023-08-17
102770	2022	632600	356200	988800	2023-08-17
102770	2021	632600	356200	988800	2023-08-17
102770	2020	572100	355700	927800	2023-08-17
102771	2022	155400	136800	292200	2023-08-17
102771	2021	155400	136800	292200	2023-08-17
102771	2020	142000	93900	235900	2023-08-17
102772	2022	0	519500	519500	2023-08-17
102772	2021	0	519500	519500	2023-08-17
102772	2020	0	447800	447800	2023-08-17
102814	2022	49000	342900	391900	2023-08-17
102814	2021	49000	342900	391900	2023-08-17
102814	2020	42600	278300	320900	2023-08-17
102815	2022	0	126900	126900	2023-08-17
102815	2021	0	126900	126900	2023-08-17
102815	2020	0	114900	114900	2023-08-17
102834	2022	860200	522500	1382700	2023-08-17
102834	2021	860200	522500	1382700	2023-08-17
102834	2020	756800	457400	1214200	2023-08-17
102854	2022	67300	91400	158700	2023-08-17
102854	2021	67300	91400	158700	2023-08-17
102854	2020	45900	69600	115500	2023-08-17
102874	2022	0	207500	207500	2023-08-17
102874	2021	0	207500	207500	2023-08-17
102874	2020	0	176900	176900	2023-08-17
102875	2022	0	848300	848300	2023-08-17
102875	2021	0	848300	848300	2023-08-17
102875	2020	0	718400	718400	2023-08-17
102876	2022	0	327900	327900	2023-08-17
102876	2021	0	327900	327900	2023-08-17
102876	2020	0	281700	281700	2023-08-17
102896	2022	0	206700	206700	2023-08-17
102896	2021	0	206700	206700	2023-08-17
102896	2020	0	69900	69900	2023-08-17
102897	2022	72500	280300	352800	2023-08-17
102897	2021	72500	280300	352800	2023-08-17
102897	2020	96500	233500	330000	2023-08-17
102916	2022	0	294700	294700	2023-08-17
102916	2021	0	294700	294700	2023-08-17
102916	2020	0	238600	238600	2023-08-17
102956	2022	0	237100	237100	2023-08-17
102956	2021	0	237100	237100	2023-08-17
102956	2020	0	206300	206300	2023-08-17
102976	2022	37100	465700	502800	2023-08-17
102976	2021	37100	465700	502800	2023-08-17
102976	2020	28500	406000	434500	2023-08-17
102996	2022	0	443800	443800	2023-08-17
102996	2021	0	443800	443800	2023-08-17
102996	2020	0	378400	378400	2023-08-17
103016	2022	34800	299900	334700	2023-08-17
103016	2021	34800	299900	334700	2023-08-17
103016	2020	34200	263800	298000	2023-08-17
103036	2022	0	369500	369500	2023-08-17
103036	2021	0	369500	369500	2023-08-17
103036	2020	0	302800	302800	2023-08-17
103057	2022	327800	330000	657800	2023-08-17
103057	2021	327800	330000	657800	2023-08-17
103057	2020	411500	237400	648900	2023-08-17
103079	2022	0	218500	218500	2023-08-17
103079	2021	0	218500	218500	2023-08-17
103079	2020	0	203700	203700	2023-08-17
103097	2022	0	49900	49900	2023-08-17
103097	2021	0	49900	49900	2023-08-17
103097	2020	0	45700	45700	2023-08-17
103117	2022	37000	44500	81500	2023-08-17
103117	2021	37000	44500	81500	2023-08-17
103117	2020	39700	44500	84200	2023-08-17
103137	2022	50000	0	50000	2023-08-17
103137	2021	50000	0	50000	2023-08-17
103137	2020	45500	0	45500	2023-08-17
103157	2022	0	218000	218000	2023-08-17
103157	2021	0	218000	218000	2023-08-17
103157	2020	0	210000	210000	2023-08-17
103178	2022	33600	88000	121600	2023-08-17
103178	2021	33600	88000	121600	2023-08-17
103197	2022	60000	0	60000	2023-08-17
103197	2021	60000	0	60000	2023-08-17
103220	2022	0	1500	1500	2023-08-17
103222	2022	0	223800	223800	2023-08-17
103224	2022	350700	0	350700	2023-08-17
103225	2022	148500	0	148500	2023-08-17
103226	2022	175000	0	175000	2023-08-17
103227	2022	144800	0	144800	2023-08-17
103228	2022	138900	0	138900	2023-08-17
103229	2022	138000	0	138000	2023-08-17
103230	2022	152100	0	152100	2023-08-17
103233	2022	141100	0	141100	2023-08-17
103237	2022	141000	0	141000	2023-08-17
103238	2022	131100	0	131100	2023-08-17
103239	2022	146200	0	146200	2023-08-17
103240	2022	147300	0	147300	2023-08-17
103242	2022	143100	0	143100	2023-08-17
103243	2022	145400	0	145400	2023-08-17
103244	2022	140800	0	140800	2023-08-17
103245	2022	161100	0	161100	2023-08-17
103246	2022	139800	0	139800	2023-08-17
103247	2022	139800	0	139800	2023-08-17
103248	2022	155900	0	155900	2023-08-17
103249	2022	141600	0	141600	2023-08-17
103250	2022	158900	0	158900	2023-08-17
103251	2022	144800	0	144800	2023-08-17
103252	No Data for PID				2023-08-17
103253	No Data for PID				2023-08-17
103254	No Data for PID				2023-08-17
103255	No Data for PID				2023-08-17