PID	App. Year	Improvements	Land	Total	CollectedOn
1	2025	0	0	0	2024-12-04
1	2023	0	0	0	2024-12-04
1	2022	1254000	0	1254000	2024-12-04
2	2025	2246700	0	2246700	2024-12-04
2	2023	2705300	0	2705300	2024-12-04
2	2022	3294400	0	3294400	2024-12-04
3	2025	1601800	0	1601800	2024-12-04
3	2023	2007300	0	2007300	2024-12-04
3	2022	2353000	0	2353000	2024-12-04
4	2025	10300	0	10300	2024-12-04
4	2023	12600	0	12600	2024-12-04
4	2022	12600	0	12600	2024-12-04
5	2025	93700	167600	261300	2024-12-04
5	2023	93700	167600	261300	2024-12-04
5	2022	93700	167600	261300	2024-12-04
7	2025	77200	104600	181800	2024-12-04
7	2023	77200	104600	181800	2024-12-04
7	2022	77200	104600	181800	2024-12-04
8	2025	114000	140400	254400	2024-12-04
8	2023	114000	140400	254400	2024-12-04
8	2022	114000	140400	254400	2024-12-04
9	2025	112100	157900	270000	2024-12-04
9	2023	112100	157900	270000	2024-12-04
9	2022	112100	157900	270000	2024-12-04
10	2025	254100	163000	417100	2024-12-04
10	2023	254100	163000	417100	2024-12-04
10	2022	254100	163000	417100	2024-12-04
12	2025	261800	225200	487000	2024-12-04
12	2023	261800	225200	487000	2024-12-04
12	2022	261800	225200	487000	2024-12-04
13	2025	275700	280700	556400	2024-12-04
13	2023	275700	280700	556400	2024-12-04
13	2022	275700	280700	556400	2024-12-04
16	2025	1016100	385700	1401800	2024-12-04
16	2023	1016100	385700	1401800	2024-12-04
16	2022	1016100	385700	1401800	2024-12-04
18	2025	201700	136700	338400	2024-12-04
18	2023	194000	122600	316600	2024-12-04
18	2022	194000	139100	333100	2024-12-04
19	2025	125000	95400	220400	2024-12-04
19	2023	125000	106300	231300	2024-12-04
19	2022	125000	62300	187300	2024-12-04
20	2025	386900	234400	621300	2024-12-04
20	2023	381400	234400	615800	2024-12-04
20	2022	381400	234400	615800	2024-12-04
21	2025	398100	288400	686500	2024-12-04
21	2023	398100	288400	686500	2024-12-04
21	2022	398100	288400	686500	2024-12-04
22	2025	269300	179700	449000	2024-12-04
22	2023	269300	179700	449000	2024-12-04
22	2022	269300	179700	449000	2024-12-04
23	2025	239600	243000	482600	2024-12-04
23	2023	233100	245600	478700	2024-12-04
23	2022	233100	245600	478700	2024-12-04
25	2025	392500	170500	563000	2024-12-04
25	2023	392500	170500	563000	2024-12-04
25	2022	378700	170500	549200	2024-12-04
26	2025	144700	205300	350000	2024-12-04
26	2023	144700	205300	350000	2024-12-04
26	2022	144700	205300	350000	2024-12-04
27	2025	386800	210000	596800	2024-12-04
27	2023	327100	210000	537100	2024-12-04
27	2022	327100	210000	537100	2024-12-04
28	2025	322000	244000	566000	2024-12-04
28	2023	302000	244000	546000	2024-12-04
28	2022	298800	244000	542800	2024-12-04
29	2025	420400	235700	656100	2024-12-04
29	2023	420400	235700	656100	2024-12-04
29	2022	420400	235700	656100	2024-12-04
30	2025	275300	218200	493500	2024-12-04
30	2023	275300	218200	493500	2024-12-04
30	2022	275300	218200	493500	2024-12-04
32	2025	136200	146800	283000	2024-12-04
32	2023	136200	146800	283000	2024-12-04
32	2022	131000	146800	277800	2024-12-04
33	2025	176400	151600	328000	2024-12-04
33	2023	176400	151600	328000	2024-12-04
33	2022	176400	151600	328000	2024-12-04
34	2025	395200	157700	552900	2024-12-04
34	2023	395200	157700	552900	2024-12-04
34	2022	395200	157700	552900	2024-12-04
35	2025	0	29200	29200	2024-12-04
35	2023	0	29200	29200	2024-12-04
35	2022	0	29200	29200	2024-12-04
36	2025	415200	416200	831400	2024-12-04
36	2023	377800	416200	794000	2024-12-04
36	2022	303000	416200	719200	2024-12-04
37	2025	297500	353000	650500	2024-12-04
37	2023	297500	353000	650500	2024-12-04
37	2022	297500	353000	650500	2024-12-04
40	2025	0	43000	43000	2024-12-04
40	2023	0	43000	43000	2024-12-04
40	2022	0	43000	43000	2024-12-04
41	2025	447000	186000	633000	2024-12-04
41	2023	447000	186000	633000	2024-12-04
41	2022	447000	186000	633000	2024-12-04
42	2025	269800	218700	488500	2024-12-04
42	2023	269800	218700	488500	2024-12-04
42	2022	269800	218700	488500	2024-12-04
43	2025	137300	208300	345600	2024-12-04
43	2023	137300	208300	345600	2024-12-04
43	2022	137300	208300	345600	2024-12-04
50	2025	194300	0	194300	2024-12-04
50	2023	194300	0	194300	2024-12-04
50	2022	194300	0	194300	2024-12-04
51	2025	197400	0	197400	2024-12-04
51	2023	197400	0	197400	2024-12-04
51	2022	197400	0	197400	2024-12-04
52	2025	184100	0	184100	2024-12-04
52	2023	184100	0	184100	2024-12-04
52	2022	184100	0	184100	2024-12-04
53	2025	208500	0	208500	2024-12-04
53	2023	208500	0	208500	2024-12-04
53	2022	208500	0	208500	2024-12-04
54	2025	179900	0	179900	2024-12-04
54	2023	179900	0	179900	2024-12-04
54	2022	179900	0	179900	2024-12-04
55	2025	195600	0	195600	2024-12-04
55	2023	195600	0	195600	2024-12-04
55	2022	195600	0	195600	2024-12-04
56	2025	545500	234500	780000	2024-12-04
56	2023	1025200	234500	1259700	2024-12-04
56	2022	976100	234500	1210600	2024-12-04
57	2025	734700	230000	964700	2024-12-04
57	2023	734700	230000	964700	2024-12-04
57	2022	734700	230000	964700	2024-12-04
58	2025	653600	262000	915600	2024-12-04
58	2023	653600	262000	915600	2024-12-04
58	2022	653600	262000	915600	2024-12-04
59	2025	355300	156500	511800	2024-12-04
59	2023	355300	156500	511800	2024-12-04
59	2022	355300	156500	511800	2024-12-04
60	2025	485100	218900	704000	2024-12-04
60	2023	485100	218900	704000	2024-12-04
60	2022	485100	218900	704000	2024-12-04
62	2025	515100	163900	679000	2024-12-04
62	2023	515100	163900	679000	2024-12-04
62	2022	498400	163900	662300	2024-12-04
63	2025	258400	232100	490500	2024-12-04
63	2023	258400	232100	490500	2024-12-04
63	2022	258400	232100	490500	2024-12-04
64	2025	103900	218200	322100	2024-12-04
64	2023	103900	218200	322100	2024-12-04
64	2022	103900	218200	322100	2024-12-04
65	2025	493400	228900	722300	2024-12-04
65	2023	482500	228900	711400	2024-12-04
65	2022	436100	228900	665000	2024-12-04
66	2025	235300	230900	466200	2024-12-04
66	2023	218800	230900	449700	2024-12-04
66	2022	218800	230900	449700	2024-12-04
67	2025	0	103200	103200	2024-12-04
67	2023	0	103200	103200	2024-12-04
67	2022	0	103200	103200	2024-12-04
68	2025	127000	157100	284100	2024-12-04
68	2023	127000	157100	284100	2024-12-04
68	2022	127000	157100	284100	2024-12-04
69	2025	0	8600	8600	2024-12-04
69	2023	0	8600	8600	2024-12-04
69	2022	0	8600	8600	2024-12-04
76	2025	568500	234400	802900	2024-12-04
76	2023	519800	234400	754200	2024-12-04
76	2022	519800	234400	754200	2024-12-04
77	2025	343500	234900	578400	2024-12-04
77	2023	343500	234900	578400	2024-12-04
77	2022	343500	234900	578400	2024-12-04
78	2025	173800	216500	390300	2024-12-04
78	2023	173800	216500	390300	2024-12-04
78	2022	173800	216500	390300	2024-12-04
79	2025	116800	216500	333300	2024-12-04
79	2023	116800	216500	333300	2024-12-04
79	2022	116800	216500	333300	2024-12-04
80	2025	352100	317200	669300	2024-12-04
80	2023	301600	317200	618800	2024-12-04
80	2022	301600	317200	618800	2024-12-04
81	2025	92200	233300	325500	2024-12-04
81	2023	92200	233300	325500	2024-12-04
81	2022	92200	233300	325500	2024-12-04
82	2025	217700	199300	417000	2024-12-04
82	2023	217700	199300	417000	2024-12-04
82	2022	217700	199300	417000	2024-12-04
83	2025	190300	161800	352100	2024-12-04
83	2023	190300	161800	352100	2024-12-04
83	2022	190300	161800	352100	2024-12-04
84	2025	3187200	2000100	5187300	2024-12-04
84	2023	3187200	2000100	5187300	2024-12-04
84	2022	3187200	2000100	5187300	2024-12-04
85	2025	0	16900	16900	2024-12-04
85	2023	0	16900	16900	2024-12-04
85	2022	0	16900	16900	2024-12-04
86	2025	471700	228900	700600	2024-12-04
86	2023	471700	228900	700600	2024-12-04
86	2022	471700	228900	700600	2024-12-04
87	2025	379700	256000	635700	2024-12-04
87	2023	379700	256000	635700	2024-12-04
87	2022	379700	256000	635700	2024-12-04
88	2025	43200	113400	156600	2024-12-04
88	2023	43200	113400	156600	2024-12-04
88	2022	43200	113400	156600	2024-12-04
89	2025	269500	375600	645100	2024-12-04
89	2023	269500	375600	645100	2024-12-04
89	2022	252300	375600	627900	2024-12-04
91	2025	526300	277000	803300	2024-12-04
91	2023	526300	277000	803300	2024-12-04
91	2022	526300	277000	803300	2024-12-04
92	2025	77800	179500	257300	2024-12-04
92	2023	77800	179500	257300	2024-12-04
92	2022	77800	179500	257300	2024-12-04
93	2025	548900	204300	753200	2024-12-04
93	2023	548900	204300	753200	2024-12-04
93	2022	548900	204300	753200	2024-12-04
94	2025	385500	179200	564700	2024-12-04
94	2023	385500	179200	564700	2024-12-04
94	2022	385500	179200	564700	2024-12-04
95	2025	410100	207600	617700	2024-12-04
95	2023	410100	207600	617700	2024-12-04
95	2022	410100	207600	617700	2024-12-04
99	2025	328500	0	328500	2024-12-04
99	2023	328500	0	328500	2024-12-04
99	2022	328500	0	328500	2024-12-04
101	2025	543900	0	543900	2024-12-04
101	2023	543900	0	543900	2024-12-04
101	2022	543900	0	543900	2024-12-04
102	2025	7500	104000	111500	2024-12-04
102	2023	7500	104000	111500	2024-12-04
102	2022	7500	104000	111500	2024-12-04
103	2025	121800	185100	306900	2024-12-04
103	2023	121800	185100	306900	2024-12-04
103	2022	121800	185100	306900	2024-12-04
104	2025	1055000	394300	1449300	2024-12-04
104	2023	1055000	394300	1449300	2024-12-04
104	2022	1055000	394300	1449300	2024-12-04
105	2025	236100	274300	510400	2024-12-04
105	2023	236100	274300	510400	2024-12-04
105	2022	236100	274300	510400	2024-12-04
106	2025	1421000	488300	1909300	2024-12-04
106	2023	1421000	488300	1909300	2024-12-04
106	2022	1421000	488300	1909300	2024-12-04
107	2025	359500	263700	623200	2024-12-04
107	2023	359500	263700	623200	2024-12-04
107	2022	359500	263700	623200	2024-12-04
111	2025	4400	424700	429100	2024-12-04
111	2023	4400	424700	429100	2024-12-04
111	2022	4400	424700	429100	2024-12-04
115	2025	148600	194200	342800	2024-12-04
115	2023	89200	194200	283400	2024-12-04
115	2022	51000	194200	245200	2024-12-04
116	2025	249500	148200	397700	2024-12-04
116	2023	249500	148200	397700	2024-12-04
116	2022	249500	148200	397700	2024-12-04
117	2025	435400	0	435400	2024-12-04
117	2023	435400	0	435400	2024-12-04
117	2022	426300	0	426300	2024-12-04
118	2025	155800	405100	560900	2024-12-04
118	2023	155800	405100	560900	2024-12-04
118	2022	155800	405100	560900	2024-12-04
120	2025	462100	360800	822900	2024-12-04
120	2023	462100	360800	822900	2024-12-04
120	2022	462100	360800	822900	2024-12-04
121	2025	187800	143700	331500	2024-12-04
121	2023	124500	143700	268200	2024-12-04
121	2022	2900	143700	146600	2024-12-04
122	2025	273000	133300	406300	2024-12-04
122	2023	273000	133300	406300	2024-12-04
122	2022	273000	133300	406300	2024-12-04
123	2025	151900	132200	284100	2024-12-04
123	2023	151900	132200	284100	2024-12-04
123	2022	151900	132200	284100	2024-12-04
124	2025	354900	223000	577900	2024-12-04
124	2023	354900	223000	577900	2024-12-04
124	2022	354900	223000	577900	2024-12-04
125	2025	272000	155700	427700	2024-12-04
125	2023	272000	155700	427700	2024-12-04
125	2022	272000	155700	427700	2024-12-04
127	2025	240200	153300	393500	2024-12-04
127	2023	240200	153300	393500	2024-12-04
127	2022	240200	153300	393500	2024-12-04
128	2025	395000	188500	583500	2024-12-04
128	2023	395000	188500	583500	2024-12-04
128	2022	395000	188500	583500	2024-12-04
129	2025	182300	157500	339800	2024-12-04
129	2023	182300	157500	339800	2024-12-04
129	2022	182300	157500	339800	2024-12-04
132	2025	0	40300	40300	2024-12-04
132	2023	0	40300	40300	2024-12-04
132	2022	0	40300	40300	2024-12-04
133	2025	42000	0	42000	2024-12-04
133	2023	42000	0	42000	2024-12-04
133	2022	42000	0	42000	2024-12-04
136	2025	15200	12200	27400	2024-12-04
136	2023	15200	12200	27400	2024-12-04
136	2022	15200	12200	27400	2024-12-04
137	2025	46900	189400	236300	2024-12-04
137	2023	46900	189400	236300	2024-12-04
137	2022	46900	189400	236300	2024-12-04
138	2025	1194500	246000	1440500	2024-12-04
138	2023	1194500	246000	1440500	2024-12-04
138	2022	1194500	246000	1440500	2024-12-04
139	2025	84900	166400	251300	2024-12-04
139	2023	81400	166400	247800	2024-12-04
139	2022	81400	166400	247800	2024-12-04
140	2025	595300	151500	746800	2024-12-04
140	2023	595300	151500	746800	2024-12-04
140	2022	575300	151500	726800	2024-12-04
142	2025	183800	209900	393700	2024-12-04
142	2023	183800	209900	393700	2024-12-04
142	2022	183800	209900	393700	2024-12-04
143	2025	334100	206900	541000	2024-12-04
143	2023	334100	206900	541000	2024-12-04
143	2022	334100	206900	541000	2024-12-04
144	2025	143600	133000	276600	2024-12-04
144	2023	145200	133000	278200	2024-12-04
144	2022	145200	133000	278200	2024-12-04
148	2025	163800	142700	306500	2024-12-04
148	2023	163800	142700	306500	2024-12-04
148	2022	163800	142700	306500	2024-12-04
149	2025	385600	171200	556800	2024-12-04
149	2023	385600	171200	556800	2024-12-04
149	2022	385600	171200	556800	2024-12-04
150	2025	402500	170200	572700	2024-12-04
150	2023	402500	170200	572700	2024-12-04
150	2022	410700	170200	580900	2024-12-04
151	2025	0	218500	218500	2024-12-04
151	2023	0	218500	218500	2024-12-04
151	2022	0	218500	218500	2024-12-04
152	2025	176000	84800	260800	2024-12-04
152	2023	176000	84800	260800	2024-12-04
152	2022	176000	84800	260800	2024-12-04
153	2025	149400	111300	260700	2024-12-04
153	2023	149400	111300	260700	2024-12-04
153	2022	149400	111300	260700	2024-12-04
154	2025	82500	82400	164900	2024-12-04
154	2023	82500	82400	164900	2024-12-04
154	2022	82500	82400	164900	2024-12-04
159	2025	23700	166100	189800	2024-12-04
159	2023	23700	166100	189800	2024-12-04
159	2022	21200	166100	187300	2024-12-04
161	2025	562100	219600	781700	2024-12-04
161	2023	562100	219600	781700	2024-12-04
161	2022	562100	219600	781700	2024-12-04
162	2025	172300	126800	299100	2024-12-04
162	2023	172300	126800	299100	2024-12-04
162	2022	165400	126800	292200	2024-12-04
163	2025	269600	158900	428500	2024-12-04
163	2023	269600	158900	428500	2024-12-04
163	2022	269600	158900	428500	2024-12-04
164	2025	46200	98300	144500	2024-12-04
164	2023	46200	98300	144500	2024-12-04
164	2022	46200	98300	144500	2024-12-04
167	2025	289300	224000	513300	2024-12-04
167	2023	289300	224000	513300	2024-12-04
167	2022	289300	224000	513300	2024-12-04
168	2025	174500	129600	304100	2024-12-04
168	2023	174500	129600	304100	2024-12-04
168	2022	174500	129600	304100	2024-12-04
169	2025	154200	111100	265300	2024-12-04
169	2023	154200	111100	265300	2024-12-04
169	2022	154200	111100	265300	2024-12-04
170	2025	1225500	266800	1492300	2024-12-04
170	2023	1225500	266800	1492300	2024-12-04
170	2022	1225500	266800	1492300	2024-12-04
171	2025	0	144500	144500	2024-12-04
171	2023	0	144500	144500	2024-12-04
171	2022	0	144500	144500	2024-12-04
172	2025	230600	177800	408400	2024-12-04
172	2023	0	161400	161400	2024-12-04
172	2022	0	161400	161400	2024-12-04
173	2025	465200	146600	611800	2024-12-04
173	2023	465200	146600	611800	2024-12-04
173	2022	465200	146600	611800	2024-12-04
174	2025	152300	132200	284500	2024-12-04
174	2023	152300	132200	284500	2024-12-04
174	2022	152300	132200	284500	2024-12-04
176	2025	156600	137900	294500	2024-12-04
176	2023	156600	137900	294500	2024-12-04
176	2022	156600	137900	294500	2024-12-04
177	2025	87900	129800	217700	2024-12-04
177	2023	81400	129800	211200	2024-12-04
177	2022	81400	129800	211200	2024-12-04
178	2025	231800	126600	358400	2024-12-04
178	2023	231800	126600	358400	2024-12-04
178	2022	231800	126600	358400	2024-12-04
179	2025	149400	138100	287500	2024-12-04
179	2023	149400	138100	287500	2024-12-04
179	2022	149400	138100	287500	2024-12-04
180	2025	597800	284700	882500	2024-12-04
180	2023	597800	284700	882500	2024-12-04
180	2022	597800	284700	882500	2024-12-04
181	2025	0	333600	333600	2024-12-04
181	2023	0	333600	333600	2024-12-04
181	2022	0	333600	333600	2024-12-04
182	2025	546700	233200	779900	2024-12-04
182	2023	546700	233200	779900	2024-12-04
182	2022	507900	233200	741100	2024-12-04
183	2025	282900	103000	385900	2024-12-04
183	2023	282900	103000	385900	2024-12-04
183	2022	282900	103000	385900	2024-12-04
187	2025	314000	322400	636400	2024-12-04
187	2023	314000	322400	636400	2024-12-04
187	2022	314000	322400	636400	2024-12-04
188	2025	641500	312400	953900	2024-12-04
188	2023	613900	312400	926300	2024-12-04
188	2022	613900	312400	926300	2024-12-04
189	2025	8500	129600	138100	2024-12-04
189	2023	8500	129600	138100	2024-12-04
189	2022	8500	129600	138100	2024-12-04
190	2025	0	59200	59200	2024-12-04
190	2023	0	59200	59200	2024-12-04
190	2022	0	59200	59200	2024-12-04
191	2025	0	204100	204100	2024-12-04
191	2023	0	204100	204100	2024-12-04
191	2022	0	204100	204100	2024-12-04
192	2025	0	689600	689600	2024-12-04
192	2023	0	689600	689600	2024-12-04
192	2022	0	689600	689600	2024-12-04
194	2025	0	22300	22300	2024-12-04
194	2023	0	22300	22300	2024-12-04
194	2022	0	22300	22300	2024-12-04
195	2025	343500	176200	519700	2024-12-04
195	2023	343500	176200	519700	2024-12-04
195	2022	343500	176200	519700	2024-12-04
197	2025	0	166600	166600	2024-12-04
197	2023	0	166600	166600	2024-12-04
197	2022	0	166600	166600	2024-12-04
201	2025	322700	251700	574400	2024-12-04
201	2023	322700	251700	574400	2024-12-04
201	2022	322700	251700	574400	2024-12-04
202	2025	420600	774500	1195100	2024-12-04
202	2023	420600	774500	1195100	2024-12-04
202	2022	418600	774500	1193100	2024-12-04
203	2025	232400	125100	357500	2024-12-04
203	2023	232400	125100	357500	2024-12-04
203	2022	232400	125100	357500	2024-12-04
204	2025	396000	484700	880700	2024-12-04
204	2023	396000	484700	880700	2024-12-04
204	2022	396000	484700	880700	2024-12-04
206	2025	606800	227800	834600	2024-12-04
206	2023	606800	227800	834600	2024-12-04
206	2022	606800	227800	834600	2024-12-04
207	2025	1700	647500	649200	2024-12-04
207	2023	1700	647500	649200	2024-12-04
207	2022	1700	647500	649200	2024-12-04
208	2025	136600	142400	279000	2024-12-04
208	2023	136600	142400	279000	2024-12-04
208	2022	180600	142400	323000	2024-12-04
209	2025	124500	143300	267800	2024-12-04
209	2023	124500	143300	267800	2024-12-04
209	2022	124500	143300	267800	2024-12-04
210	2025	193800	143300	337100	2024-12-04
210	2023	193800	143300	337100	2024-12-04
210	2022	193800	143300	337100	2024-12-04
217	2025	0	476800	476800	2024-12-04
217	2023	0	476800	476800	2024-12-04
217	2022	0	476800	476800	2024-12-04
219	2025	176100	164500	340600	2024-12-04
219	2023	176100	164500	340600	2024-12-04
219	2022	176100	164500	340600	2024-12-04
220	2025	180400	108100	288500	2024-12-04
220	2023	180400	108100	288500	2024-12-04
220	2022	180400	108100	288500	2024-12-04
221	2025	221900	95600	317500	2024-12-04
221	2023	221900	95600	317500	2024-12-04
221	2022	221900	95600	317500	2024-12-04
222	2025	269100	168700	437800	2024-12-04
222	2023	269100	168700	437800	2024-12-04
222	2022	269100	168700	437800	2024-12-04
223	2025	346400	175300	521700	2024-12-04
223	2023	334100	175300	509400	2024-12-04
223	2022	334100	175300	509400	2024-12-04
224	2025	234300	215300	449600	2024-12-04
224	2023	234300	215300	449600	2024-12-04
224	2022	234300	215300	449600	2024-12-04
225	2025	69400	176600	246000	2024-12-04
225	2023	86100	176600	262700	2024-12-04
225	2022	86100	176600	262700	2024-12-04
229	2025	344200	179600	523800	2024-12-04
229	2023	312700	179600	492300	2024-12-04
229	2022	312700	179600	492300	2024-12-04
230	2025	0	218200	218200	2024-12-04
230	2023	0	218200	218200	2024-12-04
230	2022	0	218200	218200	2024-12-04
231	2025	0	91300	91300	2024-12-04
231	2023	0	91300	91300	2024-12-04
231	2022	82800	91300	174100	2024-12-04
232	2025	72200	57800	130000	2024-12-04
232	2023	72200	57800	130000	2024-12-04
232	2022	72200	57800	130000	2024-12-04
233	2025	81500	65100	146600	2024-12-04
233	2023	81500	65100	146600	2024-12-04
233	2022	81500	65100	146600	2024-12-04
234	2025	228500	134400	362900	2024-12-04
234	2023	228500	134400	362900	2024-12-04
234	2022	228500	134400	362900	2024-12-04
235	2025	455900	169300	625200	2024-12-04
235	2023	455900	169300	625200	2024-12-04
235	2022	455900	169300	625200	2024-12-04
236	2025	184400	119700	304100	2024-12-04
236	2023	184400	119700	304100	2024-12-04
236	2022	184400	119700	304100	2024-12-04
237	2025	45100	88200	133300	2024-12-04
237	2023	45100	88200	133300	2024-12-04
237	2022	45100	88200	133300	2024-12-04
238	2025	149100	133300	282400	2024-12-04
238	2023	149100	133300	282400	2024-12-04
238	2022	149100	133300	282400	2024-12-04
241	2025	62700	719400	782100	2024-12-04
241	2023	62700	719400	782100	2024-12-04
241	2022	143900	719400	863300	2024-12-04
243	2025	0	9700	9700	2024-12-04
243	2023	0	9700	9700	2024-12-04
243	2022	0	9700	9700	2024-12-04
244	2025	0	800	800	2024-12-04
244	2023	0	800	800	2024-12-04
244	2022	0	800	800	2024-12-04
245	2025	193200	115700	308900	2024-12-04
245	2023	193200	115700	308900	2024-12-04
245	2022	193200	115700	308900	2024-12-04
246	2025	0	300300	300300	2024-12-04
246	2023	0	300300	300300	2024-12-04
246	2022	0	300300	300300	2024-12-04
247	2025	13400	149200	162600	2024-12-04
247	2023	13400	149200	162600	2024-12-04
247	2022	13400	149200	162600	2024-12-04
248	2025	126300	137700	264000	2024-12-04
248	2023	126300	137700	264000	2024-12-04
248	2022	126300	137700	264000	2024-12-04
249	2025	155900	144300	300200	2024-12-04
249	2023	155900	144300	300200	2024-12-04
249	2022	155900	144300	300200	2024-12-04
250	2025	0	341700	341700	2024-12-04
250	2023	0	341700	341700	2024-12-04
250	2022	0	341700	341700	2024-12-04
251	2025	397000	349100	746100	2024-12-04
251	2023	367000	349100	716100	2024-12-04
251	2022	367000	349100	716100	2024-12-04
252	2025	176700	251500	428200	2024-12-04
252	2023	176700	251500	428200	2024-12-04
252	2022	176700	251500	428200	2024-12-04
253	2025	227100	150400	377500	2024-12-04
253	2023	212100	150400	362500	2024-12-04
253	2022	212100	150400	362500	2024-12-04
254	2025	416800	460900	877700	2024-12-04
254	2023	356800	460900	817700	2024-12-04
254	2022	356800	460900	817700	2024-12-04
255	2025	575400	129400	704800	2024-12-04
255	2023	523800	129400	653200	2024-12-04
255	2022	471100	129400	600500	2024-12-04
256	2025	1367900	364300	1732200	2024-12-04
256	2023	1367900	364300	1732200	2024-12-04
256	2022	1367900	364300	1732200	2024-12-04
257	2025	56900	130700	187600	2024-12-04
257	2023	56900	130700	187600	2024-12-04
257	2022	56900	130700	187600	2024-12-04
258	2025	378800	0	378800	2024-12-04
258	2023	378800	0	378800	2024-12-04
258	2022	378800	0	378800	2024-12-04
259	2025	2454700	592700	3047400	2024-12-04
259	2023	2454700	592700	3047400	2024-12-04
259	2022	2454700	592700	3047400	2024-12-04
260	2025	70800	164500	235300	2024-12-04
260	2023	82600	164500	247100	2024-12-04
260	2022	82600	164500	247100	2024-12-04
267	2025	72400	122600	195000	2024-12-04
267	2023	66900	122600	189500	2024-12-04
267	2022	66900	122600	189500	2024-12-04
270	2025	54400	117800	172200	2024-12-04
270	2023	54400	117800	172200	2024-12-04
270	2022	54400	117800	172200	2024-12-04
271	2025	293800	127600	421400	2024-12-04
271	2023	293800	127600	421400	2024-12-04
271	2022	293800	127600	421400	2024-12-04
272	2025	0	11300	11300	2024-12-04
272	2023	0	11300	11300	2024-12-04
272	2022	0	11300	11300	2024-12-04
273	2025	32800	100700	133500	2024-12-04
273	2023	32800	100700	133500	2024-12-04
273	2022	32800	100700	133500	2024-12-04
274	2025	230700	139000	369700	2024-12-04
274	2023	230700	139000	369700	2024-12-04
274	2022	230700	139000	369700	2024-12-04
275	2025	15500	109800	125300	2024-12-04
275	2023	15500	109800	125300	2024-12-04
275	2022	15500	109800	125300	2024-12-04
276	2025	133100	173400	306500	2024-12-04
276	2023	133100	173400	306500	2024-12-04
276	2022	133100	173400	306500	2024-12-04
277	2025	0	58200	58200	2024-12-04
277	2023	0	58200	58200	2024-12-04
277	2022	0	58200	58200	2024-12-04
278	2025	147100	303100	450200	2024-12-04
278	2023	147100	303100	450200	2024-12-04
278	2022	147100	303100	450200	2024-12-04
279	2025	161300	176800	338100	2024-12-04
279	2023	161300	176800	338100	2024-12-04
279	2022	161300	176800	338100	2024-12-04
280	2025	0	431500	431500	2024-12-04
280	2023	0	431500	431500	2024-12-04
280	2022	0	431500	431500	2024-12-04
283	2025	25500	171600	197100	2024-12-04
283	2023	25500	171600	197100	2024-12-04
283	2022	25500	171600	197100	2024-12-04
287	2025	566500	297100	863600	2024-12-04
287	2023	566500	297100	863600	2024-12-04
287	2022	566500	297100	863600	2024-12-04
288	2025	245600	328100	573700	2024-12-04
288	2023	245600	328100	573700	2024-12-04
288	2022	245600	328100	573700	2024-12-04
290	2025	618200	454000	1072200	2024-12-04
290	2023	618200	454000	1072200	2024-12-04
290	2022	618200	454000	1072200	2024-12-04
291	2025	0	139200	139200	2024-12-04
291	2023	0	139200	139200	2024-12-04
291	2022	0	139200	139200	2024-12-04
292	2025	376400	569300	945700	2024-12-04
292	2023	376400	569300	945700	2024-12-04
292	2022	($18,800)	569300	550500	2024-12-04
294	2025	411100	386400	797500	2024-12-04
294	2023	411100	386400	797500	2024-12-04
294	2022	411100	386400	797500	2024-12-04
295	2025	132400	104100	236500	2024-12-04
295	2023	132400	104100	236500	2024-12-04
295	2022	132400	104100	236500	2024-12-04
296	2025	131100	0	131100	2024-12-04
296	2023	131100	0	131100	2024-12-04
296	2022	131100	0	131100	2024-12-04
297	2025	40800	88400	129200	2024-12-04
297	2023	40800	88400	129200	2024-12-04
297	2022	40800	88400	129200	2024-12-04
298	2025	168100	118200	286300	2024-12-04
298	2023	168100	118200	286300	2024-12-04
298	2022	168100	118200	286300	2024-12-04
299	2025	108200	133400	241600	2024-12-04
299	2023	108200	133400	241600	2024-12-04
299	2022	108200	133400	241600	2024-12-04
300	2025	116500	93400	209900	2024-12-04
300	2023	116500	93400	209900	2024-12-04
300	2022	116500	93400	209900	2024-12-04
301	2025	197200	235000	432200	2024-12-04
301	2023	197200	235000	432200	2024-12-04
301	2022	197200	235000	432200	2024-12-04
303	2025	398500	179200	577700	2024-12-04
303	2023	392100	179200	571300	2024-12-04
303	2022	392100	179200	571300	2024-12-04
306	2025	252100	220000	472100	2024-12-04
306	2023	252100	220000	472100	2024-12-04
306	2022	252100	220000	472100	2024-12-04
307	2025	520400	362500	882900	2024-12-04
307	2023	498100	362500	860600	2024-12-04
307	2022	498100	362500	860600	2024-12-04
308	2025	280100	196600	476700	2024-12-04
308	2023	280100	196600	476700	2024-12-04
308	2022	280100	196600	476700	2024-12-04
309	2025	283000	571900	854900	2024-12-04
309	2023	283000	571900	854900	2024-12-04
309	2022	283000	571900	854900	2024-12-04
310	2025	511300	244800	756100	2024-12-04
310	2023	511300	244800	756100	2024-12-04
310	2022	511300	244800	756100	2024-12-04
311	2025	0	637800	637800	2024-12-04
311	2023	0	637800	637800	2024-12-04
311	2022	0	637800	637800	2024-12-04
313	2025	675600	661400	1337000	2024-12-04
313	2023	675600	661400	1337000	2024-12-04
313	2022	675600	661400	1337000	2024-12-04
315	2025	484200	174900	659100	2024-12-04
315	2023	484200	174900	659100	2024-12-04
315	2022	484200	174900	659100	2024-12-04
316	2025	229500	180700	410200	2024-12-04
316	2023	229500	180700	410200	2024-12-04
316	2022	229500	180700	410200	2024-12-04
317	2025	361800	152900	514700	2024-12-04
317	2023	361800	152900	514700	2024-12-04
317	2022	361800	152900	514700	2024-12-04
319	2025	381800	222900	604700	2024-12-04
319	2023	381800	222900	604700	2024-12-04
319	2022	381800	222900	604700	2024-12-04
320	2025	0	433100	433100	2024-12-04
320	2023	0	433100	433100	2024-12-04
320	2022	0	433100	433100	2024-12-04
321	2025	74900	140500	215400	2024-12-04
321	2023	74900	140500	215400	2024-12-04
321	2022	74900	140500	215400	2024-12-04
322	2025	0	273200	273200	2024-12-04
322	2023	0	273200	273200	2024-12-04
322	2022	0	273200	273200	2024-12-04
323	2025	156200	143800	300000	2024-12-04
323	2023	150100	143800	293900	2024-12-04
323	2022	150100	143800	293900	2024-12-04
324	2025	319900	137800	457700	2024-12-04
324	2023	319900	137800	457700	2024-12-04
324	2022	319900	137800	457700	2024-12-04
325	2025	750700	251100	1001800	2024-12-04
325	2023	750700	251100	1001800	2024-12-04
325	2022	750700	251100	1001800	2024-12-04
326	2025	327800	180100	507900	2024-12-04
326	2023	327800	180100	507900	2024-12-04
326	2022	327800	180100	507900	2024-12-04
327	2025	266500	153200	419700	2024-12-04
327	2023	266500	153200	419700	2024-12-04
327	2022	252500	153200	405700	2024-12-04
328	2025	178800	161000	339800	2024-12-04
328	2023	178800	161000	339800	2024-12-04
328	2022	178800	161000	339800	2024-12-04
329	2025	113100	93200	206300	2024-12-04
329	2023	113100	93200	206300	2024-12-04
329	2022	110800	93200	204000	2024-12-04
330	2025	216200	201200	417400	2024-12-04
330	2023	216200	201200	417400	2024-12-04
330	2022	216200	201200	417400	2024-12-04
331	2025	62500	131800	194300	2024-12-04
331	2023	62500	131800	194300	2024-12-04
331	2022	62500	131800	194300	2024-12-04
333	2025	0	15700	15700	2024-12-04
333	2023	0	15700	15700	2024-12-04
333	2022	0	15700	15700	2024-12-04
334	2025	459600	318400	778000	2024-12-04
334	2023	459600	318400	778000	2024-12-04
334	2022	459600	318400	778000	2024-12-04
335	2025	130700	157100	287800	2024-12-04
335	2023	130700	157100	287800	2024-12-04
335	2022	103500	157100	260600	2024-12-04
336	2025	210700	158300	369000	2024-12-04
336	2023	210700	158300	369000	2024-12-04
336	2022	210700	158300	369000	2024-12-04
337	2025	630400	197400	827800	2024-12-04
337	2023	630400	197400	827800	2024-12-04
337	2022	630400	197400	827800	2024-12-04
339	2025	153000	140300	293300	2024-12-04
339	2023	153000	140300	293300	2024-12-04
339	2022	153000	140300	293300	2024-12-04
340	2025	382600	176700	559300	2024-12-04
340	2023	382600	176700	559300	2024-12-04
340	2022	382600	176700	559300	2024-12-04
341	2025	228100	123800	351900	2024-12-04
341	2023	198000	123800	321800	2024-12-04
341	2022	191600	123800	315400	2024-12-04
343	2025	238400	197200	435600	2024-12-04
343	2023	238400	197200	435600	2024-12-04
343	2022	238400	197200	435600	2024-12-04
344	2025	265500	504500	770000	2024-12-04
344	2023	265500	504500	770000	2024-12-04
344	2022	265500	504500	770000	2024-12-04
345	2025	298800	153300	452100	2024-12-04
345	2023	288300	153300	441600	2024-12-04
345	2022	288300	153300	441600	2024-12-04
346	2025	256900	159200	416100	2024-12-04
346	2023	256900	159200	416100	2024-12-04
346	2022	256900	159200	416100	2024-12-04
347	2025	8800	293500	302300	2024-12-04
347	2023	8800	293500	302300	2024-12-04
347	2022	8800	293500	302300	2024-12-04
348	2025	295100	149400	444500	2024-12-04
348	2023	287400	149400	436800	2024-12-04
348	2022	287400	149400	436800	2024-12-04
349	2025	0	102600	102600	2024-12-04
349	2023	0	102600	102600	2024-12-04
349	2022	0	102600	102600	2024-12-04
350	2025	0	52200	52200	2024-12-04
350	2023	0	52200	52200	2024-12-04
350	2022	0	52200	52200	2024-12-04
351	2025	275300	148900	424200	2024-12-04
351	2023	284700	148900	433600	2024-12-04
351	2022	284700	148900	433600	2024-12-04
355	2025	0	330300	330300	2024-12-04
355	2023	0	330300	330300	2024-12-04
355	2022	0	330300	330300	2024-12-04
357	2025	0	159000	159000	2024-12-04
357	2023	0	159000	159000	2024-12-04
357	2022	0	159000	159000	2024-12-04
358	2025	0	9300	9300	2024-12-04
358	2023	0	9300	9300	2024-12-04
358	2022	0	9300	9300	2024-12-04
359	2025	92400	135100	227500	2024-12-04
359	2023	92400	135100	227500	2024-12-04
359	2022	92400	135100	227500	2024-12-04
360	2025	126800	101800	228600	2024-12-04
360	2023	128100	101800	229900	2024-12-04
360	2022	128100	101800	229900	2024-12-04
361	2025	344600	367400	712000	2024-12-04
361	2023	344600	367400	712000	2024-12-04
361	2022	344600	367400	712000	2024-12-04
363	2025	392400	128100	520500	2024-12-04
363	2023	392400	128100	520500	2024-12-04
363	2022	392400	128100	520500	2024-12-04
364	2025	114400	98300	212700	2024-12-04
364	2023	114400	98300	212700	2024-12-04
364	2022	114400	98300	212700	2024-12-04
365	2025	544900	502900	1047800	2024-12-04
365	2023	544900	502900	1047800	2024-12-04
365	2022	544900	502900	1047800	2024-12-04
368	2025	242900	111700	354600	2024-12-04
368	2023	242900	111700	354600	2024-12-04
368	2022	242900	111700	354600	2024-12-04
369	2025	477100	445900	923000	2024-12-04
369	2023	477100	445900	923000	2024-12-04
369	2022	477100	445900	923000	2024-12-04
370	2025	0	312000	312000	2024-12-04
370	2023	0	312000	312000	2024-12-04
370	2022	0	312000	312000	2024-12-04
371	2025	357300	166800	524100	2024-12-04
371	2023	342300	166800	509100	2024-12-04
371	2022	342300	166800	509100	2024-12-04
372	2025	219900	208700	428600	2024-12-04
372	2023	219900	208700	428600	2024-12-04
372	2022	219900	208700	428600	2024-12-04
375	2025	0	244100	244100	2024-12-04
375	2023	0	244100	244100	2024-12-04
375	2022	0	244100	244100	2024-12-04
376	2025	387900	326200	714100	2024-12-04
376	2023	387900	326200	714100	2024-12-04
376	2022	387900	326200	714100	2024-12-04
377	2025	34900	462600	497500	2024-12-04
377	2023	34900	462600	497500	2024-12-04
377	2022	34900	462600	497500	2024-12-04
378	2025	345600	142700	488300	2024-12-04
378	2023	345600	142700	488300	2024-12-04
378	2022	345600	142700	488300	2024-12-04
379	2025	65300	118000	183300	2024-12-04
379	2023	65300	118000	183300	2024-12-04
379	2022	65300	118000	183300	2024-12-04
380	2025	184800	157400	342200	2024-12-04
380	2023	184800	157400	342200	2024-12-04
380	2022	184800	157400	342200	2024-12-04
381	2025	73000	107800	180800	2024-12-04
381	2023	73000	107800	180800	2024-12-04
381	2022	73000	107800	180800	2024-12-04
382	2025	150900	158900	309800	2024-12-04
382	2023	150900	158900	309800	2024-12-04
382	2022	150900	158900	309800	2024-12-04
383	2025	0	376700	376700	2024-12-04
383	2023	0	376700	376700	2024-12-04
383	2022	0	376700	376700	2024-12-04
384	2025	115100	446700	561800	2024-12-04
384	2023	115100	446700	561800	2024-12-04
384	2022	115100	446700	561800	2024-12-04
385	2025	285900	172600	458500	2024-12-04
385	2023	285900	172600	458500	2024-12-04
385	2022	285900	172600	458500	2024-12-04
387	2025	0	32300	32300	2024-12-04
387	2023	0	32300	32300	2024-12-04
387	2022	0	32300	32300	2024-12-04
388	2025	0	73500	73500	2024-12-04
388	2023	0	73500	73500	2024-12-04
388	2022	0	73500	73500	2024-12-04
389	2025	267800	112600	380400	2024-12-04
389	2023	267800	112600	380400	2024-12-04
389	2022	267800	112600	380400	2024-12-04
390	2025	0	454600	454600	2024-12-04
390	2023	0	454600	454600	2024-12-04
390	2022	0	454600	454600	2024-12-04
391	2025	113000	321300	434300	2024-12-04
391	2023	113000	321300	434300	2024-12-04
391	2022	147800	321300	469100	2024-12-04
392	2025	490000	360400	850400	2024-12-04
392	2023	490000	360400	850400	2024-12-04
392	2022	490000	360400	850400	2024-12-04
394	2025	371100	355400	726500	2024-12-04
394	2023	371100	355400	726500	2024-12-04
394	2022	371100	355400	726500	2024-12-04
395	2025	332100	335700	667800	2024-12-04
395	2023	332100	335700	667800	2024-12-04
395	2022	332100	335700	667800	2024-12-04
398	2025	777200	1621300	2398500	2024-12-04
398	2023	777200	1621300	2398500	2024-12-04
398	2022	777200	1621300	2398500	2024-12-04
399	2025	354400	297700	652100	2024-12-04
399	2023	354400	297700	652100	2024-12-04
399	2022	354400	297700	652100	2024-12-04
400	2025	339100	163100	502200	2024-12-04
400	2023	339100	163100	502200	2024-12-04
400	2022	339100	163100	502200	2024-12-04
401	2025	0	1188900	1188900	2024-12-04
401	2023	0	1188900	1188900	2024-12-04
401	2022	0	1188900	1188900	2024-12-04
402	2025	1367100	1205000	2572100	2024-12-04
402	2023	1367100	1205000	2572100	2024-12-04
402	2022	1367100	1205000	2572100	2024-12-04
405	2025	146300	143300	289600	2024-12-04
405	2023	146300	143300	289600	2024-12-04
405	2022	146300	143300	289600	2024-12-04
407	2025	0	420900	420900	2024-12-04
407	2023	0	420900	420900	2024-12-04
407	2022	0	420900	420900	2024-12-04
408	2025	182100	148500	330600	2024-12-04
408	2023	171500	148500	320000	2024-12-04
408	2022	171500	148500	320000	2024-12-04
415	2025	242800	371700	614500	2024-12-04
415	2023	242800	371700	614500	2024-12-04
415	2022	242800	371700	614500	2024-12-04
417	2025	34800	608700	643500	2024-12-04
417	2023	34800	608700	643500	2024-12-04
417	2022	34800	608700	643500	2024-12-04
418	2025	432100	205700	637800	2024-12-04
418	2023	432100	205700	637800	2024-12-04
418	2022	432100	205700	637800	2024-12-04
427	2025	317000	162800	479800	2024-12-04
427	2023	317000	162800	479800	2024-12-04
427	2022	317000	162800	479800	2024-12-04
429	2025	555500	262800	818300	2024-12-04
429	2023	555500	262800	818300	2024-12-04
429	2022	553700	262800	816500	2024-12-04
432	2025	0	23700	23700	2024-12-04
432	2023	0	23700	23700	2024-12-04
432	2022	0	23700	23700	2024-12-04
433	2025	38200	104500	142700	2024-12-04
433	2023	37700	104500	142200	2024-12-04
433	2022	37700	104500	142200	2024-12-04
434	2025	58600	184300	242900	2024-12-04
434	2023	58600	184300	242900	2024-12-04
434	2022	58600	184300	242900	2024-12-04
435	2025	104100	221200	325300	2024-12-04
435	2023	104100	221200	325300	2024-12-04
435	2022	104100	221200	325300	2024-12-04
436	2025	57700	187000	244700	2024-12-04
436	2023	57700	187000	244700	2024-12-04
436	2022	57700	187000	244700	2024-12-04
437	2025	684600	378100	1062700	2024-12-04
437	2023	682800	378100	1060900	2024-12-04
437	2022	682800	378100	1060900	2024-12-04
438	2025	310300	261700	572000	2024-12-04
438	2023	308800	261700	570500	2024-12-04
438	2022	308800	261700	570500	2024-12-04
439	2025	0	6400	6400	2024-12-04
439	2023	0	6400	6400	2024-12-04
439	2022	0	6400	6400	2024-12-04
440	2025	53000	228900	281900	2024-12-04
440	2023	53000	228900	281900	2024-12-04
440	2022	53000	228900	281900	2024-12-04
441	2025	406800	455200	862000	2024-12-04
441	2023	404100	455200	859300	2024-12-04
441	2022	404100	455200	859300	2024-12-04
442	2025	232400	196700	429100	2024-12-04
442	2023	229500	196700	426200	2024-12-04
442	2022	229500	196700	426200	2024-12-04
446	2025	426500	344100	770600	2024-12-04
446	2023	421000	344100	765100	2024-12-04
446	2022	417800	344100	761900	2024-12-04
447	2025	191900	228500	420400	2024-12-04
447	2023	191200	228500	419700	2024-12-04
447	2022	191200	228500	419700	2024-12-04
448	2025	403800	307500	711300	2024-12-04
448	2023	396900	307500	704400	2024-12-04
448	2022	396900	307500	704400	2024-12-04
450	2025	561400	1063100	1624500	2024-12-04
450	2023	561400	1063100	1624500	2024-12-04
450	2022	561400	1063100	1624500	2024-12-04
454	2025	563300	840000	1403300	2024-12-04
454	2023	586600	840000	1426600	2024-12-04
454	2022	586600	840000	1426600	2024-12-04
457	2025	824300	409400	1233700	2024-12-04
457	2023	818800	409400	1228200	2024-12-04
457	2022	818800	409400	1228200	2024-12-04
458	2025	234900	272600	507500	2024-12-04
458	2023	234800	272600	507400	2024-12-04
458	2022	234800	272600	507400	2024-12-04
459	2025	293400	192000	485400	2024-12-04
459	2023	293400	192000	485400	2024-12-04
459	2022	293400	192000	485400	2024-12-04
460	2025	512600	279000	791600	2024-12-04
460	2023	479100	279000	758100	2024-12-04
460	2022	479100	279000	758100	2024-12-04
461	2025	714600	311800	1026400	2024-12-04
461	2023	714600	311800	1026400	2024-12-04
461	2022	714600	311800	1026400	2024-12-04
462	2025	545200	246100	791300	2024-12-04
462	2023	544600	246100	790700	2024-12-04
462	2022	544600	246100	790700	2024-12-04
463	2025	0	372200	372200	2024-12-04
463	2023	0	372200	372200	2024-12-04
463	2022	0	372200	372200	2024-12-04
465	2025	0	250900	250900	2024-12-04
465	2023	0	250900	250900	2024-12-04
465	2022	0	250900	250900	2024-12-04
469	2025	739700	271500	1011200	2024-12-04
469	2023	725500	271500	997000	2024-12-04
469	2022	725500	271500	997000	2024-12-04
472	2025	715000	241600	956600	2024-12-04
472	2023	715000	241600	956600	2024-12-04
472	2022	715000	241600	956600	2024-12-04
473	2025	535100	210400	745500	2024-12-04
473	2023	535100	210400	745500	2024-12-04
473	2022	535100	210400	745500	2024-12-04
474	2025	358800	200000	558800	2024-12-04
474	2023	358800	200000	558800	2024-12-04
474	2022	358800	200000	558800	2024-12-04
475	2025	472000	379600	851600	2024-12-04
475	2023	472000	379600	851600	2024-12-04
475	2022	472000	379600	851600	2024-12-04
476	2025	1286400	445300	1731700	2024-12-04
476	2023	1080000	376800	1456800	2024-12-04
476	2022	285600	334600	620200	2024-12-04
478	2025	270800	522200	793000	2024-12-04
478	2023	270800	522200	793000	2024-12-04
478	2022	270800	522200	793000	2024-12-04
479	2025	790200	609400	1399600	2024-12-04
479	2023	750500	609400	1359900	2024-12-04
479	2022	750500	609400	1359900	2024-12-04
480	2025	233500	232000	465500	2024-12-04
480	2023	233500	232000	465500	2024-12-04
480	2022	233500	232000	465500	2024-12-04
482	2025	309900	229800	539700	2024-12-04
482	2023	308300	229800	538100	2024-12-04
482	2022	308300	229800	538100	2024-12-04
483	2025	0	700	700	2024-12-04
483	2023	0	700	700	2024-12-04
483	2022	0	700	700	2024-12-04
484	2025	419600	182200	601800	2024-12-04
484	2023	431700	182200	613900	2024-12-04
484	2022	431700	182200	613900	2024-12-04
486	2025	367300	218100	585400	2024-12-04
486	2023	367800	218100	585900	2024-12-04
486	2022	367800	218100	585900	2024-12-04
487	2025	170400	180000	350400	2024-12-04
487	2023	170800	180000	350800	2024-12-04
487	2022	165100	180000	345100	2024-12-04
488	2025	314900	248800	563700	2024-12-04
488	2023	314900	248800	563700	2024-12-04
488	2022	309400	248800	558200	2024-12-04
489	2025	231000	253700	484700	2024-12-04
489	2023	225500	253700	479200	2024-12-04
489	2022	225500	253700	479200	2024-12-04
490	2025	290700	211700	502400	2024-12-04
490	2023	289700	211700	501400	2024-12-04
490	2022	289700	211700	501400	2024-12-04
491	2025	323400	608300	931700	2024-12-04
491	2023	311300	608300	919600	2024-12-04
491	2022	311300	608300	919600	2024-12-04
492	2025	146800	198600	345400	2024-12-04
492	2023	146800	198600	345400	2024-12-04
492	2022	146800	198600	345400	2024-12-04
493	2025	457000	693200	1150200	2024-12-04
493	2023	442700	693200	1135900	2024-12-04
493	2022	442700	693200	1135900	2024-12-04
494	2025	978200	559900	1538100	2024-12-04
494	2023	978200	559900	1538100	2024-12-04
494	2022	978200	559900	1538100	2024-12-04
495	2025	308000	314900	622900	2024-12-04
495	2023	308000	314900	622900	2024-12-04
495	2022	308000	333700	641700	2024-12-04
501	2025	60200	199300	259500	2024-12-04
501	2023	63500	199300	262800	2024-12-04
501	2022	63500	199300	262800	2024-12-04
505	2025	706600	688900	1395500	2024-12-04
505	2023	704800	688900	1393700	2024-12-04
505	2022	704800	688900	1393700	2024-12-04
506	2025	581800	356800	938600	2024-12-04
506	2023	580400	356800	937200	2024-12-04
506	2022	580400	356800	937200	2024-12-04
507	2025	($43,300)	653800	610500	2024-12-04
507	2023	($43,300)	653800	610500	2024-12-04
507	2022	($43,300)	653800	610500	2024-12-04
509	2025	339600	260800	600400	2024-12-04
509	2023	339400	260800	600200	2024-12-04
509	2022	339400	260800	600200	2024-12-04
510	2025	406200	343100	749300	2024-12-04
510	2023	406200	343100	749300	2024-12-04
510	2022	406200	343100	749300	2024-12-04
511	2025	196500	212500	409000	2024-12-04
511	2023	196100	212500	408600	2024-12-04
511	2022	196100	212500	408600	2024-12-04
512	2025	0	265100	265100	2024-12-04
512	2023	0	265100	265100	2024-12-04
512	2022	0	265100	265100	2024-12-04
513	2025	277700	214600	492300	2024-12-04
513	2023	275900	214600	490500	2024-12-04
513	2022	275900	214600	490500	2024-12-04
514	2025	351500	357000	708500	2024-12-04
514	2023	365300	357000	722300	2024-12-04
514	2022	365300	357000	722300	2024-12-04
515	2025	173500	187700	361200	2024-12-04
515	2023	173600	187700	361300	2024-12-04
515	2022	173600	187700	361300	2024-12-04
517	2025	387100	281800	668900	2024-12-04
517	2023	387600	281800	669400	2024-12-04
517	2022	331700	281800	613500	2024-12-04
518	2025	290800	217800	508600	2024-12-04
518	2023	290800	217800	508600	2024-12-04
518	2022	290800	217800	508600	2024-12-04
519	2025	142100	156900	299000	2024-12-04
519	2023	142100	156900	299000	2024-12-04
519	2022	142100	156900	299000	2024-12-04
520	2025	512800	204900	717700	2024-12-04
520	2023	512800	204900	717700	2024-12-04
520	2022	482800	204900	687700	2024-12-04
522	2025	167900	162100	330000	2024-12-04
522	2023	133200	162100	295300	2024-12-04
522	2022	133200	162100	295300	2024-12-04
526	2025	134800	217300	352100	2024-12-04
526	2023	133300	217300	350600	2024-12-04
526	2022	133300	217300	350600	2024-12-04
527	2025	312700	207400	520100	2024-12-04
527	2023	312700	207400	520100	2024-12-04
527	2022	312700	207400	520100	2024-12-04
529	2025	161200	181700	342900	2024-12-04
529	2023	159300	181700	341000	2024-12-04
529	2022	159300	181700	341000	2024-12-04
530	2025	484000	301900	785900	2024-12-04
530	2023	458500	301900	760400	2024-12-04
530	2022	458500	301900	760400	2024-12-04
532	2025	58700	182400	241100	2024-12-04
532	2023	58700	182400	241100	2024-12-04
532	2022	58700	182400	241100	2024-12-04
533	2025	561200	270000	831200	2024-12-04
533	2023	561200	270000	831200	2024-12-04
533	2022	561200	270000	831200	2024-12-04
537	2025	544100	312100	856200	2024-12-04
537	2023	544100	312100	856200	2024-12-04
537	2022	544100	312100	856200	2024-12-04
538	2025	380100	259400	639500	2024-12-04
538	2023	379300	259400	638700	2024-12-04
538	2022	379300	259400	638700	2024-12-04
540	2025	305400	300900	606300	2024-12-04
540	2023	296800	300900	597700	2024-12-04
540	2022	296800	300900	597700	2024-12-04
542	2025	185000	147700	332700	2024-12-04
542	2023	184300	147700	332000	2024-12-04
542	2022	184300	147700	332000	2024-12-04
543	2025	0	54100	54100	2024-12-04
543	2023	0	54100	54100	2024-12-04
543	2022	0	54100	54100	2024-12-04
544	2025	62300	171200	233500	2024-12-04
544	2023	62700	171200	233900	2024-12-04
544	2022	62700	171200	233900	2024-12-04
545	2025	119600	168200	287800	2024-12-04
545	2023	119600	168200	287800	2024-12-04
545	2022	109800	168200	278000	2024-12-04
546	2025	115400	217500	332900	2024-12-04
546	2023	115400	217500	332900	2024-12-04
546	2022	115400	217500	332900	2024-12-04
547	2025	173300	185500	358800	2024-12-04
547	2023	175800	185500	361300	2024-12-04
547	2022	175800	185500	361300	2024-12-04
552	2025	4600	276400	281000	2024-12-04
552	2023	3600	276400	280000	2024-12-04
552	2022	3600	276400	280000	2024-12-04
557	2025	125900	203800	329700	2024-12-04
557	2023	114900	203800	318700	2024-12-04
557	2022	114900	203800	318700	2024-12-04
558	2025	78500	161200	239700	2024-12-04
558	2023	45800	161200	207000	2024-12-04
558	2022	45800	161200	207000	2024-12-04
559	2025	300300	270400	570700	2024-12-04
559	2023	300300	270400	570700	2024-12-04
559	2022	300300	270400	570700	2024-12-04
560	2025	123500	162900	286400	2024-12-04
560	2023	123400	162900	286300	2024-12-04
560	2022	123400	162900	286300	2024-12-04
561	2025	0	12200	12200	2024-12-04
561	2023	0	12200	12200	2024-12-04
561	2022	0	12200	12200	2024-12-04
563	2025	357900	236700	594600	2024-12-04
563	2023	344200	236700	580900	2024-12-04
563	2022	344200	236700	580900	2024-12-04
564	2025	550000	657500	1207500	2024-12-04
564	2023	544200	657500	1201700	2024-12-04
564	2022	497800	657500	1155300	2024-12-04
565	2025	249100	332200	581300	2024-12-04
565	2023	247800	332200	580000	2024-12-04
565	2022	247800	332200	580000	2024-12-04
569	2025	728700	508400	1237100	2024-12-04
569	2023	728700	508400	1237100	2024-12-04
569	2022	730600	508400	1239000	2024-12-04
570	2025	184400	577900	762300	2024-12-04
570	2023	184400	577900	762300	2024-12-04
570	2022	184400	577900	762300	2024-12-04
571	2025	169100	180000	349100	2024-12-04
571	2023	169100	180000	349100	2024-12-04
571	2022	169100	180000	349100	2024-12-04
572	2025	155200	183900	339100	2024-12-04
572	2023	155200	183900	339100	2024-12-04
572	2022	155200	183900	339100	2024-12-04
575	2025	668000	982300	1650300	2024-12-04
575	2023	796700	1024700	1821400	2024-12-04
575	2022	862000	1131400	1993400	2024-12-04
576	2025	2084100	1274800	3358900	2024-12-04
576	2023	2084100	1274800	3358900	2024-12-04
576	2022	2084100	1274800	3358900	2024-12-04
578	2025	881300	822200	1703500	2024-12-04
578	2023	881300	822200	1703500	2024-12-04
578	2022	881300	822200	1703500	2024-12-04
579	2025	469900	267200	737100	2024-12-04
579	2023	443300	267200	710500	2024-12-04
579	2022	443300	267200	710500	2024-12-04
580	2025	0	19300	19300	2024-12-04
580	2023	0	19300	19300	2024-12-04
580	2022	0	19300	19300	2024-12-04
581	2025	186900	567800	754700	2024-12-04
581	2023	174700	567800	742500	2024-12-04
581	2022	174700	567800	742500	2024-12-04
582	2025	1808200	671400	2479600	2024-12-04
582	2023	1765300	671400	2436700	2024-12-04
582	2022	1700400	671400	2371800	2024-12-04
584	2025	574900	531100	1106000	2024-12-04
584	2023	561900	531100	1093000	2024-12-04
584	2022	561900	531100	1093000	2024-12-04
591	2025	0	346300	346300	2024-12-04
591	2023	0	346300	346300	2024-12-04
591	2022	0	346300	346300	2024-12-04
592	2025	0	190200	190200	2024-12-04
592	2023	0	190200	190200	2024-12-04
592	2022	0	190200	190200	2024-12-04
593	2025	234800	372000	606800	2024-12-04
593	2023	234800	372000	606800	2024-12-04
593	2022	234800	372000	606800	2024-12-04
594	2025	541800	257000	798800	2024-12-04
594	2023	541800	257000	798800	2024-12-04
594	2022	541800	257000	798800	2024-12-04
597	2025	673200	399500	1072700	2024-12-04
597	2023	689900	399500	1089400	2024-12-04
597	2022	689900	399500	1089400	2024-12-04
598	2025	0	35000	35000	2024-12-04
598	2023	0	35000	35000	2024-12-04
598	2022	0	35000	35000	2024-12-04
600	2025	133000	128800	261800	2024-12-04
600	2023	133000	128800	261800	2024-12-04
600	2022	133000	128800	261800	2024-12-04
603	2025	0	238800	238800	2024-12-04
603	2023	0	238800	238800	2024-12-04
603	2022	0	250000	250000	2024-12-04
605	2025	189700	133300	323000	2024-12-04
605	2023	189700	133300	323000	2024-12-04
605	2022	189700	133300	323000	2024-12-04
607	2025	242700	191800	434500	2024-12-04
607	2023	243800	191800	435600	2024-12-04
607	2022	243800	191800	435600	2024-12-04
611	2025	672000	460500	1132500	2024-12-04
611	2023	672000	460500	1132500	2024-12-04
611	2022	672000	460500	1132500	2024-12-04
616	2025	403700	153200	556900	2024-12-04
616	2023	403700	153200	556900	2024-12-04
616	2022	403700	153200	556900	2024-12-04
617	2025	175400	155200	330600	2024-12-04
617	2023	175400	155200	330600	2024-12-04
617	2022	175400	155200	330600	2024-12-04
618	2025	87000	505700	592700	2024-12-04
618	2023	111400	505700	617100	2024-12-04
618	2022	83100	280100	363200	2024-12-04
620	2025	0	70300	70300	2024-12-04
620	2023	0	70300	70300	2024-12-04
620	2022	0	70300	70300	2024-12-04
621	2025	147500	203200	350700	2024-12-04
621	2023	147500	203200	350700	2024-12-04
621	2022	147500	203200	350700	2024-12-04
622	2025	97700	138300	236000	2024-12-04
622	2023	97700	138300	236000	2024-12-04
622	2022	97700	138300	236000	2024-12-04
623	2025	89500	210200	299700	2024-12-04
623	2023	89500	210200	299700	2024-12-04
623	2022	89500	210200	299700	2024-12-04
624	2025	330700	291700	622400	2024-12-04
624	2023	301300	291700	593000	2024-12-04
624	2022	301300	291700	593000	2024-12-04
625	2025	556600	220500	777100	2024-12-04
625	2023	553700	220500	774200	2024-12-04
625	2022	553700	220500	774200	2024-12-04
626	2025	434300	297700	732000	2024-12-04
626	2023	428100	297700	725800	2024-12-04
626	2022	428100	297700	725800	2024-12-04
627	2025	0	32700	32700	2024-12-04
627	2023	0	32700	32700	2024-12-04
627	2022	0	32700	32700	2024-12-04
633	2025	0	585800	585800	2024-12-04
633	2023	0	585800	585800	2024-12-04
633	2022	0	585800	585800	2024-12-04
634	2025	0	287800	287800	2024-12-04
634	2023	0	287800	287800	2024-12-04
634	2022	0	287800	287800	2024-12-04
635	2025	0	4200	4200	2024-12-04
635	2023	0	4200	4200	2024-12-04
635	2022	0	4200	4200	2024-12-04
636	2025	0	4200	4200	2024-12-04
636	2023	0	4200	4200	2024-12-04
636	2022	0	4200	4200	2024-12-04
637	2025	229100	81000	310100	2024-12-04
637	2023	228800	81000	309800	2024-12-04
637	2022	228800	81000	309800	2024-12-04
638	2025	279300	245000	524300	2024-12-04
638	2023	279300	245000	524300	2024-12-04
638	2022	279300	245000	524300	2024-12-04
639	2025	1622100	809400	2431500	2024-12-04
639	2023	1610400	809400	2419800	2024-12-04
639	2022	1610400	809400	2419800	2024-12-04
643	2025	0	40400	40400	2024-12-04
643	2023	0	40400	40400	2024-12-04
643	2022	0	40400	40400	2024-12-04
645	2025	243400	133300	376700	2024-12-04
645	2023	243400	133300	376700	2024-12-04
645	2022	243400	133300	376700	2024-12-04
647	2025	30000	302800	332800	2024-12-04
647	2023	30000	302800	332800	2024-12-04
647	2022	30000	302800	332800	2024-12-04
648	2025	838300	492700	1331000	2024-12-04
648	2023	838300	492700	1331000	2024-12-04
648	2022	838300	492700	1331000	2024-12-04
649	2025	318500	254900	573400	2024-12-04
649	2023	318500	254900	573400	2024-12-04
649	2022	318500	254900	573400	2024-12-04
650	2025	183500	235400	418900	2024-12-04
650	2023	183500	235400	418900	2024-12-04
650	2022	183500	235400	418900	2024-12-04
651	2025	183300	278100	461400	2024-12-04
651	2023	183300	278100	461400	2024-12-04
651	2022	183300	278100	461400	2024-12-04
652	2025	23900	208300	232200	2024-12-04
652	2023	23900	208300	232200	2024-12-04
652	2022	23900	208300	232200	2024-12-04
653	2025	68500	262400	330900	2024-12-04
653	2023	68500	262400	330900	2024-12-04
653	2022	68500	262400	330900	2024-12-04
654	2025	107000	377200	484200	2024-12-04
654	2023	107000	377200	484200	2024-12-04
654	2022	107000	377200	484200	2024-12-04
655	2025	480400	433200	913600	2024-12-04
655	2023	480400	433200	913600	2024-12-04
655	2022	480400	433200	913600	2024-12-04
659	2025	0	13900	13900	2024-12-04
659	2023	0	13900	13900	2024-12-04
659	2022	0	13900	13900	2024-12-04
664	2025	55700	128400	184100	2024-12-04
664	2023	55700	128400	184100	2024-12-04
664	2022	55700	128400	184100	2024-12-04
667	2025	18200	100700	118900	2024-12-04
667	2023	18200	100700	118900	2024-12-04
667	2022	18200	100700	118900	2024-12-04
673	2025	44600	225800	270400	2024-12-04
673	2023	44600	225800	270400	2024-12-04
673	2022	44600	225800	270400	2024-12-04
675	2025	0	52400	52400	2024-12-04
675	2023	0	52400	52400	2024-12-04
675	2022	0	52400	52400	2024-12-04
686	2025	0	11600	11600	2024-12-04
686	2023	0	11600	11600	2024-12-04
686	2022	0	11600	11600	2024-12-04
688	2025	2600	47600	50200	2024-12-04
688	2023	2600	47600	50200	2024-12-04
688	2022	2600	47600	50200	2024-12-04
689	2025	281400	207100	488500	2024-12-04
689	2023	281400	207100	488500	2024-12-04
689	2022	309800	207100	516900	2024-12-04
690	2025	726400	200500	926900	2024-12-04
690	2023	726400	200500	926900	2024-12-04
690	2022	726400	200500	926900	2024-12-04
691	2025	400600	265800	666400	2024-12-04
691	2023	400600	265800	666400	2024-12-04
691	2022	400600	265800	666400	2024-12-04
692	2025	578500	227500	806000	2024-12-04
692	2023	578500	227500	806000	2024-12-04
692	2022	578500	227500	806000	2024-12-04
694	2025	192900	152200	345100	2024-12-04
694	2023	192900	152200	345100	2024-12-04
694	2022	192900	152200	345100	2024-12-04
695	2025	179300	193800	373100	2024-12-04
695	2023	179300	193800	373100	2024-12-04
695	2022	179300	193800	373100	2024-12-04
696	2025	324100	191200	515300	2024-12-04
696	2023	324100	191200	515300	2024-12-04
696	2022	324100	191200	515300	2024-12-04
697	2025	227900	214600	442500	2024-12-04
697	2023	227900	214600	442500	2024-12-04
697	2022	227900	214600	442500	2024-12-04
698	2025	501500	179200	680700	2024-12-04
698	2023	486500	179200	665700	2024-12-04
698	2022	486500	179200	665700	2024-12-04
700	2025	48900	77600	126500	2024-12-04
700	2023	48900	77600	126500	2024-12-04
700	2022	48900	77600	126500	2024-12-04
701	2025	211800	176600	388400	2024-12-04
701	2023	211800	176600	388400	2024-12-04
701	2022	208100	176600	384700	2024-12-04
702	2025	216000	149500	365500	2024-12-04
702	2023	216000	149500	365500	2024-12-04
702	2022	216000	149500	365500	2024-12-04
703	2025	66400	191800	258200	2024-12-04
703	2023	66400	191800	258200	2024-12-04
703	2022	66400	191800	258200	2024-12-04
704	2025	146600	149000	295600	2024-12-04
704	2023	146600	149000	295600	2024-12-04
704	2022	146600	149000	295600	2024-12-04
705	2025	2000	8800	10800	2024-12-04
705	2023	2000	8800	10800	2024-12-04
705	2022	2000	8800	10800	2024-12-04
706	2025	213600	196500	410100	2024-12-04
706	2023	213600	196500	410100	2024-12-04
706	2022	213600	196500	410100	2024-12-04
707	2025	210800	170800	381600	2024-12-04
707	2023	210800	170800	381600	2024-12-04
707	2022	210800	170800	381600	2024-12-04
708	2025	144900	157600	302500	2024-12-04
708	2023	144900	157600	302500	2024-12-04
708	2022	144900	157600	302500	2024-12-04
711	2025	162700	125900	288600	2024-12-04
711	2023	162700	125900	288600	2024-12-04
711	2022	162700	125900	288600	2024-12-04
717	2025	0	447800	447800	2024-12-04
717	2023	0	447800	447800	2024-12-04
717	2022	0	447800	447800	2024-12-04
719	2025	347200	280700	627900	2024-12-04
719	2023	347200	280700	627900	2024-12-04
719	2022	347200	280700	627900	2024-12-04
720	2025	228000	175200	403200	2024-12-04
720	2023	213000	175200	388200	2024-12-04
720	2022	213000	175200	388200	2024-12-04
723	2025	263100	145600	408700	2024-12-04
723	2023	262400	145600	408000	2024-12-04
723	2022	249500	145600	395100	2024-12-04
724	2025	716900	479000	1195900	2024-12-04
724	2023	0	445500	445500	2024-12-04
724	2022	0	466700	466700	2024-12-04
725	2025	446600	301400	748000	2024-12-04
725	2023	446600	301400	748000	2024-12-04
725	2022	446600	301400	748000	2024-12-04
734	2025	559500	267700	827200	2024-12-04
734	2023	559500	267700	827200	2024-12-04
734	2022	559500	267700	827200	2024-12-04
735	2025	0	258100	258100	2024-12-04
735	2023	0	258100	258100	2024-12-04
735	2022	0	258100	258100	2024-12-04
736	2025	1054700	284700	1339400	2024-12-04
736	2023	1054700	284700	1339400	2024-12-04
736	2022	1054700	284700	1339400	2024-12-04
737	2025	854300	389700	1244000	2024-12-04
737	2023	854300	389700	1244000	2024-12-04
737	2022	854300	389700	1244000	2024-12-04
738	2025	375400	271100	646500	2024-12-04
738	2023	375400	271100	646500	2024-12-04
738	2022	375400	271100	646500	2024-12-04
739	2025	420500	329500	750000	2024-12-04
739	2023	420500	329500	750000	2024-12-04
739	2022	471700	329500	801200	2024-12-04
740	2025	668000	334400	1002400	2024-12-04
740	2023	668000	334400	1002400	2024-12-04
740	2022	668000	334400	1002400	2024-12-04
741	2025	136000	320100	456100	2024-12-04
741	2023	136000	320100	456100	2024-12-04
741	2022	136000	320100	456100	2024-12-04
742	2025	602000	344800	946800	2024-12-04
742	2023	602000	344800	946800	2024-12-04
742	2022	602000	344800	946800	2024-12-04
743	2025	254600	268600	523200	2024-12-04
743	2023	254600	268600	523200	2024-12-04
743	2022	258000	268600	526600	2024-12-04
744	2025	428200	352900	781100	2024-12-04
744	2023	330000	352900	682900	2024-12-04
744	2022	525500	352900	878400	2024-12-04
745	2025	0	273700	273700	2024-12-04
745	2023	0	273700	273700	2024-12-04
745	2022	0	273700	273700	2024-12-04
746	2025	657300	297600	954900	2024-12-04
746	2023	657300	297600	954900	2024-12-04
746	2022	657300	297600	954900	2024-12-04
747	2025	456000	330800	786800	2024-12-04
747	2023	456000	330800	786800	2024-12-04
747	2022	454400	330800	785200	2024-12-04
748	2025	424400	417700	842100	2024-12-04
748	2023	424400	417700	842100	2024-12-04
748	2022	424400	417700	842100	2024-12-04
749	2025	1062400	588700	1651100	2024-12-04
749	2023	1062400	588700	1651100	2024-12-04
749	2022	1062400	588700	1651100	2024-12-04
750	2025	1014500	272500	1287000	2024-12-04
750	2023	1008100	272500	1280600	2024-12-04
750	2022	1008100	272500	1280600	2024-12-04
751	2025	311800	228100	539900	2024-12-04
751	2023	311800	228100	539900	2024-12-04
751	2022	311800	228100	539900	2024-12-04
752	2025	335600	256700	592300	2024-12-04
752	2023	335600	256700	592300	2024-12-04
752	2022	335600	256700	592300	2024-12-04
753	2025	475900	560300	1036200	2024-12-04
753	2023	475900	560300	1036200	2024-12-04
753	2022	475900	560300	1036200	2024-12-04
754	2025	506500	426100	932600	2024-12-04
754	2023	506500	426100	932600	2024-12-04
754	2022	506500	426100	932600	2024-12-04
755	2025	173500	173400	346900	2024-12-04
755	2023	173500	173400	346900	2024-12-04
755	2022	173500	173400	346900	2024-12-04
756	2025	363200	548200	911400	2024-12-04
756	2023	363200	548200	911400	2024-12-04
756	2022	363200	548200	911400	2024-12-04
757	2025	0	251800	251800	2024-12-04
757	2023	0	251800	251800	2024-12-04
757	2022	0	251800	251800	2024-12-04
758	2025	122500	223700	346200	2024-12-04
758	2023	122500	223700	346200	2024-12-04
758	2022	122500	223700	346200	2024-12-04
759	2025	103400	177900	281300	2024-12-04
759	2023	103400	177900	281300	2024-12-04
759	2022	103400	177900	281300	2024-12-04
760	2025	0	289600	289600	2024-12-04
760	2023	0	289600	289600	2024-12-04
760	2022	0	289600	289600	2024-12-04
762	2025	0	181700	181700	2024-12-04
762	2023	0	181700	181700	2024-12-04
762	2022	0	181700	181700	2024-12-04
764	2025	53400	141100	194500	2024-12-04
764	2023	53400	141100	194500	2024-12-04
764	2022	53400	141100	194500	2024-12-04
765	2025	313700	158200	471900	2024-12-04
765	2023	313700	158200	471900	2024-12-04
765	2022	313700	222400	536100	2024-12-04
767	2025	73900	483700	557600	2024-12-04
767	2023	8700	483700	492400	2024-12-04
767	2022	8700	483700	492400	2024-12-04
768	2025	639200	215800	855000	2024-12-04
768	2023	639200	215800	855000	2024-12-04
768	2022	639200	215800	855000	2024-12-04
769	2025	195800	149200	345000	2024-12-04
769	2023	195800	149200	345000	2024-12-04
769	2022	195800	149200	345000	2024-12-04
770	2025	0	269900	269900	2024-12-04
770	2023	0	269900	269900	2024-12-04
770	2022	0	269900	269900	2024-12-04
771	2025	283000	205900	488900	2024-12-04
771	2023	283000	205900	488900	2024-12-04
771	2022	283000	205900	488900	2024-12-04
772	2025	256700	176600	433300	2024-12-04
772	2023	256700	176600	433300	2024-12-04
772	2022	256700	176600	433300	2024-12-04
773	2025	0	142900	142900	2024-12-04
773	2023	0	142900	142900	2024-12-04
773	2022	0	142900	142900	2024-12-04
774	2025	161200	147700	308900	2024-12-04
774	2023	161200	147700	308900	2024-12-04
774	2022	161200	147700	308900	2024-12-04
775	2025	127300	164800	292100	2024-12-04
775	2023	127300	164800	292100	2024-12-04
775	2022	127300	164800	292100	2024-12-04
776	2025	404000	206900	610900	2024-12-04
776	2023	404000	206900	610900	2024-12-04
776	2022	404000	206900	610900	2024-12-04
782	2025	831100	401000	1232100	2024-12-04
782	2023	831100	401000	1232100	2024-12-04
782	2022	831100	401000	1232100	2024-12-04
783	2025	94200	152700	246900	2024-12-04
783	2023	94200	152700	246900	2024-12-04
783	2022	94200	152700	246900	2024-12-04
784	2025	11200	149400	160600	2024-12-04
784	2023	11200	149400	160600	2024-12-04
784	2022	11200	149400	160600	2024-12-04
785	2025	857100	551300	1408400	2024-12-04
785	2023	857100	551300	1408400	2024-12-04
785	2022	857100	551300	1408400	2024-12-04
786	2025	484200	382900	867100	2024-12-04
786	2023	484200	382900	867100	2024-12-04
786	2022	484200	382900	867100	2024-12-04
787	2025	238800	166500	405300	2024-12-04
787	2023	238800	166500	405300	2024-12-04
787	2022	238800	166500	405300	2024-12-04
788	2025	146600	156300	302900	2024-12-04
788	2023	136300	156300	292600	2024-12-04
788	2022	136300	156300	292600	2024-12-04
789	2025	308700	222700	531400	2024-12-04
789	2023	288700	222700	511400	2024-12-04
789	2022	288700	222700	511400	2024-12-04
792	2025	413000	181300	594300	2024-12-04
792	2023	413000	181300	594300	2024-12-04
792	2022	413000	181300	594300	2024-12-04
793	2025	0	268100	268100	2024-12-04
793	2023	0	268100	268100	2024-12-04
793	2022	0	268100	268100	2024-12-04
795	2025	236000	161200	397200	2024-12-04
795	2023	236000	161200	397200	2024-12-04
795	2022	236000	161200	397200	2024-12-04
796	2025	55500	94000	149500	2024-12-04
796	2023	55500	94000	149500	2024-12-04
796	2022	55500	94000	149500	2024-12-04
797	2025	535400	214900	750300	2024-12-04
797	2023	535400	214900	750300	2024-12-04
797	2022	535400	214900	750300	2024-12-04
798	2025	5400	457100	462500	2024-12-04
798	2023	5400	457100	462500	2024-12-04
798	2022	5400	457100	462500	2024-12-04
799	2025	375900	182900	558800	2024-12-04
799	2023	375900	182900	558800	2024-12-04
799	2022	375900	182900	558800	2024-12-04
800	2025	1185500	377100	1562600	2024-12-04
800	2023	1185500	377100	1562600	2024-12-04
800	2022	1185500	377100	1562600	2024-12-04
801	2025	395700	679100	1074800	2024-12-04
801	2023	395700	679100	1074800	2024-12-04
801	2022	395700	679100	1074800	2024-12-04
804	2025	453900	446200	900100	2024-12-04
804	2023	453900	446200	900100	2024-12-04
804	2022	453900	446200	900100	2024-12-04
806	2025	715100	336900	1052000	2024-12-04
806	2023	715100	336900	1052000	2024-12-04
806	2022	715100	336900	1052000	2024-12-04
807	2025	0	722500	722500	2024-12-04
807	2023	0	722500	722500	2024-12-04
807	2022	0	722500	722500	2024-12-04
808	2025	268500	184100	452600	2024-12-04
808	2023	268500	184100	452600	2024-12-04
808	2022	268500	184100	452600	2024-12-04
809	2025	194900	182800	377700	2024-12-04
809	2023	194900	182800	377700	2024-12-04
809	2022	194900	182800	377700	2024-12-04
810	2025	747800	384400	1132200	2024-12-04
810	2023	747800	384400	1132200	2024-12-04
810	2022	747800	384400	1132200	2024-12-04
811	2025	17300	352400	369700	2024-12-04
811	2023	17300	352400	369700	2024-12-04
811	2022	17300	352400	369700	2024-12-04
812	2025	225800	182600	408400	2024-12-04
812	2023	225800	182600	408400	2024-12-04
812	2022	261500	214500	476000	2024-12-04
814	2025	494100	176200	670300	2024-12-04
814	2023	494100	176200	670300	2024-12-04
814	2022	494100	176200	670300	2024-12-04
815	2025	378600	252100	630700	2024-12-04
815	2023	378600	252100	630700	2024-12-04
815	2022	378600	252100	630700	2024-12-04
816	2025	654900	303400	958300	2024-12-04
816	2023	641800	303400	945200	2024-12-04
816	2022	611800	303400	915200	2024-12-04
820	2025	954300	279300	1233600	2024-12-04
820	2023	954300	279300	1233600	2024-12-04
820	2022	954300	279300	1233600	2024-12-04
821	2025	0	243100	243100	2024-12-04
821	2023	0	243100	243100	2024-12-04
821	2022	0	243100	243100	2024-12-04
824	2025	38200	190600	228800	2024-12-04
824	2023	38200	190600	228800	2024-12-04
824	2022	38200	190600	228800	2024-12-04
826	2025	301900	308300	610200	2024-12-04
826	2023	301900	308300	610200	2024-12-04
826	2022	301900	308300	610200	2024-12-04
827	2025	749700	900000	1649700	2024-12-04
827	2023	749700	900000	1649700	2024-12-04
827	2022	749700	900000	1649700	2024-12-04
829	2025	393900	358200	752100	2024-12-04
829	2023	393900	358200	752100	2024-12-04
829	2022	393900	358200	752100	2024-12-04
830	2025	159900	138800	298700	2024-12-04
830	2023	159900	138800	298700	2024-12-04
830	2022	159900	138800	298700	2024-12-04
831	2025	1136400	699600	1836000	2024-12-04
831	2023	1136400	699600	1836000	2024-12-04
831	2022	1136400	699600	1836000	2024-12-04
832	2025	0	100800	100800	2024-12-04
832	2023	0	100800	100800	2024-12-04
832	2022	0	100800	100800	2024-12-04
833	2025	342900	180000	522900	2024-12-04
833	2023	342900	180000	522900	2024-12-04
833	2022	342900	180000	522900	2024-12-04
834	2025	156300	120200	276500	2024-12-04
834	2023	156300	120200	276500	2024-12-04
834	2022	156300	120200	276500	2024-12-04
835	2025	342000	236200	578200	2024-12-04
835	2023	342000	236200	578200	2024-12-04
835	2022	342000	236200	578200	2024-12-04
836	2025	0	258500	258500	2024-12-04
836	2023	0	258500	258500	2024-12-04
836	2022	0	258500	258500	2024-12-04
837	2025	499700	245900	745600	2024-12-04
837	2023	499700	245900	745600	2024-12-04
837	2022	498200	245900	744100	2024-12-04
838	2025	258600	142000	400600	2024-12-04
838	2023	258600	142000	400600	2024-12-04
838	2022	258600	142000	400600	2024-12-04
839	2025	534600	365900	900500	2024-12-04
839	2023	534600	365900	900500	2024-12-04
839	2022	534600	365900	900500	2024-12-04
840	2025	202100	137200	339300	2024-12-04
840	2023	127400	137200	264600	2024-12-04
840	2022	107300	130700	238000	2024-12-04
841	2025	543500	205900	749400	2024-12-04
841	2023	543500	205900	749400	2024-12-04
841	2022	543500	205900	749400	2024-12-04
842	2025	127100	93200	220300	2024-12-04
842	2023	127100	93200	220300	2024-12-04
842	2022	127100	93200	220300	2024-12-04
843	2025	83600	152200	235800	2024-12-04
843	2023	83600	152200	235800	2024-12-04
843	2022	83600	152200	235800	2024-12-04
844	2025	4300	297500	301800	2024-12-04
844	2023	4300	297500	301800	2024-12-04
844	2022	4300	297500	301800	2024-12-04
845	2025	211500	141600	353100	2024-12-04
845	2023	211500	141600	353100	2024-12-04
845	2022	211500	141600	353100	2024-12-04
846	2025	0	113800	113800	2024-12-04
846	2023	0	113800	113800	2024-12-04
846	2022	0	113800	113800	2024-12-04
849	2025	0	117700	117700	2024-12-04
849	2023	0	117700	117700	2024-12-04
849	2022	0	117700	117700	2024-12-04
850	2025	33500	152200	185700	2024-12-04
850	2023	33500	152200	185700	2024-12-04
850	2022	33500	152200	185700	2024-12-04
851	2025	1500	156500	158000	2024-12-04
851	2023	1500	156500	158000	2024-12-04
851	2022	1500	156500	158000	2024-12-04
852	2025	35100	139500	174600	2024-12-04
852	2023	35100	139500	174600	2024-12-04
852	2022	35100	139500	174600	2024-12-04
853	2025	79000	125500	204500	2024-12-04
853	2023	79000	125500	204500	2024-12-04
853	2022	79000	125500	204500	2024-12-04
855	2025	42800	128800	171600	2024-12-04
855	2023	42800	128800	171600	2024-12-04
855	2022	42800	128800	171600	2024-12-04
858	2025	0	290600	290600	2024-12-04
858	2023	0	290600	290600	2024-12-04
858	2022	0	290600	290600	2024-12-04
860	2025	0	422400	422400	2024-12-04
860	2023	0	422400	422400	2024-12-04
860	2022	0	422400	422400	2024-12-04
861	2025	203600	139000	342600	2024-12-04
861	2023	203600	139000	342600	2024-12-04
861	2022	203600	139000	342600	2024-12-04
862	2025	714100	334100	1048200	2024-12-04
862	2023	714100	334100	1048200	2024-12-04
862	2022	714100	334100	1048200	2024-12-04
863	2025	0	165600	165600	2024-12-04
863	2023	0	165600	165600	2024-12-04
863	2022	0	165600	165600	2024-12-04
864	2025	0	156600	156600	2024-12-04
864	2023	0	156600	156600	2024-12-04
864	2022	0	156600	156600	2024-12-04
865	2025	913800	367800	1281600	2024-12-04
865	2023	913800	367800	1281600	2024-12-04
865	2022	913800	367800	1281600	2024-12-04
867	2025	1064900	808600	1873500	2024-12-04
867	2023	1064900	808600	1873500	2024-12-04
867	2022	1064900	808600	1873500	2024-12-04
868	2025	314000	269600	583600	2024-12-04
868	2023	314000	269600	583600	2024-12-04
868	2022	314000	269600	583600	2024-12-04
869	2025	209700	155600	365300	2024-12-04
869	2023	209700	155600	365300	2024-12-04
869	2022	209700	155600	365300	2024-12-04
871	2025	367100	181500	548600	2024-12-04
871	2023	367100	181500	548600	2024-12-04
871	2022	367100	181500	548600	2024-12-04
872	2025	397900	289300	687200	2024-12-04
872	2023	397900	289300	687200	2024-12-04
872	2022	397900	289300	687200	2024-12-04
873	2025	525300	788000	1313300	2024-12-04
873	2023	525300	788000	1313300	2024-12-04
873	2022	525300	788000	1313300	2024-12-04
874	2025	146500	300200	446700	2024-12-04
874	2023	146500	300200	446700	2024-12-04
874	2022	146500	300200	446700	2024-12-04
875	2025	434800	228300	663100	2024-12-04
875	2023	434800	228300	663100	2024-12-04
875	2022	434800	228300	663100	2024-12-04
876	2025	187900	352500	540400	2024-12-04
876	2023	187900	352500	540400	2024-12-04
876	2022	187900	352500	540400	2024-12-04
877	2025	468400	403300	871700	2024-12-04
877	2023	468400	403300	871700	2024-12-04
877	2022	468400	403300	871700	2024-12-04
878	2025	336300	465800	802100	2024-12-04
878	2023	326300	465800	792100	2024-12-04
878	2022	325900	465800	791700	2024-12-04
879	2025	183200	218400	401600	2024-12-04
879	2023	183200	218400	401600	2024-12-04
879	2022	183200	218400	401600	2024-12-04
880	2025	384400	224300	608700	2024-12-04
880	2023	384400	224300	608700	2024-12-04
880	2022	384400	224300	608700	2024-12-04
881	2025	1268800	371500	1640300	2024-12-04
881	2023	1268800	371500	1640300	2024-12-04
881	2022	1268800	371500	1640300	2024-12-04
883	2025	21300	143600	164900	2024-12-04
883	2023	21300	143600	164900	2024-12-04
883	2022	21300	143600	164900	2024-12-04
884	2025	191000	235500	426500	2024-12-04
884	2023	191000	235500	426500	2024-12-04
884	2022	191000	235500	426500	2024-12-04
887	2025	998100	474700	1472800	2024-12-04
887	2023	998100	474700	1472800	2024-12-04
887	2022	998100	474700	1472800	2024-12-04
888	2025	0	160200	160200	2024-12-04
888	2023	0	160200	160200	2024-12-04
888	2022	0	160200	160200	2024-12-04
891	2025	405300	192900	598200	2024-12-04
891	2023	405300	192900	598200	2024-12-04
891	2022	403600	192900	596500	2024-12-04
892	2025	0	554000	554000	2024-12-04
892	2023	0	554000	554000	2024-12-04
892	2022	0	554000	554000	2024-12-04
895	2025	786900	282800	1069700	2024-12-04
895	2023	786900	282800	1069700	2024-12-04
895	2022	786900	282800	1069700	2024-12-04
896	2025	1117300	352700	1470000	2024-12-04
896	2023	1117300	352700	1470000	2024-12-04
896	2022	1117300	352700	1470000	2024-12-04
897	2025	0	138700	138700	2024-12-04
897	2023	0	138700	138700	2024-12-04
897	2022	0	138700	138700	2024-12-04
898	2025	0	425300	425300	2024-12-04
898	2023	0	425300	425300	2024-12-04
898	2022	0	425300	425300	2024-12-04
899	2025	597700	515300	1113000	2024-12-04
899	2023	581100	515300	1096400	2024-12-04
899	2022	581100	515300	1096400	2024-12-04
900	2025	563900	675100	1239000	2024-12-04
900	2023	563900	675100	1239000	2024-12-04
900	2022	563900	675100	1239000	2024-12-04
901	2025	114200	178100	292300	2024-12-04
901	2023	114200	178100	292300	2024-12-04
901	2022	114200	178100	292300	2024-12-04
907	2025	0	375900	375900	2024-12-04
907	2023	0	375900	375900	2024-12-04
907	2022	0	375900	375900	2024-12-04
908	2025	0	428000	428000	2024-12-04
908	2023	0	428000	428000	2024-12-04
908	2022	0	428000	428000	2024-12-04
909	2025	1491200	1184800	2676000	2024-12-04
909	2023	1264700	1184800	2449500	2024-12-04
909	2022	1264700	1184800	2449500	2024-12-04
910	2025	487700	403500	891200	2024-12-04
910	2023	487700	403500	891200	2024-12-04
910	2022	487700	403500	891200	2024-12-04
911	2025	420600	852600	1273200	2024-12-04
911	2023	420600	852600	1273200	2024-12-04
911	2022	420600	852600	1273200	2024-12-04
912	2025	0	81400	81400	2024-12-04
912	2023	0	81400	81400	2024-12-04
912	2022	0	81400	81400	2024-12-04
913	2025	462100	149300	611400	2024-12-04
913	2023	277400	149300	426700	2024-12-04
913	2022	25900	149300	175200	2024-12-04
915	2025	133700	155800	289500	2024-12-04
915	2023	133700	155800	289500	2024-12-04
915	2022	133700	155800	289500	2024-12-04
916	2025	171000	178500	349500	2024-12-04
916	2023	171000	178500	349500	2024-12-04
916	2022	171000	178500	349500	2024-12-04
917	2025	250500	235300	485800	2024-12-04
917	2023	250500	235300	485800	2024-12-04
917	2022	250500	235300	485800	2024-12-04
920	2025	441800	335600	777400	2024-12-04
920	2023	441800	335600	777400	2024-12-04
920	2022	403900	335600	739500	2024-12-04
921	2025	302400	249100	551500	2024-12-04
921	2023	302400	249100	551500	2024-12-04
921	2022	302400	249100	551500	2024-12-04
923	2025	29900	171500	201400	2024-12-04
923	2023	29900	171500	201400	2024-12-04
923	2022	29900	171500	201400	2024-12-04
924	2025	0	444100	444100	2024-12-04
924	2023	0	444100	444100	2024-12-04
924	2022	0	477500	477500	2024-12-04
925	2025	0	400	400	2024-12-04
925	2023	0	400	400	2024-12-04
925	2022	0	400	400	2024-12-04
934	2025	0	222900	222900	2024-12-04
934	2023	0	222900	222900	2024-12-04
934	2022	0	222900	222900	2024-12-04
935	2025	458600	263000	721600	2024-12-04
935	2023	458600	263000	721600	2024-12-04
935	2022	458600	263000	721600	2024-12-04
939	2025	596300	440400	1036700	2024-12-04
939	2023	596300	440400	1036700	2024-12-04
939	2022	596300	440400	1036700	2024-12-04
940	2025	442600	276100	718700	2024-12-04
940	2023	442600	276100	718700	2024-12-04
940	2022	432600	276100	708700	2024-12-04
941	2025	397900	168600	566500	2024-12-04
941	2023	397900	168600	566500	2024-12-04
941	2022	397900	168600	566500	2024-12-04
942	2025	402700	227300	630000	2024-12-04
942	2023	402700	227300	630000	2024-12-04
942	2022	402700	227300	630000	2024-12-04
943	2025	324200	261900	586100	2024-12-04
943	2023	324200	261900	586100	2024-12-04
943	2022	324200	261900	586100	2024-12-04
944	2025	331800	297200	629000	2024-12-04
944	2023	331800	297200	629000	2024-12-04
944	2022	331800	297200	629000	2024-12-04
947	2025	334800	143600	478400	2024-12-04
947	2023	334800	143600	478400	2024-12-04
947	2022	334800	143600	478400	2024-12-04
949	2025	425800	386900	812700	2024-12-04
949	2023	425800	386900	812700	2024-12-04
949	2022	423400	386900	810300	2024-12-04
951	2025	161600	106600	268200	2024-12-04
951	2023	161600	106600	268200	2024-12-04
951	2022	161600	106600	268200	2024-12-04
952	2025	122200	125500	247700	2024-12-04
952	2023	122200	125500	247700	2024-12-04
952	2022	122200	125500	247700	2024-12-04
953	2025	183800	126300	310100	2024-12-04
953	2023	183800	126300	310100	2024-12-04
953	2022	183800	126300	310100	2024-12-04
954	2025	134700	156100	290800	2024-12-04
954	2023	134700	156100	290800	2024-12-04
954	2022	134700	156100	290800	2024-12-04
955	2025	91100	124900	216000	2024-12-04
955	2023	91100	124900	216000	2024-12-04
955	2022	91100	124900	216000	2024-12-04
958	2025	311600	108600	420200	2024-12-04
958	2023	311600	108600	420200	2024-12-04
958	2022	311600	108600	420200	2024-12-04
959	2025	229100	112600	341700	2024-12-04
959	2023	229100	112600	341700	2024-12-04
959	2022	229100	112600	341700	2024-12-04
960	2025	209600	115100	324700	2024-12-04
960	2023	209600	115100	324700	2024-12-04
960	2022	209600	115100	324700	2024-12-04
961	2025	383800	243800	627600	2024-12-04
961	2023	383800	243800	627600	2024-12-04
961	2022	383800	243800	627600	2024-12-04
962	2025	371900	112400	484300	2024-12-04
962	2023	371900	112400	484300	2024-12-04
962	2022	371900	112400	484300	2024-12-04
963	2025	245600	239300	484900	2024-12-04
963	2023	245600	239300	484900	2024-12-04
963	2022	245600	239300	484900	2024-12-04
964	2025	0	211200	211200	2024-12-04
964	2023	0	211200	211200	2024-12-04
964	2022	0	211200	211200	2024-12-04
965	2025	528500	231100	759600	2024-12-04
965	2023	528500	231100	759600	2024-12-04
965	2022	528500	231100	759600	2024-12-04
966	2025	376200	166000	542200	2024-12-04
966	2023	376200	166000	542200	2024-12-04
966	2022	376200	166000	542200	2024-12-04
967	2025	467700	172900	640600	2024-12-04
967	2023	467700	172900	640600	2024-12-04
967	2022	467700	172900	640600	2024-12-04
968	2025	222600	278700	501300	2024-12-04
968	2023	234500	278700	513200	2024-12-04
968	2022	215000	278700	493700	2024-12-04
969	2025	143300	156100	299400	2024-12-04
969	2023	143300	156100	299400	2024-12-04
969	2022	143300	156100	299400	2024-12-04
971	2025	207900	172600	380500	2024-12-04
971	2023	207900	172600	380500	2024-12-04
971	2022	207900	172600	380500	2024-12-04
972	2025	0	158100	158100	2024-12-04
972	2023	0	158100	158100	2024-12-04
972	2022	0	158100	158100	2024-12-04
973	2025	253200	151600	404800	2024-12-04
973	2023	253200	151600	404800	2024-12-04
973	2022	253200	151600	404800	2024-12-04
974	2025	466700	266000	732700	2024-12-04
974	2023	466700	266000	732700	2024-12-04
974	2022	463100	266000	729100	2024-12-04
975	2025	0	221300	221300	2024-12-04
975	2023	0	221300	221300	2024-12-04
975	2022	0	221300	221300	2024-12-04
976	2025	261400	211800	473200	2024-12-04
976	2023	261400	211800	473200	2024-12-04
976	2022	261400	211800	473200	2024-12-04
977	2025	603500	192500	796000	2024-12-04
977	2023	603500	192500	796000	2024-12-04
977	2022	584200	192500	776700	2024-12-04
978	2025	26100	134100	160200	2024-12-04
978	2023	26100	134100	160200	2024-12-04
978	2022	26100	134100	160200	2024-12-04
979	2025	94700	130300	225000	2024-12-04
979	2023	94700	130300	225000	2024-12-04
979	2022	94700	130300	225000	2024-12-04
981	2025	270900	128900	399800	2024-12-04
981	2023	270900	128900	399800	2024-12-04
981	2022	270900	128900	399800	2024-12-04
982	2025	112400	137000	249400	2024-12-04
982	2023	112400	137000	249400	2024-12-04
982	2022	112400	137000	249400	2024-12-04
983	2025	12100	137300	149400	2024-12-04
983	2023	12100	137300	149400	2024-12-04
983	2022	12100	137300	149400	2024-12-04
984	2025	90800	118300	209100	2024-12-04
984	2023	90800	118300	209100	2024-12-04
984	2022	90800	118300	209100	2024-12-04
986	2025	107000	139600	246600	2024-12-04
986	2023	107000	139600	246600	2024-12-04
986	2022	107000	139600	246600	2024-12-04
987	2025	258800	411500	670300	2024-12-04
987	2023	258800	411500	670300	2024-12-04
987	2022	258800	411500	670300	2024-12-04
990	2025	4100	12000	16100	2024-12-04
990	2023	4100	12000	16100	2024-12-04
990	2022	4100	12000	16100	2024-12-04
991	2025	77800	131000	208800	2024-12-04
991	2023	77800	131000	208800	2024-12-04
991	2022	77800	131000	208800	2024-12-04
992	2025	0	680300	680300	2024-12-04
992	2023	0	680300	680300	2024-12-04
992	2022	0	680300	680300	2024-12-04
993	2025	226300	135900	362200	2024-12-04
993	2023	226300	135900	362200	2024-12-04
993	2022	226300	135900	362200	2024-12-04
994	2025	145200	171100	316300	2024-12-04
994	2023	145200	171100	316300	2024-12-04
994	2022	145200	171100	316300	2024-12-04
995	2025	165900	84200	250100	2024-12-04
995	2023	165900	84200	250100	2024-12-04
995	2022	165900	84200	250100	2024-12-04
996	2025	336100	186700	522800	2024-12-04
996	2023	336100	186700	522800	2024-12-04
996	2022	336100	186700	522800	2024-12-04
997	2025	212500	160700	373200	2024-12-04
997	2023	212500	160700	373200	2024-12-04
997	2022	212500	160700	373200	2024-12-04
998	2025	442600	379500	822100	2024-12-04
998	2023	442600	379500	822100	2024-12-04
998	2022	442600	379500	822100	2024-12-04
1002	2025	0	141700	141700	2024-12-04
1002	2023	0	141700	141700	2024-12-04
1002	2022	0	141700	141700	2024-12-04
1003	2025	291800	361400	653200	2024-12-04
1003	2023	178600	361400	540000	2024-12-04
1003	2022	167600	361400	529000	2024-12-04
1004	2025	370900	175200	546100	2024-12-04
1004	2023	370900	175200	546100	2024-12-04
1004	2022	370900	175200	546100	2024-12-04
1005	2025	348300	184800	533100	2024-12-04
1005	2023	348300	184800	533100	2024-12-04
1005	2022	348300	184800	533100	2024-12-04
1006	2025	131500	140300	271800	2024-12-04
1006	2023	131500	140300	271800	2024-12-04
1006	2022	131500	140300	271800	2024-12-04
1009	2025	0	366700	366700	2024-12-04
1009	2023	0	366700	366700	2024-12-04
1009	2022	0	366700	366700	2024-12-04
1015	2025	56500	122100	178600	2024-12-04
1015	2023	56500	122100	178600	2024-12-04
1015	2022	56500	122100	178600	2024-12-04
1016	2025	122600	155100	277700	2024-12-04
1016	2023	122600	155100	277700	2024-12-04
1016	2022	122600	155100	277700	2024-12-04
1018	2025	43400	191800	235200	2024-12-04
1018	2023	43400	191800	235200	2024-12-04
1018	2022	43400	191800	235200	2024-12-04
1019	2025	265300	163000	428300	2024-12-04
1019	2023	265300	163000	428300	2024-12-04
1019	2022	265300	163000	428300	2024-12-04
1020	2025	81200	169000	250200	2024-12-04
1020	2023	81200	169000	250200	2024-12-04
1020	2022	81200	169000	250200	2024-12-04
1022	2025	370500	395200	765700	2024-12-04
1022	2023	370500	395200	765700	2024-12-04
1022	2022	370500	395200	765700	2024-12-04
1023	2025	160500	195700	356200	2024-12-04
1023	2023	160500	195700	356200	2024-12-04
1023	2022	160500	195700	356200	2024-12-04
1024	2025	142900	148400	291300	2024-12-04
1024	2023	142900	148400	291300	2024-12-04
1024	2022	142900	148400	291300	2024-12-04
1025	2025	296500	202000	498500	2024-12-04
1025	2023	296500	202000	498500	2024-12-04
1025	2022	296500	202000	498500	2024-12-04
1026	2025	261400	264800	526200	2024-12-04
1026	2023	261400	264800	526200	2024-12-04
1026	2022	261400	264800	526200	2024-12-04
1027	2025	0	401100	401100	2024-12-04
1027	2023	0	401100	401100	2024-12-04
1027	2022	0	401100	401100	2024-12-04
1028	2025	0	12200	12200	2024-12-04
1028	2023	0	12200	12200	2024-12-04
1028	2022	0	12200	12200	2024-12-04
1030	2025	368900	354100	723000	2024-12-04
1030	2023	368900	354100	723000	2024-12-04
1030	2022	368900	354100	723000	2024-12-04
1031	2025	145000	176700	321700	2024-12-04
1031	2023	145000	176700	321700	2024-12-04
1031	2022	145000	176700	321700	2024-12-04
1033	2025	313200	306900	620100	2024-12-04
1033	2023	298200	306900	605100	2024-12-04
1033	2022	298200	306900	605100	2024-12-04
1034	2025	17100	103900	121000	2024-12-04
1034	2023	17100	103900	121000	2024-12-04
1034	2022	17100	103900	121000	2024-12-04
1035	2025	162400	251800	414200	2024-12-04
1035	2023	162400	251800	414200	2024-12-04
1035	2022	162400	251800	414200	2024-12-04
1037	2025	53700	226100	279800	2024-12-04
1037	2023	53700	226100	279800	2024-12-04
1037	2022	53700	226100	279800	2024-12-04
1038	2025	114400	97000	211400	2024-12-04
1038	2023	114400	97000	211400	2024-12-04
1038	2022	114400	97000	211400	2024-12-04
1039	2025	0	402900	402900	2024-12-04
1039	2023	0	402900	402900	2024-12-04
1039	2022	0	402900	402900	2024-12-04
1040	2025	404300	143100	547400	2024-12-04
1040	2023	404300	143100	547400	2024-12-04
1040	2022	391100	143100	534200	2024-12-04
1041	2025	348600	147700	496300	2024-12-04
1041	2023	348600	147700	496300	2024-12-04
1041	2022	348600	147700	496300	2024-12-04
1042	2025	245800	152800	398600	2024-12-04
1042	2023	245800	152800	398600	2024-12-04
1042	2022	245800	152800	398600	2024-12-04
1043	2025	125600	100500	226100	2024-12-04
1043	2023	125600	100500	226100	2024-12-04
1043	2022	125600	100500	226100	2024-12-04
1045	2025	68200	105400	173600	2024-12-04
1045	2023	68200	105400	173600	2024-12-04
1045	2022	68200	105400	173600	2024-12-04
1046	2025	128000	131300	259300	2024-12-04
1046	2023	128000	131300	259300	2024-12-04
1046	2022	128000	131300	259300	2024-12-04
1048	2025	0	4400	4400	2024-12-04
1048	2023	0	4400	4400	2024-12-04
1048	2022	0	4400	4400	2024-12-04
1049	2025	31100	161400	192500	2024-12-04
1049	2023	31100	161400	192500	2024-12-04
1049	2022	31100	161400	192500	2024-12-04
1051	2025	90000	147200	237200	2024-12-04
1051	2023	73600	147200	220800	2024-12-04
1051	2022	73600	147200	220800	2024-12-04
1052	2025	118300	260900	379200	2024-12-04
1052	2023	118300	260900	379200	2024-12-04
1052	2022	118300	260900	379200	2024-12-04
1053	2025	859100	1007400	1866500	2024-12-04
1053	2023	859100	1007400	1866500	2024-12-04
1053	2022	859100	1044500	1903600	2024-12-04
1054	2025	1622000	804100	2426100	2024-12-04
1054	2023	1622000	804100	2426100	2024-12-04
1054	2022	1622000	804100	2426100	2024-12-04
1055	2025	0	327000	327000	2024-12-04
1055	2023	0	327000	327000	2024-12-04
1055	2022	0	327000	327000	2024-12-04
1057	2025	0	72300	72300	2024-12-04
1057	2023	0	72300	72300	2024-12-04
1057	2022	0	72300	72300	2024-12-04
1058	2025	9400	270800	280200	2024-12-04
1058	2023	9400	270800	280200	2024-12-04
1058	2022	9400	270800	280200	2024-12-04
1060	2025	956300	438500	1394800	2024-12-04
1060	2023	952200	438500	1390700	2024-12-04
1060	2022	952200	438500	1390700	2024-12-04
1061	2025	132200	194200	326400	2024-12-04
1061	2023	132200	194200	326400	2024-12-04
1061	2022	132200	194200	326400	2024-12-04
1064	2025	536700	476500	1013200	2024-12-04
1064	2023	536700	476500	1013200	2024-12-04
1064	2022	536700	476500	1013200	2024-12-04
1068	2025	620900	381500	1002400	2024-12-04
1068	2023	620900	381500	1002400	2024-12-04
1068	2022	620900	336000	956900	2024-12-04
1069	2025	0	180000	180000	2024-12-04
1069	2023	0	180000	180000	2024-12-04
1069	2022	0	180000	180000	2024-12-04
1070	2025	62100	169800	231900	2024-12-04
1070	2023	62100	169800	231900	2024-12-04
1070	2022	62100	169800	231900	2024-12-04
1071	2025	496200	139200	635400	2024-12-04
1071	2023	496200	139200	635400	2024-12-04
1071	2022	496200	139200	635400	2024-12-04
1076	2025	0	220200	220200	2024-12-04
1076	2023	0	220200	220200	2024-12-04
1076	2022	0	220200	220200	2024-12-04
1077	2025	0	997900	997900	2024-12-04
1077	2023	0	997900	997900	2024-12-04
1077	2022	0	997900	997900	2024-12-04
1078	2025	200900	103900	304800	2024-12-04
1078	2023	200900	103900	304800	2024-12-04
1078	2022	200900	103900	304800	2024-12-04
1079	2025	0	66800	66800	2024-12-04
1079	2023	0	66800	66800	2024-12-04
1079	2022	0	66800	66800	2024-12-04
1081	2025	0	92100	92100	2024-12-04
1081	2023	0	92100	92100	2024-12-04
1081	2022	0	92100	92100	2024-12-04
1082	2025	33700	95900	129600	2024-12-04
1082	2023	33700	95900	129600	2024-12-04
1082	2022	33700	95900	129600	2024-12-04
1083	2025	0	572000	572000	2024-12-04
1083	2023	0	572000	572000	2024-12-04
1083	2022	0	572000	572000	2024-12-04
1084	2025	0	33700	33700	2024-12-04
1084	2023	0	33700	33700	2024-12-04
1084	2022	0	33700	33700	2024-12-04
1085	2025	0	140400	140400	2024-12-04
1085	2023	0	140400	140400	2024-12-04
1085	2022	0	140400	140400	2024-12-04
1087	2025	0	83500	83500	2024-12-04
1087	2023	0	83500	83500	2024-12-04
1087	2022	0	83500	83500	2024-12-04
1091	2025	80800	145200	226000	2024-12-04
1091	2023	80800	145200	226000	2024-12-04
1091	2022	80800	145200	226000	2024-12-04
1092	2025	309500	161300	470800	2024-12-04
1092	2023	309500	161300	470800	2024-12-04
1092	2022	309500	161300	470800	2024-12-04
1093	2025	0	139200	139200	2024-12-04
1093	2023	0	139200	139200	2024-12-04
1093	2022	0	139200	139200	2024-12-04
1094	2025	179900	240600	420500	2024-12-04
1094	2023	179900	240600	420500	2024-12-04
1094	2022	179900	240600	420500	2024-12-04
1096	2025	1589900	780600	2370500	2024-12-04
1096	2023	1589900	780600	2370500	2024-12-04
1096	2022	1589900	780600	2370500	2024-12-04
1097	2025	0	862800	862800	2024-12-04
1097	2023	0	197900	197900	2024-12-04
1097	2022	0	197900	197900	2024-12-04
1099	2025	269700	194800	464500	2024-12-04
1099	2023	269700	194800	464500	2024-12-04
1099	2022	257600	194800	452400	2024-12-04
1101	2025	176500	127400	303900	2024-12-04
1101	2023	176500	127400	303900	2024-12-04
1101	2022	176500	127400	303900	2024-12-04
1102	2025	94200	134800	229000	2024-12-04
1102	2023	94200	134800	229000	2024-12-04
1102	2022	94200	134800	229000	2024-12-04
1103	2025	0	353700	353700	2024-12-04
1103	2023	0	353700	353700	2024-12-04
1103	2022	0	353700	353700	2024-12-04
1104	2025	535000	434700	969700	2024-12-04
1104	2023	535000	434700	969700	2024-12-04
1104	2022	535000	434700	969700	2024-12-04
1105	2025	538000	432800	970800	2024-12-04
1105	2023	538000	432800	970800	2024-12-04
1105	2022	538000	432800	970800	2024-12-04
1109	2025	653900	489400	1143300	2024-12-04
1109	2023	653900	489400	1143300	2024-12-04
1109	2022	653900	489400	1143300	2024-12-04
1111	2025	0	128800	128800	2024-12-04
1111	2023	0	128800	128800	2024-12-04
1111	2022	0	128800	128800	2024-12-04
1112	2025	196600	168700	365300	2024-12-04
1112	2023	196600	168700	365300	2024-12-04
1112	2022	196600	168700	365300	2024-12-04
1113	2025	73200	455600	528800	2024-12-04
1113	2023	73200	455600	528800	2024-12-04
1113	2022	73200	455600	528800	2024-12-04
1118	2025	204900	130200	335100	2024-12-04
1118	2023	204900	130200	335100	2024-12-04
1118	2022	204900	130200	335100	2024-12-04
1120	2025	370500	232200	602700	2024-12-04
1120	2023	370500	232200	602700	2024-12-04
1120	2022	370500	232200	602700	2024-12-04
1121	2025	233400	148900	382300	2024-12-04
1121	2023	221000	148900	369900	2024-12-04
1121	2022	221000	148900	369900	2024-12-04
1122	2025	27800	97300	125100	2024-12-04
1122	2023	27800	97300	125100	2024-12-04
1122	2022	27800	97300	125100	2024-12-04
1123	2025	37100	140400	177500	2024-12-04
1123	2023	37100	140400	177500	2024-12-04
1123	2022	37100	140400	177500	2024-12-04
1124	2025	39500	95000	134500	2024-12-04
1124	2023	39500	95000	134500	2024-12-04
1124	2022	39500	95000	134500	2024-12-04
1125	2025	27000	50400	77400	2024-12-04
1125	2023	27000	50400	77400	2024-12-04
1125	2022	27000	50400	77400	2024-12-04
1126	2025	194300	103600	297900	2024-12-04
1126	2023	194300	103600	297900	2024-12-04
1126	2022	194300	103600	297900	2024-12-04
1127	2025	50200	304400	354600	2024-12-04
1127	2023	50200	304400	354600	2024-12-04
1127	2022	50200	304400	354600	2024-12-04
1129	2025	0	107900	107900	2024-12-04
1129	2023	0	107900	107900	2024-12-04
1129	2022	0	107900	107900	2024-12-04
1131	2025	54200	338100	392300	2024-12-04
1131	2023	54200	338100	392300	2024-12-04
1131	2022	54200	338100	392300	2024-12-04
1132	2025	605600	584900	1190500	2024-12-04
1132	2023	605600	584900	1190500	2024-12-04
1132	2022	605600	531100	1136700	2024-12-04
1133	2025	121200	111300	232500	2024-12-04
1133	2023	121200	111300	232500	2024-12-04
1133	2022	121200	111300	232500	2024-12-04
1136	2025	82700	92300	175000	2024-12-04
1136	2023	82700	92300	175000	2024-12-04
1136	2022	82700	92300	175000	2024-12-04
1137	2025	26500	75000	101500	2024-12-04
1137	2023	26500	75000	101500	2024-12-04
1137	2022	26500	75000	101500	2024-12-04
1138	2025	40000	46500	86500	2024-12-04
1138	2023	40000	46500	86500	2024-12-04
1138	2022	40000	46500	86500	2024-12-04
1140	2025	258000	150300	408300	2024-12-04
1140	2023	233000	150300	383300	2024-12-04
1140	2022	233000	150300	383300	2024-12-04
1141	2025	0	3300	3300	2024-12-04
1141	2023	0	3300	3300	2024-12-04
1141	2022	0	3300	3300	2024-12-04
1142	2025	298500	151900	450400	2024-12-04
1142	2023	298500	151900	450400	2024-12-04
1142	2022	252600	151900	404500	2024-12-04
1144	2025	380000	190600	570600	2024-12-04
1144	2023	380000	190600	570600	2024-12-04
1144	2022	380000	190600	570600	2024-12-04
1149	2025	164600	275900	440500	2024-12-04
1149	2023	164600	275900	440500	2024-12-04
1149	2022	164600	275900	440500	2024-12-04
1150	2025	195100	190700	385800	2024-12-04
1150	2023	195100	190700	385800	2024-12-04
1150	2022	195100	190700	385800	2024-12-04
1151	2025	0	347500	347500	2024-12-04
1151	2023	0	347500	347500	2024-12-04
1151	2022	0	347500	347500	2024-12-04
1152	2025	0	311600	311600	2024-12-04
1152	2023	0	311600	311600	2024-12-04
1152	2022	0	311600	311600	2024-12-04
1154	2025	0	100400	100400	2024-12-04
1154	2023	0	100400	100400	2024-12-04
1154	2022	0	100400	100400	2024-12-04
1155	2025	0	217300	217300	2024-12-04
1155	2023	0	217300	217300	2024-12-04
1155	2022	0	217300	217300	2024-12-04
1156	2025	343100	221600	564700	2024-12-04
1156	2023	343100	221600	564700	2024-12-04
1156	2022	343100	221600	564700	2024-12-04
1157	2025	77200	178200	255400	2024-12-04
1157	2023	77200	178200	255400	2024-12-04
1157	2022	77200	178200	255400	2024-12-04
1158	2025	0	304500	304500	2024-12-04
1158	2023	0	304500	304500	2024-12-04
1158	2022	0	304500	304500	2024-12-04
1163	2025	0	205000	205000	2024-12-04
1163	2023	0	205000	205000	2024-12-04
1163	2022	0	205000	205000	2024-12-04
1164	2025	0	2792500	2792500	2024-12-04
1164	2023	0	2792500	2792500	2024-12-04
1164	2022	0	2792500	2792500	2024-12-04
1165	2025	70600	85100	155700	2024-12-04
1165	2023	70600	85100	155700	2024-12-04
1165	2022	70500	85100	155600	2024-12-04
1166	2025	185000	154900	339900	2024-12-04
1166	2023	185000	154900	339900	2024-12-04
1166	2022	182400	154900	337300	2024-12-04
1167	2025	156100	142600	298700	2024-12-04
1167	2023	156100	142600	298700	2024-12-04
1167	2022	154000	142600	296600	2024-12-04
1169	2025	527000	253000	780000	2024-12-04
1169	2023	527000	253000	780000	2024-12-04
1169	2022	527000	253000	780000	2024-12-04
1170	2025	267100	299800	566900	2024-12-04
1170	2023	267100	299800	566900	2024-12-04
1170	2022	261600	299800	561400	2024-12-04
1171	2025	0	83700	83700	2024-12-04
1171	2023	0	83700	83700	2024-12-04
1171	2022	0	83700	83700	2024-12-04
1173	2025	58600	258000	316600	2024-12-04
1173	2023	58600	258000	316600	2024-12-04
1173	2022	58600	258000	316600	2024-12-04
1177	2025	0	324600	324600	2024-12-04
1177	2023	0	324600	324600	2024-12-04
1177	2022	0	324600	324600	2024-12-04
1186	2025	0	59000	59000	2024-12-04
1186	2023	0	59000	59000	2024-12-04
1186	2022	0	59000	59000	2024-12-04
1187	2025	0	72300	72300	2024-12-04
1187	2023	0	72300	72300	2024-12-04
1187	2022	0	72300	72300	2024-12-04
1188	2025	520600	348700	869300	2024-12-04
1188	2023	500600	348700	849300	2024-12-04
1188	2022	477000	348700	825700	2024-12-04
1189	2025	0	290400	290400	2024-12-04
1189	2023	0	290400	290400	2024-12-04
1189	2022	0	290400	290400	2024-12-04
1190	2025	1200	113100	114300	2024-12-04
1190	2023	1200	113100	114300	2024-12-04
1190	2022	1200	113100	114300	2024-12-04
1191	2025	0	110100	110100	2024-12-04
1191	2023	0	110100	110100	2024-12-04
1191	2022	0	110100	110100	2024-12-04
1192	2025	0	22300	22300	2024-12-04
1192	2023	0	22300	22300	2024-12-04
1192	2022	0	22300	22300	2024-12-04
1193	2025	0	77500	77500	2024-12-04
1193	2023	0	77500	77500	2024-12-04
1193	2022	0	77500	77500	2024-12-04
1195	2025	318700	160200	478900	2024-12-04
1195	2023	318700	160200	478900	2024-12-04
1195	2022	318700	160200	478900	2024-12-04
1196	2025	328700	168700	497400	2024-12-04
1196	2023	328700	168700	497400	2024-12-04
1196	2022	325600	168700	494300	2024-12-04
1197	2025	4300	63600	67900	2024-12-04
1197	2023	4300	63600	67900	2024-12-04
1197	2022	4300	63600	67900	2024-12-04
1198	2025	0	0	0	2024-12-04
1198	2023	0	0	0	2024-12-04
1198	2022	0	0	0	2024-12-04
1199	2025	119900	138500	258400	2024-12-04
1199	2023	119900	138500	258400	2024-12-04
1199	2022	119800	138500	258300	2024-12-04
1200	2025	168200	130700	298900	2024-12-04
1200	2023	168200	130700	298900	2024-12-04
1200	2022	165800	130700	296500	2024-12-04
1201	2025	272000	138100	410100	2024-12-04
1201	2023	272000	138100	410100	2024-12-04
1201	2022	284500	138100	422600	2024-12-04
1202	2025	296000	138100	434100	2024-12-04
1202	2023	296000	138100	434100	2024-12-04
1202	2022	294100	138100	432200	2024-12-04
1203	2025	201400	138100	339500	2024-12-04
1203	2023	189600	138100	327700	2024-12-04
1203	2022	189100	138100	327200	2024-12-04
1204	2025	190600	145500	336100	2024-12-04
1204	2023	190600	145500	336100	2024-12-04
1204	2022	187600	145500	333100	2024-12-04
1206	2025	0	625400	625400	2024-12-04
1206	2023	0	625400	625400	2024-12-04
1206	2022	0	625400	625400	2024-12-04
1207	2025	0	16100	16100	2024-12-04
1207	2023	0	16100	16100	2024-12-04
1207	2022	0	16100	16100	2024-12-04
1208	2025	299400	162800	462200	2024-12-04
1208	2023	299400	162800	462200	2024-12-04
1208	2022	293700	162800	456500	2024-12-04
1209	2025	300400	199500	499900	2024-12-04
1209	2023	300400	199500	499900	2024-12-04
1209	2022	294100	199500	493600	2024-12-04
1211	2025	118500	167700	286200	2024-12-04
1211	2023	118500	167700	286200	2024-12-04
1211	2022	116300	167700	284000	2024-12-04
1212	2025	474700	190000	664700	2024-12-04
1212	2023	474700	190000	664700	2024-12-04
1212	2022	474700	190000	664700	2024-12-04
1213	2025	400100	189300	589400	2024-12-04
1213	2023	400100	189300	589400	2024-12-04
1213	2022	390400	189300	579700	2024-12-04
1214	2025	0	33200	33200	2024-12-04
1214	2023	0	33200	33200	2024-12-04
1214	2022	0	33200	33200	2024-12-04
1215	2025	0	419900	419900	2024-12-04
1215	2023	0	419900	419900	2024-12-04
1215	2022	0	419900	419900	2024-12-04
1222	2025	537800	268300	806100	2024-12-04
1222	2023	479600	268300	747900	2024-12-04
1222	2022	428200	268300	696500	2024-12-04
1223	2025	0	428700	428700	2024-12-04
1223	2023	0	428700	428700	2024-12-04
1223	2022	0	428700	428700	2024-12-04
1225	2025	345500	257200	602700	2024-12-04
1225	2023	224600	218500	443100	2024-12-04
1225	2022	222900	218500	441400	2024-12-04
1226	2025	857800	714300	1572100	2024-12-04
1226	2023	857800	714300	1572100	2024-12-04
1226	2022	831300	714300	1545600	2024-12-04
1227	2025	425300	360300	785600	2024-12-04
1227	2023	425300	360300	785600	2024-12-04
1227	2022	425300	360300	785600	2024-12-04
1228	2025	161900	344400	506300	2024-12-04
1228	2023	161900	344400	506300	2024-12-04
1228	2022	162200	344400	506600	2024-12-04
1229	2025	34700	80000	114700	2024-12-04
1229	2023	34700	80000	114700	2024-12-04
1229	2022	34700	80000	114700	2024-12-04
1230	2025	358300	279000	637300	2024-12-04
1230	2023	358300	279000	637300	2024-12-04
1230	2022	358200	279000	637200	2024-12-04
1232	2025	155200	147100	302300	2024-12-04
1232	2023	155200	147100	302300	2024-12-04
1232	2022	156500	147100	303600	2024-12-04
1233	2025	304300	176600	480900	2024-12-04
1233	2023	304300	176600	480900	2024-12-04
1233	2022	304300	176600	480900	2024-12-04
1234	2025	132600	136700	269300	2024-12-04
1234	2023	132600	136700	269300	2024-12-04
1234	2022	129400	136700	266100	2024-12-04
1235	2025	114400	120800	235200	2024-12-04
1235	2023	114400	120800	235200	2024-12-04
1235	2022	114800	120800	235600	2024-12-04
1236	2025	65700	143200	208900	2024-12-04
1236	2023	65700	143200	208900	2024-12-04
1236	2022	66500	143200	209700	2024-12-04
1243	2025	0	299900	299900	2024-12-04
1243	2023	0	299900	299900	2024-12-04
1243	2022	0	299900	299900	2024-12-04
1247	2025	520900	415900	936800	2024-12-04
1247	2023	520900	415900	936800	2024-12-04
1247	2022	510900	415900	926800	2024-12-04
1248	2025	521400	319500	840900	2024-12-04
1248	2023	521400	319500	840900	2024-12-04
1248	2022	455900	319500	775400	2024-12-04
1249	2025	176800	414100	590900	2024-12-04
1249	2023	176800	414100	590900	2024-12-04
1249	2022	176600	414100	590700	2024-12-04
1250	2025	281200	168700	449900	2024-12-04
1250	2023	281200	168700	449900	2024-12-04
1250	2022	278300	168700	447000	2024-12-04
1251	2025	457700	190500	648200	2024-12-04
1251	2023	457700	190500	648200	2024-12-04
1251	2022	457500	190500	648000	2024-12-04
1255	2025	368200	157800	526000	2024-12-04
1255	2023	368200	157800	526000	2024-12-04
1255	2022	363500	157800	521300	2024-12-04
1256	2025	240200	140300	380500	2024-12-04
1256	2023	240200	140300	380500	2024-12-04
1256	2022	238500	140300	378800	2024-12-04
1257	2025	149800	130700	280500	2024-12-04
1257	2023	149800	130700	280500	2024-12-04
1257	2022	149000	130700	279700	2024-12-04
1263	2025	156000	409000	565000	2024-12-04
1263	2023	156000	409000	565000	2024-12-04
1263	2022	156000	409000	565000	2024-12-04
1265	2025	256800	146600	403400	2024-12-04
1265	2023	256800	146600	403400	2024-12-04
1265	2022	255500	146600	402100	2024-12-04
1266	2025	338200	173300	511500	2024-12-04
1266	2023	338200	173300	511500	2024-12-04
1266	2022	324100	173300	497400	2024-12-04
1267	2025	278700	149300	428000	2024-12-04
1267	2023	278700	149300	428000	2024-12-04
1267	2022	278100	149300	427400	2024-12-04
1268	2025	21400	118300	139700	2024-12-04
1268	2023	21400	118300	139700	2024-12-04
1268	2022	21400	118300	139700	2024-12-04
1269	2025	184700	232400	417100	2024-12-04
1269	2023	184700	232400	417100	2024-12-04
1269	2022	184700	232400	417100	2024-12-04
1270	2025	0	5200	5200	2024-12-04
1270	2023	0	5200	5200	2024-12-04
1270	2022	0	5200	5200	2024-12-04
1271	2025	312500	150800	463300	2024-12-04
1271	2023	312500	150800	463300	2024-12-04
1271	2022	312500	150800	463300	2024-12-04
1272	2025	389400	369100	758500	2024-12-04
1272	2023	389400	369100	758500	2024-12-04
1272	2022	389400	369100	758500	2024-12-04
1274	2025	305400	168100	473500	2024-12-04
1274	2023	305400	168100	473500	2024-12-04
1274	2022	312200	168100	480300	2024-12-04
1277	2025	0	294200	294200	2024-12-04
1277	2023	0	294200	294200	2024-12-04
1277	2022	0	294200	294200	2024-12-04
1282	2025	0	304600	304600	2024-12-04
1282	2023	0	304600	304600	2024-12-04
1282	2022	0	304600	304600	2024-12-04
1289	2025	0	181900	181900	2024-12-04
1289	2023	0	181900	181900	2024-12-04
1289	2022	0	181900	181900	2024-12-04
1291	2025	0	33700	33700	2024-12-04
1291	2023	0	33700	33700	2024-12-04
1291	2022	0	33700	33700	2024-12-04
1292	2025	0	186800	186800	2024-12-04
1292	2023	0	186800	186800	2024-12-04
1292	2022	0	186800	186800	2024-12-04
1298	2025	1015500	308700	1324200	2024-12-04
1298	2023	1015500	308700	1324200	2024-12-04
1298	2022	1014200	308700	1322900	2024-12-04
1299	2025	334900	124400	459300	2024-12-04
1299	2023	334900	124400	459300	2024-12-04
1299	2022	329400	124400	453800	2024-12-04
1302	2025	0	191600	191600	2024-12-04
1302	2023	0	191600	191600	2024-12-04
1302	2022	0	191600	191600	2024-12-04
1304	2025	830300	1532600	2362900	2024-12-04
1304	2023	830300	1532600	2362900	2024-12-04
1304	2022	830300	1532600	2362900	2024-12-04
1305	2025	3697300	337000	4034300	2024-12-04
1305	2023	3697300	337000	4034300	2024-12-04
1305	2022	3697300	337000	4034300	2024-12-04
1309	2025	0	198000	198000	2024-12-04
1309	2023	0	198000	198000	2024-12-04
1309	2022	0	198000	198000	2024-12-04
1311	2025	441600	237500	679100	2024-12-04
1311	2023	441600	237500	679100	2024-12-04
1311	2022	441600	237500	679100	2024-12-04
1312	2025	0	778800	778800	2024-12-04
1312	2023	0	778800	778800	2024-12-04
1312	2022	0	778800	778800	2024-12-04
1313	2025	266300	187800	454100	2024-12-04
1313	2023	266300	187800	454100	2024-12-04
1313	2022	241900	187800	429700	2024-12-04
1319	2025	5700	193700	199400	2024-12-04
1319	2023	5700	193700	199400	2024-12-04
1319	2022	5700	193700	199400	2024-12-04
1323	2025	405400	163300	568700	2024-12-04
1323	2023	405400	163300	568700	2024-12-04
1323	2022	402700	163300	566000	2024-12-04
1325	2025	239400	252600	492000	2024-12-04
1325	2023	224400	252600	477000	2024-12-04
1325	2022	207200	252600	459800	2024-12-04
1326	2025	788400	402300	1190700	2024-12-04
1326	2023	788400	402300	1190700	2024-12-04
1326	2022	780700	402300	1183000	2024-12-04
1327	2025	0	435200	435200	2024-12-04
1327	2023	0	435200	435200	2024-12-04
1327	2022	0	435200	435200	2024-12-04
1332	2025	0	48800	48800	2024-12-04
1332	2023	0	48800	48800	2024-12-04
1332	2022	0	48800	48800	2024-12-04
1333	2025	527300	330300	857600	2024-12-04
1333	2023	527300	330300	857600	2024-12-04
1333	2022	527300	330300	857600	2024-12-04
1335	2025	308200	254700	562900	2024-12-04
1335	2023	308200	254700	562900	2024-12-04
1335	2022	307900	254700	562600	2024-12-04
1336	2025	0	259300	259300	2024-12-04
1336	2023	0	259300	259300	2024-12-04
1336	2022	0	259300	259300	2024-12-04
1337	2025	0	253000	253000	2024-12-04
1337	2023	0	253000	253000	2024-12-04
1337	2022	0	253000	253000	2024-12-04
1338	2025	547800	204400	752200	2024-12-04
1338	2023	547800	204400	752200	2024-12-04
1338	2022	546500	204400	750900	2024-12-04
1340	2025	225000	195500	420500	2024-12-04
1340	2023	225000	195500	420500	2024-12-04
1340	2022	225000	195500	420500	2024-12-04
1341	2025	632100	202500	834600	2024-12-04
1341	2023	632100	202500	834600	2024-12-04
1341	2022	644800	202500	847300	2024-12-04
1342	2025	456000	230800	686800	2024-12-04
1342	2023	456000	230800	686800	2024-12-04
1342	2022	456000	230800	686800	2024-12-04
1343	2025	104100	198500	302600	2024-12-04
1343	2023	104100	198500	302600	2024-12-04
1343	2022	100700	198500	299200	2024-12-04
1344	2025	544800	1101700	1646500	2024-12-04
1344	2023	544800	1101700	1646500	2024-12-04
1344	2022	518400	1101700	1620100	2024-12-04
1352	2025	310500	456900	767400	2024-12-04
1352	2023	310500	456900	767400	2024-12-04
1352	2022	280600	456900	737500	2024-12-04
1353	2025	725400	336300	1061700	2024-12-04
1353	2023	725400	336300	1061700	2024-12-04
1353	2022	716800	336300	1053100	2024-12-04
1354	2025	328100	423800	751900	2024-12-04
1354	2023	328100	423800	751900	2024-12-04
1354	2022	328100	423800	751900	2024-12-04
1355	2025	0	251200	251200	2024-12-04
1355	2023	0	251200	251200	2024-12-04
1355	2022	0	251200	251200	2024-12-04
1356	2025	0	2464300	2464300	2024-12-04
1356	2023	0	2464300	2464300	2024-12-04
1356	2022	0	2464300	2464300	2024-12-04
1358	2025	0	30700	30700	2024-12-04
1358	2023	0	30700	30700	2024-12-04
1358	2022	0	30700	30700	2024-12-04
1360	2025	0	228600	228600	2024-12-04
1360	2023	0	228600	228600	2024-12-04
1360	2022	0	228600	228600	2024-12-04
1361	2025	0	142400	142400	2024-12-04
1361	2023	0	142400	142400	2024-12-04
1361	2022	0	142400	142400	2024-12-04
1362	2025	0	96100	96100	2024-12-04
1362	2023	0	96100	96100	2024-12-04
1362	2022	0	96100	96100	2024-12-04
1363	2025	0	89400	89400	2024-12-04
1363	2023	0	89400	89400	2024-12-04
1363	2022	0	89400	89400	2024-12-04
1364	2025	0	221800	221800	2024-12-04
1364	2023	0	221800	221800	2024-12-04
1364	2022	0	221800	221800	2024-12-04
1365	2025	0	29900	29900	2024-12-04
1365	2023	0	29900	29900	2024-12-04
1365	2022	0	29900	29900	2024-12-04
1366	2025	0	208500	208500	2024-12-04
1366	2023	0	208500	208500	2024-12-04
1366	2022	0	208500	208500	2024-12-04
1367	2025	1900	207700	209600	2024-12-04
1367	2023	1900	207700	209600	2024-12-04
1367	2022	1900	207700	209600	2024-12-04
1373	2025	969500	628900	1598400	2024-12-04
1373	2023	969500	628900	1598400	2024-12-04
1373	2022	970800	628900	1599700	2024-12-04
1374	2025	308300	225400	533700	2024-12-04
1374	2023	271300	225400	496700	2024-12-04
1374	2022	271300	225400	496700	2024-12-04
1375	2025	1454000	1846700	3300700	2024-12-04
1375	2023	1454000	1846700	3300700	2024-12-04
1375	2022	1454000	1846700	3300700	2024-12-04
1379	2025	0	144500	144500	2024-12-04
1379	2023	0	144500	144500	2024-12-04
1379	2022	0	144500	144500	2024-12-04
1382	2025	630500	345400	975900	2024-12-04
1382	2023	630500	345400	975900	2024-12-04
1382	2022	613200	345400	958600	2024-12-04
1384	2025	644500	589900	1234400	2024-12-04
1384	2023	644500	589900	1234400	2024-12-04
1384	2022	633900	589900	1223800	2024-12-04
1385	2025	485800	282700	768500	2024-12-04
1385	2023	485800	282700	768500	2024-12-04
1385	2022	485800	282700	768500	2024-12-04
1386	2025	800900	729700	1530600	2024-12-04
1386	2023	800900	729700	1530600	2024-12-04
1386	2022	800900	729700	1530600	2024-12-04
1387	2025	0	356000	356000	2024-12-04
1387	2023	0	356000	356000	2024-12-04
1387	2022	0	356000	356000	2024-12-04
1388	2025	0	264000	264000	2024-12-04
1388	2023	0	264000	264000	2024-12-04
1388	2022	0	264000	264000	2024-12-04
1389	2025	159400	199100	358500	2024-12-04
1389	2023	159400	206300	365700	2024-12-04
1389	2022	159400	206300	365700	2024-12-04
1394	2025	0	166300	166300	2024-12-04
1394	2023	0	166300	166300	2024-12-04
1394	2022	0	166300	166300	2024-12-04
1399	2025	0	61600	61600	2024-12-04
1399	2023	0	61600	61600	2024-12-04
1399	2022	0	61600	61600	2024-12-04
1400	2025	0	93700	93700	2024-12-04
1400	2023	0	93700	93700	2024-12-04
1400	2022	0	93700	93700	2024-12-04
1401	2025	0	49300	49300	2024-12-04
1401	2023	0	49300	49300	2024-12-04
1401	2022	0	49300	49300	2024-12-04
1402	2025	0	305600	305600	2024-12-04
1402	2023	0	305600	305600	2024-12-04
1402	2022	0	305600	305600	2024-12-04
1403	2025	0	8500	8500	2024-12-04
1403	2023	0	8500	8500	2024-12-04
1403	2022	0	8500	8500	2024-12-04
1406	2025	694100	684800	1378900	2024-12-04
1406	2023	694100	684800	1378900	2024-12-04
1406	2022	703700	684800	1388500	2024-12-04
1410	2025	165400	192800	358200	2024-12-04
1410	2023	165400	192800	358200	2024-12-04
1410	2022	165400	192800	358200	2024-12-04
1412	2025	105000	206900	311900	2024-12-04
1412	2023	105000	206900	311900	2024-12-04
1412	2022	105000	206900	311900	2024-12-04
1413	2025	0	86600	86600	2024-12-04
1413	2023	0	86600	86600	2024-12-04
1413	2022	0	86600	86600	2024-12-04
1417	2025	0	345400	345400	2024-12-04
1417	2023	0	345400	345400	2024-12-04
1417	2022	0	345400	345400	2024-12-04
1423	2025	0	342200	342200	2024-12-04
1423	2023	0	342200	342200	2024-12-04
1423	2022	0	342200	342200	2024-12-04
1435	2025	0	88300	88300	2024-12-04
1435	2023	0	88300	88300	2024-12-04
1435	2022	0	88300	88300	2024-12-04
1436	2025	0	57100	57100	2024-12-04
1436	2023	0	57100	57100	2024-12-04
1436	2022	0	57100	57100	2024-12-04
1437	2025	0	183500	183500	2024-12-04
1437	2023	0	183500	183500	2024-12-04
1437	2022	0	183500	183500	2024-12-04
1438	2025	0	177200	177200	2024-12-04
1438	2023	0	177200	177200	2024-12-04
1438	2022	0	177200	177200	2024-12-04
1439	2025	0	85000	85000	2024-12-04
1439	2023	0	85000	85000	2024-12-04
1439	2022	0	85000	85000	2024-12-04
1440	2025	0	404400	404400	2024-12-04
1440	2023	0	404400	404400	2024-12-04
1440	2022	0	404400	404400	2024-12-04
1441	2025	0	7500	7500	2024-12-04
1441	2023	0	7500	7500	2024-12-04
1441	2022	0	7500	7500	2024-12-04
1442	2025	0	10900	10900	2024-12-04
1442	2023	0	10900	10900	2024-12-04
1442	2022	0	10900	10900	2024-12-04
1443	2025	0	589400	589400	2024-12-04
1443	2023	0	589400	589400	2024-12-04
1443	2022	0	589400	589400	2024-12-04
1446	2025	0	630500	630500	2024-12-04
1446	2023	0	630500	630500	2024-12-04
1446	2022	0	630500	630500	2024-12-04
1447	2025	200	269800	270000	2024-12-04
1447	2023	200	269800	270000	2024-12-04
1447	2022	200	269800	270000	2024-12-04
1448	2025	0	282000	282000	2024-12-04
1448	2023	0	282000	282000	2024-12-04
1448	2022	0	282000	282000	2024-12-04
1449	2025	60900	274900	335800	2024-12-04
1449	2023	60900	274900	335800	2024-12-04
1449	2022	60700	274900	335600	2024-12-04
1450	2025	20000	73200	93200	2024-12-04
1450	2023	20000	73200	93200	2024-12-04
1450	2022	18900	73200	92100	2024-12-04
1451	2025	110600	145500	256100	2024-12-04
1451	2023	110600	145500	256100	2024-12-04
1451	2022	109100	145500	254600	2024-12-04
1455	2025	224900	230900	455800	2024-12-04
1455	2023	224900	230900	455800	2024-12-04
1455	2022	224900	230900	455800	2024-12-04
1456	2025	16800	173700	190500	2024-12-04
1456	2023	16800	173700	190500	2024-12-04
1456	2022	18300	173700	192000	2024-12-04
1457	2025	123900	159100	283000	2024-12-04
1457	2023	123900	159100	283000	2024-12-04
1457	2022	122000	159100	281100	2024-12-04
1462	2025	301600	439000	740600	2024-12-04
1462	2023	301600	439000	740600	2024-12-04
1462	2022	316800	439000	755800	2024-12-04
1464	2025	0	138700	138700	2024-12-04
1464	2023	0	138700	138700	2024-12-04
1464	2022	0	138700	138700	2024-12-04
1466	2025	0	368800	368800	2024-12-04
1466	2023	0	368800	368800	2024-12-04
1466	2022	0	368800	368800	2024-12-04
1468	2025	281600	366800	648400	2024-12-04
1468	2023	281600	366800	648400	2024-12-04
1468	2022	280800	366800	647600	2024-12-04
1469	2025	0	75600	75600	2024-12-04
1469	2023	0	75600	75600	2024-12-04
1469	2022	0	75600	75600	2024-12-04
1471	2025	12900	165800	178700	2024-12-04
1471	2023	12900	165800	178700	2024-12-04
1471	2022	13000	165800	178800	2024-12-04
1472	2025	59200	236400	295600	2024-12-04
1472	2023	59200	236400	295600	2024-12-04
1472	2022	56000	236400	292400	2024-12-04
1473	2025	167300	320800	488100	2024-12-04
1473	2023	167300	320800	488100	2024-12-04
1473	2022	163200	320800	484000	2024-12-04
1475	2025	72800	275600	348400	2024-12-04
1475	2023	72800	275600	348400	2024-12-04
1475	2022	64200	275600	339800	2024-12-04
1477	2025	94400	139000	233400	2024-12-04
1477	2023	94400	139000	233400	2024-12-04
1477	2022	94400	139000	233400	2024-12-04
1484	2025	114700	166100	280800	2024-12-04
1484	2023	114700	166100	280800	2024-12-04
1484	2022	105200	166100	271300	2024-12-04
1485	2025	152700	201200	353900	2024-12-04
1485	2023	152700	201200	353900	2024-12-04
1485	2022	152700	201200	353900	2024-12-04
1486	2025	276300	350100	626400	2024-12-04
1486	2023	276300	350100	626400	2024-12-04
1486	2022	270400	350100	620500	2024-12-04
1488	2025	0	332900	332900	2024-12-04
1488	2023	0	332900	332900	2024-12-04
1488	2022	0	332900	332900	2024-12-04
1489	2025	0	459000	459000	2024-12-04
1489	2023	0	459000	459000	2024-12-04
1489	2022	0	459000	459000	2024-12-04
100000	2025	765900	240800	1006700	2024-12-04
100000	2023	765900	240800	1006700	2024-12-04
100000	2022	765900	240800	1006700	2024-12-04
100021	2025	1143000	520300	1663300	2024-12-04
100021	2023	1128800	520300	1649100	2024-12-04
100021	2022	1128800	520300	1649100	2024-12-04
100041	2025	0	338400	338400	2024-12-04
100041	2023	0	338400	338400	2024-12-04
100041	2022	0	338400	338400	2024-12-04
100103	2025	234700	229200	463900	2024-12-04
100103	2023	234700	229200	463900	2024-12-04
100103	2022	234700	229200	463900	2024-12-04
100122	2025	386900	280400	667300	2024-12-04
100122	2023	386900	280400	667300	2024-12-04
100122	2022	386900	280400	667300	2024-12-04
100142	2025	217500	0	217500	2024-12-04
100142	2023	217500	0	217500	2024-12-04
100142	2022	217500	0	217500	2024-12-04
100162	2025	217500	0	217500	2024-12-04
100162	2023	217500	0	217500	2024-12-04
100162	2022	217500	0	217500	2024-12-04
100163	2025	251600	0	251600	2024-12-04
100163	2023	251600	0	251600	2024-12-04
100163	2022	251600	0	251600	2024-12-04
100164	2025	244700	0	244700	2024-12-04
100164	2023	244700	0	244700	2024-12-04
100164	2022	244700	0	244700	2024-12-04
100182	2025	377100	0	377100	2024-12-04
100182	2023	377100	0	377100	2024-12-04
100182	2022	377100	0	377100	2024-12-04
100184	2025	349600	0	349600	2024-12-04
100184	2023	349600	0	349600	2024-12-04
100184	2022	349600	0	349600	2024-12-04
100202	2025	0	848400	848400	2024-12-04
100202	2023	0	848400	848400	2024-12-04
100202	2022	0	848400	848400	2024-12-04
100243	2025	478200	229900	708100	2024-12-04
100243	2023	478200	229900	708100	2024-12-04
100243	2022	478200	229900	708100	2024-12-04
100262	2025	841700	257900	1099600	2024-12-04
100262	2023	841700	257900	1099600	2024-12-04
100262	2022	826700	257900	1084600	2024-12-04
100263	2025	629900	202300	832200	2024-12-04
100263	2023	609800	202300	812100	2024-12-04
100263	2022	609800	202300	812100	2024-12-04
100264	2025	0	208200	208200	2024-12-04
100264	2023	0	208200	208200	2024-12-04
100264	2022	0	208200	208200	2024-12-04
100265	2025	431900	203100	635000	2024-12-04
100265	2023	431900	203100	635000	2024-12-04
100265	2022	431900	203100	635000	2024-12-04
100282	2025	599400	190100	789500	2024-12-04
100282	2023	557500	190100	747600	2024-12-04
100282	2022	545900	190100	736000	2024-12-04
100302	2025	263600	206300	469900	2024-12-04
100302	2023	263600	206300	469900	2024-12-04
100302	2022	263600	206300	469900	2024-12-04
100322	2025	0	77200	77200	2024-12-04
100322	2023	0	77200	77200	2024-12-04
100322	2022	0	77200	77200	2024-12-04
100361	2025	0	83150	83150	2024-12-04
100361	2023	0	83150	83150	2024-12-04
100361	2022	0	83150	83150	2024-12-04
100401	2025	0	315200	315200	2024-12-04
100401	2023	0	315200	315200	2024-12-04
100401	2022	0	315200	315200	2024-12-04
100422	2025	451200	0	451200	2024-12-04
100422	2023	451200	0	451200	2024-12-04
100422	2022	451200	0	451200	2024-12-04
100442	2025	387700	0	387700	2024-12-04
100442	2023	387700	0	387700	2024-12-04
100442	2022	387700	0	387700	2024-12-04
100462	2025	204700	0	204700	2024-12-04
100462	2023	204700	0	204700	2024-12-04
100462	2022	204700	0	204700	2024-12-04
100463	2025	398200	0	398200	2024-12-04
100463	2023	398200	0	398200	2024-12-04
100463	2022	398200	0	398200	2024-12-04
100482	2025	212900	0	212900	2024-12-04
100482	2023	212900	0	212900	2024-12-04
100482	2022	212900	0	212900	2024-12-04
100502	2025	421200	0	421200	2024-12-04
100502	2023	421200	0	421200	2024-12-04
100502	2022	421200	0	421200	2024-12-04
100503	2025	261900	0	261900	2024-12-04
100503	2023	261900	0	261900	2024-12-04
100503	2022	261900	0	261900	2024-12-04
100522	2025	184400	0	184400	2024-12-04
100522	2023	184400	0	184400	2024-12-04
100522	2022	184400	0	184400	2024-12-04
100523	2025	332100	0	332100	2024-12-04
100523	2023	332100	0	332100	2024-12-04
100523	2022	332100	0	332100	2024-12-04
100542	2025	473800	0	473800	2024-12-04
100542	2023	473800	0	473800	2024-12-04
100542	2022	473800	0	473800	2024-12-04
100543	2025	543400	0	543400	2024-12-04
100543	2023	543400	0	543400	2024-12-04
100543	2022	543400	0	543400	2024-12-04
100562	2025	427400	0	427400	2024-12-04
100562	2023	427400	0	427400	2024-12-04
100562	2022	427400	0	427400	2024-12-04
100563	2025	340300	0	340300	2024-12-04
100563	2023	340300	0	340300	2024-12-04
100563	2022	340300	0	340300	2024-12-04
100582	2025	385200	0	385200	2024-12-04
100582	2023	385200	0	385200	2024-12-04
100582	2022	385200	0	385200	2024-12-04
100583	2025	3773000	0	3773000	2024-12-04
100583	2023	1848200	0	1848200	2024-12-04
100583	2022	1848200	0	1848200	2024-12-04
100602	2025	0	92900	92900	2024-12-04
100602	2023	0	92900	92900	2024-12-04
100602	2022	0	92900	92900	2024-12-04
100622	2025	0	54500	54500	2024-12-04
100622	2023	0	54500	54500	2024-12-04
100622	2022	0	54500	54500	2024-12-04
100642	2025	0	33000	33000	2024-12-04
100642	2023	0	33000	33000	2024-12-04
100642	2022	0	33000	33000	2024-12-04
100662	2025	0	354300	354300	2024-12-04
100662	2023	0	354300	354300	2024-12-04
100662	2022	0	354300	354300	2024-12-04
100722	2025	374200	176700	550900	2024-12-04
100722	2023	374200	176700	550900	2024-12-04
100722	2022	374200	176700	550900	2024-12-04
100742	2025	704200	317100	1021300	2024-12-04
100742	2023	674200	317100	991300	2024-12-04
100742	2022	674200	317100	991300	2024-12-04
100822	2025	159600	633500	793100	2024-12-04
100822	2023	147600	709000	856600	2024-12-04
100822	2022	147600	633900	781500	2024-12-04
100863	2025	162900	104400	267300	2024-12-04
100863	2023	162900	104400	267300	2024-12-04
100863	2022	162900	104400	267300	2024-12-04
101082	2025	0	179500	179500	2024-12-04
101082	2023	0	179500	179500	2024-12-04
101082	2022	0	179500	179500	2024-12-04
101143	2025	531300	268600	799900	2024-12-04
101143	2023	531300	268600	799900	2024-12-04
101143	2022	531300	268600	799900	2024-12-04
101162	2025	273300	253100	526400	2024-12-04
101162	2023	273300	253100	526400	2024-12-04
101162	2022	273300	253100	526400	2024-12-04
101182	2025	457000	332800	789800	2024-12-04
101182	2023	457000	332800	789800	2024-12-04
101182	2022	457000	332800	789800	2024-12-04
101183	2025	0	65400	65400	2024-12-04
101183	2023	0	65400	65400	2024-12-04
101183	2022	0	65400	65400	2024-12-04
101202	2025	0	231200	231200	2024-12-04
101202	2023	0	231200	231200	2024-12-04
101202	2022	0	231200	231200	2024-12-04
101203	2025	0	244300	244300	2024-12-04
101203	2023	0	244300	244300	2024-12-04
101203	2022	0	244300	244300	2024-12-04
101204	2025	0	206800	206800	2024-12-04
101204	2023	0	206800	206800	2024-12-04
101204	2022	0	206800	206800	2024-12-04
101205	2025	0	213100	213100	2024-12-04
101205	2023	0	213100	213100	2024-12-04
101205	2022	0	213100	213100	2024-12-04
101224	2025	521700	249600	771300	2024-12-04
101224	2023	521700	249600	771300	2024-12-04
101224	2022	521700	249600	771300	2024-12-04
101242	2025	660000	249300	909300	2024-12-04
101242	2023	660000	249300	909300	2024-12-04
101242	2022	660000	249300	909300	2024-12-04
101243	2025	621200	221300	842500	2024-12-04
101243	2023	621200	221300	842500	2024-12-04
101243	2022	621200	221300	842500	2024-12-04
101262	2025	413400	243800	657200	2024-12-04
101262	2023	408800	243800	652600	2024-12-04
101262	2022	408800	243800	652600	2024-12-04
101282	2025	384200	458200	842400	2024-12-04
101282	2023	384200	458200	842400	2024-12-04
101282	2022	384200	458200	842400	2024-12-04
101325	2025	711400	454300	1165700	2024-12-04
101325	2023	666300	454300	1120600	2024-12-04
101325	2022	628800	454300	1083100	2024-12-04
101342	2025	812300	754500	1566800	2024-12-04
101342	2023	812300	754500	1566800	2024-12-04
101342	2022	812300	754500	1566800	2024-12-04
101362	2025	444400	258900	703300	2024-12-04
101362	2023	444400	258900	703300	2024-12-04
101362	2022	444400	258900	703300	2024-12-04
101382	2025	253400	228800	482200	2024-12-04
101382	2023	244600	228800	473400	2024-12-04
101382	2022	244600	228800	473400	2024-12-04
101442	2025	3500	400400	403900	2024-12-04
101442	2023	3500	400400	403900	2024-12-04
101442	2022	3500	400400	403900	2024-12-04
101462	2025	926800	191100	1117900	2024-12-04
101462	2023	926800	191100	1117900	2024-12-04
101462	2022	926800	191100	1117900	2024-12-04
101483	2025	200	144400	144600	2024-12-04
101483	2023	200	144400	144600	2024-12-04
101483	2022	200	144400	144600	2024-12-04
101502	2025	0	13400	13400	2024-12-04
101502	2023	0	13400	13400	2024-12-04
101502	2022	0	13400	13400	2024-12-04
101523	2025	319000	277400	596400	2024-12-04
101523	2023	319000	277400	596400	2024-12-04
101523	2022	319000	277400	596400	2024-12-04
101542	2025	203700	1088400	1292100	2024-12-04
101542	2023	203700	1088400	1292100	2024-12-04
101542	2022	203700	1088400	1292100	2024-12-04
101562	2025	900	379100	380000	2024-12-04
101562	2023	900	379100	380000	2024-12-04
101562	2022	900	379100	380000	2024-12-04
101582	2025	0	118800	118800	2024-12-04
101582	2023	0	118800	118800	2024-12-04
101582	2022	0	118800	118800	2024-12-04
101602	2025	243200	0	243200	2024-12-04
101602	2023	243200	0	243200	2024-12-04
101602	2022	243200	0	243200	2024-12-04
101622	2025	365500	174600	540100	2024-12-04
101622	2023	365500	174600	540100	2024-12-04
101622	2022	344800	174600	519400	2024-12-04
101642	2025	281900	144800	426700	2024-12-04
101642	2023	281900	144800	426700	2024-12-04
101642	2022	281900	144800	426700	2024-12-04
102644	2025	6300	141500	147800	2024-12-04
102644	2023	6300	141500	147800	2024-12-04
102644	2022	6300	141500	147800	2024-12-04
102691	2025	793000	474000	1267000	2024-12-04
102691	2023	793000	474000	1267000	2024-12-04
102691	2022	791100	474000	1265100	2024-12-04
102692	2025	645600	228300	873900	2024-12-04
102692	2023	645600	228300	873900	2024-12-04
102692	2022	645300	228300	873600	2024-12-04
102712	2025	11100	246900	258000	2024-12-04
102712	2023	11100	246900	258000	2024-12-04
102712	2022	11100	246900	258000	2024-12-04
102732	2025	36300	69300	105600	2024-12-04
102732	2023	36300	69300	105600	2024-12-04
102732	2022	36300	69300	105600	2024-12-04
102736	2025	431400	267000	698400	2024-12-04
102736	2023	425900	267000	692900	2024-12-04
102736	2022	425900	267000	692900	2024-12-04
102737	2025	672900	368500	1041400	2024-12-04
102737	2023	672900	368500	1041400	2024-12-04
102737	2022	672900	368500	1041400	2024-12-04
102759	2025	0	20100	20100	2024-12-04
102759	2023	0	20100	20100	2024-12-04
102759	2022	0	20100	20100	2024-12-04
102763	2025	0	331000	331000	2024-12-04
102763	2023	0	324900	324900	2024-12-04
102763	2022	0	324900	324900	2024-12-04
102766	2025	206700	174300	381000	2024-12-04
102766	2023	205000	174300	379300	2024-12-04
102766	2022	171800	174300	346100	2024-12-04
102768	2025	0	109300	109300	2024-12-04
102768	2023	0	109300	109300	2024-12-04
102768	2022	0	109300	109300	2024-12-04
102770	2025	692600	356200	1048800	2024-12-04
102770	2023	692600	356200	1048800	2024-12-04
102770	2022	632600	356200	988800	2024-12-04
102771	2025	155400	136800	292200	2024-12-04
102771	2023	155400	136800	292200	2024-12-04
102771	2022	155400	136800	292200	2024-12-04
102772	2025	0	519500	519500	2024-12-04
102772	2023	0	519500	519500	2024-12-04
102772	2022	0	519500	519500	2024-12-04
102814	2025	49000	342900	391900	2024-12-04
102814	2023	49000	342900	391900	2024-12-04
102814	2022	49000	342900	391900	2024-12-04
102815	2025	0	126900	126900	2024-12-04
102815	2023	0	126900	126900	2024-12-04
102815	2022	0	126900	126900	2024-12-04
102834	2025	902600	522500	1425100	2024-12-04
102834	2023	892800	522500	1415300	2024-12-04
102834	2022	860200	522500	1382700	2024-12-04
102854	2025	67300	91400	158700	2024-12-04
102854	2023	67300	91400	158700	2024-12-04
102854	2022	67300	91400	158700	2024-12-04
102874	2025	0	207500	207500	2024-12-04
102874	2023	0	207500	207500	2024-12-04
102874	2022	0	207500	207500	2024-12-04
102875	2025	0	848300	848300	2024-12-04
102875	2023	0	848300	848300	2024-12-04
102875	2022	0	848300	848300	2024-12-04
102876	2025	0	327900	327900	2024-12-04
102876	2023	0	327900	327900	2024-12-04
102876	2022	0	327900	327900	2024-12-04
102896	2025	400300	262100	662400	2024-12-04
102896	2023	215600	215000	430600	2024-12-04
102896	2022	0	206700	206700	2024-12-04
102897	2025	72500	280300	352800	2024-12-04
102897	2023	72500	280300	352800	2024-12-04
102897	2022	72500	280300	352800	2024-12-04
102916	2025	0	294700	294700	2024-12-04
102916	2023	0	294700	294700	2024-12-04
102916	2022	0	294700	294700	2024-12-04
102937	2025	5100	0	5100	2024-12-04
102937	2023	5100	0	5100	2024-12-04
102937	2022	5700	0	5700	2024-12-04
102956	2025	0	237100	237100	2024-12-04
102956	2023	0	237100	237100	2024-12-04
102956	2022	0	237100	237100	2024-12-04
102976	2025	37100	465700	502800	2024-12-04
102976	2023	37100	465700	502800	2024-12-04
102976	2022	37100	465700	502800	2024-12-04
102996	2025	0	443800	443800	2024-12-04
102996	2023	0	443800	443800	2024-12-04
102996	2022	0	443800	443800	2024-12-04
103016	2025	34800	299900	334700	2024-12-04
103016	2023	34800	299900	334700	2024-12-04
103016	2022	34800	299900	334700	2024-12-04
103036	2025	0	369500	369500	2024-12-04
103036	2023	0	369500	369500	2024-12-04
103036	2022	0	369500	369500	2024-12-04
103057	2025	327800	330000	657800	2024-12-04
103057	2023	327800	330000	657800	2024-12-04
103057	2022	327800	330000	657800	2024-12-04
103079	2025	0	218500	218500	2024-12-04
103079	2023	0	218500	218500	2024-12-04
103079	2022	0	218500	218500	2024-12-04
103097	2025	0	49900	49900	2024-12-04
103097	2023	0	49900	49900	2024-12-04
103097	2022	0	49900	49900	2024-12-04
103117	2025	37000	44500	81500	2024-12-04
103117	2023	37000	44500	81500	2024-12-04
103117	2022	37000	44500	81500	2024-12-04
103137	2025	50000	0	50000	2024-12-04
103137	2023	50000	0	50000	2024-12-04
103137	2022	50000	0	50000	2024-12-04
103157	2025	0	218000	218000	2024-12-04
103157	2023	0	218000	218000	2024-12-04
103157	2022	0	218000	218000	2024-12-04
103178	2025	33600	88000	121600	2024-12-04
103178	2023	33600	88000	121600	2024-12-04
103178	2022	33600	88000	121600	2024-12-04
103197	2025	241800	0	241800	2024-12-04
103197	2023	227700	0	227700	2024-12-04
103197	2022	60000	0	60000	2024-12-04
103218	2025	214200	0	214200	2024-12-04
103218	2023	236500	0	236500	2024-12-04
103218	2022	401300	0	401300	2024-12-04
103220	2025	0	1500	1500	2024-12-04
103220	2023	0	1500	1500	2024-12-04
103220	2022	0	1500	1500	2024-12-04
103222	2025	0	223800	223800	2024-12-04
103222	2023	0	223800	223800	2024-12-04
103222	2022	0	223800	223800	2024-12-04
103224	2025	251200	0	251200	2024-12-04
103224	2023	251200	0	251200	2024-12-04
103224	2022	350700	0	350700	2024-12-04
103225	2025	63700	0	63700	2024-12-04
103225	2023	63700	0	63700	2024-12-04
103225	2022	148500	0	148500	2024-12-04
103226	2025	108500	0	108500	2024-12-04
103226	2023	108500	0	108500	2024-12-04
103226	2022	175000	0	175000	2024-12-04
103227	2025	79200	0	79200	2024-12-04
103227	2023	79200	0	79200	2024-12-04
103227	2022	144800	0	144800	2024-12-04
103228	2025	73200	0	73200	2024-12-04
103228	2023	73200	0	73200	2024-12-04
103228	2022	138900	0	138900	2024-12-04
103229	2025	72500	0	72500	2024-12-04
103229	2023	72500	0	72500	2024-12-04
103229	2022	138000	0	138000	2024-12-04
103230	2025	85500	0	85500	2024-12-04
103230	2023	85500	0	85500	2024-12-04
103230	2022	152100	0	152100	2024-12-04
103233	2025	74900	0	74900	2024-12-04
103233	2023	74900	0	74900	2024-12-04
103233	2022	141100	0	141100	2024-12-04
103237	2025	74900	0	74900	2024-12-04
103237	2023	74900	0	74900	2024-12-04
103237	2022	141000	0	141000	2024-12-04
103238	2025	72800	0	72800	2024-12-04
103238	2023	72800	0	72800	2024-12-04
103238	2022	131100	0	131100	2024-12-04
103239	2025	78800	0	78800	2024-12-04
103239	2023	78800	0	78800	2024-12-04
103239	2022	146200	0	146200	2024-12-04
103240	2025	79700	0	79700	2024-12-04
103240	2023	79700	0	79700	2024-12-04
103240	2022	147300	0	147300	2024-12-04
103242	2025	72700	0	72700	2024-12-04
103242	2023	72700	0	72700	2024-12-04
103242	2022	143100	0	143100	2024-12-04
103243	2025	78200	0	78200	2024-12-04
103243	2023	78200	0	78200	2024-12-04
103243	2022	145400	0	145400	2024-12-04
103244	2025	74600	0	74600	2024-12-04
103244	2023	74600	0	74600	2024-12-04
103244	2022	140800	0	140800	2024-12-04
103245	2025	90300	0	90300	2024-12-04
103245	2023	90300	0	90300	2024-12-04
103245	2022	161100	0	161100	2024-12-04
103246	2025	73900	0	73900	2024-12-04
103246	2023	73900	0	73900	2024-12-04
103246	2022	139800	0	139800	2024-12-04
103247	2025	73900	0	73900	2024-12-04
103247	2023	73900	0	73900	2024-12-04
103247	2022	139800	0	139800	2024-12-04
103248	2025	86300	0	86300	2024-12-04
103248	2023	86300	0	86300	2024-12-04
103248	2022	155900	0	155900	2024-12-04
103249	2025	75800	0	75800	2024-12-04
103249	2023	75800	0	75800	2024-12-04
103249	2022	141600	0	141600	2024-12-04
103250	2025	88600	0	88600	2024-12-04
103250	2023	88600	0	88600	2024-12-04
103250	2022	158900	0	158900	2024-12-04
103251	2025	31300	0	31300	2024-12-04
103251	2023	31300	0	31300	2024-12-04
103251	2022	144800	0	144800	2024-12-04
103252	2025	263900	170100	434000	2024-12-04
103252	2023	102100	140400	242500	2024-12-04
103253	2025	0	12400	12400	2024-12-04
103253	2023	0	12400	12400	2024-12-04
103254	2025	33800	154800	188600	2024-12-04
103254	2023	33800	154800	188600	2024-12-04
103255	2025	0	151400	151400	2024-12-04
103255	2023	0	151400	151400	2024-12-04
103257	2025	0	137900	137900	2024-12-04
103257	2023	0	137900	137900	2024-12-04
103258	2025	439400	0	439400	2024-12-04
103259	2025	439400	0	439400	2024-12-04
103260	2025	422700	0	422700	2024-12-04
103261	2025	438300	0	438300	2024-12-04
103262	2025	374900	0	374900	2024-12-04
103265	No Data for PID				2024-12-04
