					
10	2020	254100	125900	380000	2023-02-01
10	2021	254100	163000	417100	2023-02-01
10	2022	254100	163000	417100	2023-02-01
10	2023	254100	163000	417100	2023-12-18
100000	2020	681800	174100	855900	2023-02-01
100000	2021	765900	167200	933100	2023-02-01
100000	2022	765900	167200	933100	2023-02-01
100000	2023	765900	167200	933100	2023-12-18
100021	2020	1046600	280100	1326700	2023-02-01
100021	2021	1128800	230900	1359700	2023-02-01
100021	2022	1128800	230900	1359700	2023-02-01
100021	2023	1128800	230600	1359400	2023-12-18
100041	2020	0	8800	8800	2023-02-01
100041	2021	0	8800	8800	2023-02-01
100041	2022	0	8800	8800	2023-02-01
100041	2023	0	8800	8800	2023-12-18
100103	2020	243600	84100	327700	2023-02-01
100103	2021	234700	111100	345800	2023-02-01
100103	2022	234700	111100	345800	2023-02-01
100103	2023	234700	111000	345700	2023-12-18
100122	2020	316200	125500	441700	2023-02-01
100122	2021	386900	159800	546700	2023-02-01
100122	2022	386900	159800	546700	2023-02-01
100122	2023	386900	159800	546700	2023-12-18
100142	2020	185200	0	185200	2023-02-01
100142	2021	217500	0	217500	2023-02-01
100142	2022	217500	0	217500	2023-02-01
100142	2023	217500	0	217500	2023-12-18
100162	2020	185200	0	185200	2023-02-01
100162	2021	217500	0	217500	2023-02-01
100162	2022	217500	0	217500	2023-02-01
100162	2023	217500	0	217500	2023-12-18
100163	2020	229300	0	229300	2023-02-01
100163	2021	251600	0	251600	2023-02-01
100163	2022	251600	0	251600	2023-02-01
100163	2023	251600	0	251600	2023-12-18
100164	2020	213500	0	213500	2023-02-01
100164	2021	244700	0	244700	2023-02-01
100164	2022	244700	0	244700	2023-02-01
100164	2023	244700	0	244700	2023-12-18
100182	2020	326100	0	326100	2023-02-01
100182	2021	377100	0	377100	2023-02-01
100182	2022	377100	0	377100	2023-02-01
100182	2023	377100	0	377100	2023-12-18
100184	2020	356600	0	356600	2023-02-01
100184	2021	349600	0	349600	2023-02-01
100184	2022	349600	0	349600	2023-02-01
100184	2023	349600	0	349600	2023-12-18
1002	2020	0	4800	4800	2023-02-01
1002	2021	0	4800	4800	2023-02-01
1002	2022	0	4800	4800	2023-02-01
1002	2023	0	4700	4700	2023-12-18
100202	2020	0	20600	20600	2023-02-01
100202	2021	0	20600	20600	2023-02-01
100202	2022	0	20600	20600	2023-02-01
100202	2023	0	20700	20700	2023-12-18
100222	2020	0	2100	2100	2023-02-01
100222	2021	0	2400	2400	2023-02-01
100222	2022	0	2400	2400	2023-02-01
100243	2020	388000	131300	519300	2023-02-01
100243	2021	478200	158900	637100	2023-02-01
100243	2022	478200	158900	637100	2023-02-01
100243	2023	478200	158800	637000	2023-12-18
100262	2020	685200	194900	880100	2023-02-01
100262	2021	826700	181900	1008600	2023-02-01
100262	2022	826700	181900	1008600	2023-02-01
100262	2023	841700	181900	1023600	2023-12-18
100263	2020	516000	171900	687900	2023-02-01
100263	2021	609800	202300	812100	2023-02-01
100263	2022	609800	202300	812100	2023-02-01
100263	2023	609800	202300	812100	2023-12-18
100264	2020	0	400	400	2023-02-01
100264	2021	0	400	400	2023-02-01
100264	2022	0	400	400	2023-02-01
100264	2023	0	400	400	2023-12-18
100265	2020	345400	170500	515900	2023-02-01
100265	2021	431900	203100	635000	2023-02-01
100265	2022	431900	203100	635000	2023-02-01
100265	2023	431900	203100	635000	2023-12-18
100282	2020	447700	161300	609000	2023-02-01
100282	2021	545900	190100	736000	2023-02-01
100282	2022	545900	190100	736000	2023-02-01
100282	2023	557500	190100	747600	2023-12-18
1003	2020	198500	137300	335800	2023-02-01
1003	2021	179900	166900	346800	2023-02-01
1003	2022	167600	166900	334500	2023-02-01
1003	2023	178600	166900	345500	2023-12-18
100302	2020	221900	159500	381400	2023-02-01
100302	2021	263600	206300	469900	2023-02-01
100302	2022	263600	206300	469900	2023-02-01
100302	2023	263600	206300	469900	2023-12-18
100322	2020	0	4300	4300	2023-02-01
100322	2021	0	4300	4300	2023-02-01
100322	2022	0	4300	4300	2023-02-01
100322	2023	0	4300	4300	2023-12-18
100361	2020	0	4200	4200	2023-02-01
100361	2021	0	4200	4200	2023-02-01
100361	2022	0	4200	4200	2023-02-01
100361	2023	0	4500	4500	2023-12-18
1004	2020	289200	166000	455200	2023-02-01
1004	2021	370900	175200	546100	2023-02-01
1004	2022	370900	175200	546100	2023-02-01
1004	2023	370900	175200	546100	2023-12-18
100401	2020	0	2500	2500	2023-02-01
100401	2021	0	2500	2500	2023-02-01
100401	2022	0	2500	2500	2023-02-01
100401	2023	0	2500	2500	2023-12-18
100422	2020	416300	0	416300	2023-02-01
100422	2021	451200	0	451200	2023-02-01
100422	2022	451200	0	451200	2023-02-01
100422	2023	451200	0	451200	2023-12-18
100442	2020	355600	0	355600	2023-02-01
100442	2021	387700	0	387700	2023-02-01
100442	2022	387700	0	387700	2023-02-01
100442	2023	387700	0	387700	2023-12-18
100462	2020	188700	0	188700	2023-02-01
100462	2021	204700	0	204700	2023-02-01
100462	2022	204700	0	204700	2023-02-01
100462	2023	204700	0	204700	2023-12-18
100463	2020	364500	0	364500	2023-02-01
100463	2021	398200	0	398200	2023-02-01
100463	2022	398200	0	398200	2023-02-01
100463	2023	398200	0	398200	2023-12-18
100482	2020	197100	0	197100	2023-02-01
100482	2021	212900	0	212900	2023-02-01
100482	2022	212900	0	212900	2023-02-01
100482	2023	212900	0	212900	2023-12-18
1005	2020	303600	124000	427600	2023-02-01
1005	2021	348300	184800	533100	2023-02-01
1005	2022	348300	184800	533100	2023-02-01
1005	2023	348300	184800	533100	2023-12-18
100502	2020	385100	0	385100	2023-02-01
100502	2021	421200	0	421200	2023-02-01
100502	2022	421200	0	421200	2023-02-01
100502	2023	421200	0	421200	2023-12-18
100503	2020	197400	0	197400	2023-02-01
100503	2021	261900	0	261900	2023-02-01
100503	2022	261900	0	261900	2023-02-01
100503	2023	261900	0	261900	2023-12-18
100522	2020	171300	0	171300	2023-02-01
100522	2021	184400	0	184400	2023-02-01
100522	2022	184400	0	184400	2023-02-01
100522	2023	184400	0	184400	2023-12-18
100523	2020	306200	0	306200	2023-02-01
100523	2021	332100	0	332100	2023-02-01
100523	2022	332100	0	332100	2023-02-01
100523	2023	332100	0	332100	2023-12-18
100542	2020	429200	0	429200	2023-02-01
100542	2021	473800	0	473800	2023-02-01
100542	2022	473800	0	473800	2023-02-01
100542	2023	473800	0	473800	2023-12-18
100543	2020	496700	0	496700	2023-02-01
100543	2021	543400	0	543400	2023-02-01
100543	2022	543400	0	543400	2023-02-01
100543	2023	543400	0	543400	2023-12-18
100562	2020	393600	0	393600	2023-02-01
100562	2021	427400	0	427400	2023-02-01
100562	2022	427400	0	427400	2023-02-01
100562	2023	427400	0	427400	2023-12-18
100563	2020	313300	0	313300	2023-02-01
100563	2021	340300	0	340300	2023-02-01
100563	2022	340300	0	340300	2023-02-01
100563	2023	340300	0	340300	2023-12-18
100582	2020	346100	0	346100	2023-02-01
100582	2021	385200	0	385200	2023-02-01
100582	2022	385200	0	385200	2023-02-01
100582	2023	385200	0	385200	2023-12-18
100583	2020	1690400	0	1690400	2023-02-01
100583	2021	1848200	0	1848200	2023-02-01
100583	2022	1848200	0	1848200	2023-02-01
100583	2023	1848200	0	1848200	2023-12-18
1006	2020	113800	106500	220300	2023-02-01
1006	2021	131500	140300	271800	2023-02-01
1006	2022	131500	140300	271800	2023-02-01
1006	2023	131500	140300	271800	2023-12-18
100602	2020	0	2100	2100	2023-02-01
100602	2021	0	2100	2100	2023-02-01
100602	2022	0	2100	2100	2023-02-01
100602	2023	0	1900	1900	2023-12-18
100622	2020	0	1500	1500	2023-02-01
100622	2021	0	1500	1500	2023-02-01
100622	2022	0	1500	1500	2023-02-01
100622	2023	0	1300	1300	2023-12-18
100642	2020	0	30000	30000	2023-02-01
100642	2021	0	33000	33000	2023-02-01
100642	2022	0	33000	33000	2023-02-01
100642	2023	0	33000	33000	2023-12-18
100662	2020	0	2600	2600	2023-02-01
100662	2021	0	2600	2600	2023-02-01
100662	2022	0	2600	2600	2023-02-01
100662	2023	0	2300	2300	2023-12-18
100722	2020	248500	192600	441100	2023-02-01
100722	2021	359600	176700	536300	2023-02-01
100722	2022	374200	176700	550900	2023-02-01
100722	2023	374200	176700	550900	2023-12-18
100742	2020	346600	200800	547400	2023-02-01
100742	2021	674200	219200	893400	2023-02-01
100742	2022	674200	219200	893400	2023-02-01
100742	2023	674200	218900	893100	2023-12-18
100822	2020	134100	265300	399400	2023-02-01
100822	2021	147600	290200	437800	2023-02-01
100822	2022	147600	290200	437800	2023-02-01
100822	2023	147600	371300	518900	2023-12-18
100863	2020	154900	81500	236400	2023-02-01
100863	2021	162900	104400	267300	2023-02-01
100863	2022	162900	104400	267300	2023-02-01
100863	2023	162900	104400	267300	2023-12-18
1009	2020	0	10800	10800	2023-02-01
1009	2021	0	10800	10800	2023-02-01
1009	2022	0	10800	10800	2023-02-01
1009	2023	0	10700	10700	2023-12-18
101	2020	543200	0	543200	2023-02-01
101	2021	543900	0	543900	2023-02-01
101	2022	543900	0	543900	2023-02-01
101	2023	543900	0	543900	2023-12-18
101082	2020	0	135200	135200	2023-02-01
101082	2021	0	179500	179500	2023-02-01
101082	2022	0	179500	179500	2023-02-01
101082	2023	0	179500	179500	2023-12-18
101143	2020	503500	142500	646000	2023-02-01
101143	2021	588800	207200	796000	2023-02-01
101143	2022	531300	180100	711400	2023-02-01
101143	2023	531300	180100	711400	2023-12-18
101162	2020	234200	253100	487300	2023-02-01
101162	2021	273300	253100	526400	2023-02-01
101162	2022	273300	253100	526400	2023-02-01
101162	2023	273300	253100	526400	2023-12-18
101182	2020	363200	293700	656900	2023-02-01
101182	2021	457000	332800	789800	2023-02-01
101182	2022	457000	332800	789800	2023-02-01
101182	2023	457000	332800	789800	2023-12-18
101183	2020	0	400	400	2023-02-01
101183	2021	0	400	400	2023-02-01
101183	2022	0	400	400	2023-02-01
101183	2023	0	400	400	2023-12-18
101202	2020	0	2900	2900	2023-02-01
101202	2021	0	3100	3100	2023-02-01
101202	2022	0	3100	3100	2023-02-01
101202	2023	0	3000	3000	2023-12-18
101203	2020	0	6400	6400	2023-02-01
101203	2021	0	6400	6400	2023-02-01
101203	2022	0	6400	6400	2023-02-01
101203	2023	0	6400	6400	2023-12-18
101204	2020	0	2800	2800	2023-02-01
101204	2021	0	2800	2800	2023-02-01
101204	2022	0	2800	2800	2023-02-01
101204	2023	0	2700	2700	2023-12-18
101205	2020	0	2500	2500	2023-02-01
101205	2021	0	2500	2500	2023-02-01
101205	2022	0	2500	2500	2023-02-01
101205	2023	0	2400	2400	2023-12-18
101224	2020	389900	158900	548800	2023-02-01
101224	2021	484500	174400	658900	2023-02-01
101224	2022	521700	174800	696500	2023-02-01
101224	2023	521700	174800	696500	2023-12-18
101242	2020	533100	220700	753800	2023-02-01
101242	2021	660000	249300	909300	2023-02-01
101242	2022	660000	249300	909300	2023-02-01
101242	2023	660000	249300	909300	2023-12-18
101243	2020	486400	188500	674900	2023-02-01
101243	2021	621200	221300	842500	2023-02-01
101243	2022	621200	221300	842500	2023-02-01
101243	2023	621200	221300	842500	2023-12-18
101262	2020	380700	163700	544400	2023-02-01
101262	2021	405400	185900	591300	2023-02-01
101262	2022	408800	185900	594700	2023-02-01
101262	2023	408800	185900	594700	2023-12-18
101282	2020	267400	155600	423000	2023-02-01
101282	2021	384200	200600	584800	2023-02-01
101282	2022	384200	200700	584900	2023-02-01
101282	2023	384200	200600	584800	2023-12-18
101325	2020	594700	241800	836500	2023-02-01
101325	2021	628800	203400	832200	2023-02-01
101325	2022	628800	203400	832200	2023-02-01
101325	2023	666300	203300	869600	2023-12-18
101342	2020	811100	528100	1339200	2023-02-01
101342	2021	810900	874800	1685700	2023-02-01
101342	2022	812300	660900	1473200	2023-02-01
101342	2023	812300	660900	1473200	2023-12-18
101362	2020	108200	119700	227900	2023-02-01
101362	2021	516900	186400	703300	2023-02-01
101362	2022	516800	186500	703300	2023-02-01
101362	2023	516900	186400	703300	2023-12-18
101382	2020	246400	182700	429100	2023-02-01
101382	2021	244400	182200	426600	2023-02-01
101382	2022	244600	182200	426800	2023-02-01
101382	2023	244600	182100	426700	2023-12-18
101442	2020	3300	32100	35400	2023-02-01
101442	2021	3500	89800	93300	2023-02-01
101442	2022	3500	89800	93300	2023-02-01
101442	2023	3500	89700	93200	2023-12-18
101462	2020	840900	176500	1017400	2023-02-01
101462	2021	926800	191100	1117900	2023-02-01
101462	2022	926800	191100	1117900	2023-02-01
101462	2023	926800	191100	1117900	2023-12-18
101483	2020	0	119900	119900	2023-02-01
101483	2021	200	144400	144600	2023-02-01
101483	2022	200	144400	144600	2023-02-01
101483	2023	200	144400	144600	2023-12-18
1015	2020	49200	95200	144400	2023-02-01
1015	2021	56500	122100	178600	2023-02-01
1015	2022	56500	122100	178600	2023-02-01
1015	2023	56500	122100	178600	2023-12-18
101502	2020	0	11600	11600	2023-02-01
101502	2021	0	13400	13400	2023-02-01
101502	2022	0	13400	13400	2023-02-01
101502	2023	0	13400	13400	2023-12-18
101523	2020	295500	105300	400800	2023-02-01
101523	2021	319000	144400	463400	2023-02-01
101523	2022	319000	144400	463400	2023-02-01
101523	2023	319000	144300	463300	2023-12-18
101542	2020	109800	271800	381600	2023-02-01
101542	2021	203700	327400	531100	2023-02-01
101542	2022	203700	327400	531100	2023-02-01
101542	2023	203700	327200	530900	2023-12-18
101562	2020	800	15600	16400	2023-02-01
101562	2021	900	15900	16800	2023-02-01
101562	2022	900	15900	16800	2023-02-01
101562	2023	900	15800	16700	2023-12-18
101582	2020	0	2800	2800	2023-02-01
101582	2021	0	2800	2800	2023-02-01
101582	2022	0	2900	2900	2023-02-01
101582	2023	0	2700	2700	2023-12-18
1016	2020	111500	118800	230300	2023-02-01
1016	2021	122600	155100	277700	2023-02-01
1016	2022	122600	155100	277700	2023-02-01
1016	2023	122600	155100	277700	2023-12-18
101602	2020	217800	0	217800	2023-02-01
101602	2021	243200	0	243200	2023-02-01
101602	2022	243200	0	243200	2023-02-01
101602	2023	243200	0	243200	2023-12-18
101622	2020	139800	96100	235900	2023-02-01
101622	2021	334300	114400	448700	2023-02-01
101622	2022	344800	114500	459300	2023-02-01
101622	2023	365500	114500	480000	2023-12-18
101642	2020	260900	111600	372500	2023-02-01
101642	2021	281900	144800	426700	2023-02-01
101642	2022	281900	144800	426700	2023-02-01
101642	2023	281900	144800	426700	2023-12-18
1018	2020	39600	81900	121500	2023-02-01
1018	2021	43400	94600	138000	2023-02-01
1018	2022	43400	94600	138000	2023-02-01
1018	2023	43400	94500	137900	2023-12-18
1019	2020	253200	126000	379200	2023-02-01
1019	2021	265300	163000	428300	2023-02-01
1019	2022	265300	163000	428300	2023-02-01
1019	2023	265300	163000	428300	2023-12-18
102	2020	7500	91900	99400	2023-02-01
102	2021	7500	104000	111500	2023-02-01
102	2022	7500	104000	111500	2023-02-01
102	2023	7500	104000	111500	2023-12-18
1020	2020	102200	131400	233600	2023-02-01
1020	2021	81200	169000	250200	2023-02-01
1020	2022	81200	169000	250200	2023-02-01
1020	2023	81200	169000	250200	2023-12-18
1022	2020	256100	140500	396600	2023-02-01
1022	2021	370500	182300	552800	2023-02-01
1022	2022	370500	182300	552800	2023-02-01
1022	2023	370500	182300	552800	2023-12-18
1023	2020	139700	158800	298500	2023-02-01
1023	2021	160500	195700	356200	2023-02-01
1023	2022	160500	195700	356200	2023-02-01
1023	2023	160500	195700	356200	2023-12-18
1024	2020	121200	102400	223600	2023-02-01
1024	2021	142900	148400	291300	2023-02-01
1024	2022	142900	148400	291300	2023-02-01
1024	2023	142900	148400	291300	2023-12-18
1025	2020	201800	189300	391100	2023-02-01
1025	2021	277500	202000	479500	2023-02-01
1025	2022	296500	202000	498500	2023-02-01
1025	2023	296500	202000	498500	2023-12-18
1026	2020	248000	138200	386200	2023-02-01
1026	2021	261400	176100	437500	2023-02-01
1026	2022	261400	176100	437500	2023-02-01
1026	2023	261400	176100	437500	2023-12-18
102644	2020	8300	11800	20100	2023-02-01
102644	2021	6300	16400	22700	2023-02-01
102644	2022	6300	16400	22700	2023-02-01
102644	2023	6300	16400	22700	2023-12-18
102691	2020	718300	355800	1074100	2023-02-01
102691	2021	791100	301800	1092900	2023-02-01
102691	2022	791100	301800	1092900	2023-02-01
102691	2023	793000	301700	1094700	2023-12-18
102692	2020	522900	148200	671100	2023-02-01
102692	2021	645300	168900	814200	2023-02-01
102692	2022	645300	168900	814200	2023-02-01
102692	2023	645600	168900	814500	2023-12-18
1027	2020	0	19100	19100	2023-02-01
1027	2021	0	19100	19100	2023-02-01
1027	2022	0	19100	19100	2023-02-01
1027	2023	0	19900	19900	2023-12-18
102712	2020	8300	183700	192000	2023-02-01
102712	2021	11100	246900	258000	2023-02-01
102712	2022	11100	246900	258000	2023-02-01
102712	2023	11100	246900	258000	2023-12-18
102732	2020	16600	62700	79300	2023-02-01
102732	2021	36300	69300	105600	2023-02-01
102732	2022	36300	69300	105600	2023-02-01
102732	2023	36300	69300	105600	2023-12-18
102736	2020	394900	192000	586900	2023-02-01
102736	2021	425900	192300	618200	2023-02-01
102736	2022	425900	192300	618200	2023-02-01
102736	2023	425900	192300	618200	2023-12-18
102737	2020	569100	324800	893900	2023-02-01
102737	2021	672900	368500	1041400	2023-02-01
102737	2022	672900	368500	1041400	2023-02-01
102737	2023	672900	368500	1041400	2023-12-18
102759	2020	0	600	600	2023-02-01
102759	2021	0	600	600	2023-02-01
102759	2022	0	600	600	2023-02-01
102759	2023	0	600	600	2023-12-18
102763	2020	0	3300	3300	2023-02-01
102763	2021	0	3300	3300	2023-02-01
102763	2022	0	3300	3300	2023-02-01
102763	2023	0	3200	3200	2023-12-18
102766	2020	169600	153300	322900	2023-02-01
102766	2021	171800	174300	346100	2023-02-01
102766	2022	171800	174300	346100	2023-02-01
102766	2023	205000	174300	379300	2023-12-18
102768	2020	0	83800	83800	2023-02-01
102768	2021	0	109300	109300	2023-02-01
102768	2022	0	109300	109300	2023-02-01
102768	2023	0	109300	109300	2023-12-18
102770	2020	572100	196400	768500	2023-02-01
102770	2021	632600	180600	813200	2023-02-01
102770	2022	632600	180600	813200	2023-02-01
102770	2023	692600	180600	873200	2023-12-18
102771	2020	142000	93900	235900	2023-02-01
102771	2021	155400	136800	292200	2023-02-01
102771	2022	155400	136800	292200	2023-02-01
102771	2023	155400	136800	292200	2023-12-18
102772	2020	0	14800	14800	2023-02-01
102772	2021	0	14800	14800	2023-02-01
102772	2022	0	14800	14800	2023-02-01
102772	2023	0	14500	14500	2023-12-18
1028	2020	0	10500	10500	2023-02-01
1028	2021	0	12200	12200	2023-02-01
1028	2022	0	12200	12200	2023-02-01
1028	2023	0	12200	12200	2023-12-18
102814	2020	42600	278300	320900	2023-02-01
102814	2021	49000	342900	391900	2023-02-01
102814	2022	49000	342900	391900	2023-02-01
102814	2023	49000	342900	391900	2023-12-18
102815	2020	0	114900	114900	2023-02-01
102815	2021	0	126900	126900	2023-02-01
102815	2022	0	126900	126900	2023-02-01
102815	2023	0	126900	126900	2023-12-18
102834	2020	756800	297800	1054600	2023-02-01
102834	2021	860200	346200	1206400	2023-02-01
102834	2022	860200	346200	1206400	2023-02-01
102834	2023	892800	346200	1239000	2023-12-18
102854	2020	45900	69600	115500	2023-02-01
102854	2021	67300	91400	158700	2023-02-01
102854	2022	67300	91400	158700	2023-02-01
102854	2023	67300	91400	158700	2023-12-18
102874	2020	0	3800	3800	2023-02-01
102874	2021	0	3800	3800	2023-02-01
102874	2022	0	3800	3800	2023-02-01
102874	2023	0	3600	3600	2023-12-18
102875	2020	0	13700	13700	2023-02-01
102875	2021	0	13700	13700	2023-02-01
102875	2022	0	13700	13700	2023-02-01
102875	2023	0	13000	13000	2023-12-18
102876	2020	0	800	800	2023-02-01
102876	2021	0	800	800	2023-02-01
102876	2022	0	800	800	2023-02-01
102876	2023	0	700	700	2023-12-18
102896	2020	0	400	400	2023-02-01
102896	2021	0	500	500	2023-02-01
102896	2022	0	500	500	2023-02-01
102896	2023	215600	215000	430600	2023-12-18
102897	2020	96500	216600	313100	2023-02-01
102897	2021	72500	265300	337800	2023-02-01
102897	2022	72500	265300	337800	2023-02-01
102897	2023	72500	265300	337800	2023-12-18
102916	2020	0	25000	25000	2023-02-01
102916	2021	0	25000	25000	2023-02-01
102916	2022	0	25000	25000	2023-02-01
102916	2023	0	25000	25000	2023-12-18
102956	2020	0	206300	206300	2023-02-01
102956	2021	0	237100	237100	2023-02-01
102956	2022	0	237100	237100	2023-02-01
102956	2023	0	237100	237100	2023-12-18
102976	2020	28500	93900	122400	2023-02-01
102976	2021	37100	121900	159000	2023-02-01
102976	2022	37100	121900	159000	2023-02-01
102976	2023	37100	121800	158900	2023-12-18
102996	2020	0	9900	9900	2023-02-01
102996	2021	0	9900	9900	2023-02-01
102996	2022	0	10000	10000	2023-02-01
102996	2023	0	9900	9900	2023-12-18
103	2020	116200	162700	278900	2023-02-01
103	2021	121800	185100	306900	2023-02-01
103	2022	121800	185100	306900	2023-02-01
103	2023	121800	185100	306900	2023-12-18
1030	2020	320700	229000	549700	2023-02-01
1030	2021	368900	264300	633200	2023-02-01
1030	2022	368900	264300	633200	2023-02-01
1030	2023	368900	264300	633200	2023-12-18
103016	2020	34200	43200	77400	2023-02-01
103016	2021	34800	42800	77600	2023-02-01
103016	2022	34800	42800	77600	2023-02-01
103016	2023	34800	42800	77600	2023-12-18
103036	2020	0	2000	2000	2023-02-01
103036	2021	0	2000	2000	2023-02-01
103036	2022	0	2000	2000	2023-02-01
103036	2023	0	1800	1800	2023-12-18
103057	2020	411500	237400	648900	2023-02-01
103057	2021	327800	330000	657800	2023-02-01
103057	2022	327800	330000	657800	2023-02-01
103057	2023	327800	330000	657800	2023-12-18
103078	2020	11200	78900	90100	2023-02-01
103078	2021	11500	78700	90200	2023-02-01
103078	2022	11500	78700	90200	2023-02-01
103079	2020	0	2300	2300	2023-02-01
103079	2021	0	2300	2300	2023-02-01
103079	2022	0	2300	2300	2023-02-01
103079	2023	0	2000	2000	2023-12-18
103097	2020	0	3000	3000	2023-02-01
103097	2021	0	3000	3000	2023-02-01
103097	2022	0	3000	3000	2023-02-01
103097	2023	0	3000	3000	2023-12-18
1031	2020	114500	113400	227900	2023-02-01
1031	2021	145000	141700	286700	2023-02-01
1031	2022	145000	141700	286700	2023-02-01
1031	2023	145000	141600	286600	2023-12-18
103117	2020	39700	44500	84200	2023-02-01
103117	2021	37000	44500	81500	2023-02-01
103117	2022	37000	44500	81500	2023-02-01
103117	2023	37000	44500	81500	2023-12-18
103137	2020	45500	0	45500	2023-02-01
103137	2021	50000	0	50000	2023-02-01
103137	2022	50000	0	50000	2023-02-01
103137	2023	50000	0	50000	2023-12-18
103157	2020	0	4500	4500	2023-02-01
103157	2021	0	4500	4500	2023-02-01
103157	2022	0	4500	4500	2023-02-01
103157	2023	0	4500	4500	2023-12-18
103178	2021	33600	88000	121600	2023-02-01
103178	2022	33600	88000	121600	2023-02-01
103178	2023	33600	88000	121600	2023-12-18
103197	2021	60000	0	60000	2023-02-01
103197	2022	60000	0	60000	2023-02-01
103197	2023	227700	0	227700	2023-12-18
103220	2022	0	1500	1500	2023-02-01
103220	2023	0	1500	1500	2023-12-18
103222	2022	0	1300	1300	2023-02-01
103222	2023	0	1300	1300	2023-12-18
103224	2022	350700	0	350700	2023-02-01
103224	2023	251200	0	251200	2023-12-18
103225	2022	148500	0	148500	2023-02-01
103225	2023	63700	0	63700	2023-12-18
103226	2022	175000	0	175000	2023-02-01
103226	2023	108500	0	108500	2023-12-18
103227	2022	144800	0	144800	2023-02-01
103227	2023	79200	0	79200	2023-12-18
103228	2022	138900	0	138900	2023-02-01
103228	2023	73200	0	73200	2023-12-18
103229	2022	138000	0	138000	2023-02-01
103229	2023	72500	0	72500	2023-12-18
103230	2022	152100	0	152100	2023-02-01
103230	2023	85500	0	85500	2023-12-18
103233	2022	141100	0	141100	2023-02-01
103233	2023	74900	0	74900	2023-12-18
103237	2022	141000	0	141000	2023-02-01
103237	2023	74900	0	74900	2023-12-18
103238	2022	131100	0	131100	2023-02-01
103238	2023	72800	0	72800	2023-12-18
103239	2022	146200	0	146200	2023-02-01
103239	2023	78800	0	78800	2023-12-18
103240	2022	147300	0	147300	2023-02-01
103240	2023	79700	0	79700	2023-12-18
103242	2022	143100	0	143100	2023-02-01
103242	2023	72700	0	72700	2023-12-18
103243	2022	145400	0	145400	2023-02-01
103243	2023	78200	0	78200	2023-12-18
103244	2022	140800	0	140800	2023-02-01
103244	2023	74600	0	74600	2023-12-18
103245	2022	161100	0	161100	2023-02-01
103245	2023	90300	0	90300	2023-12-18
103246	2022	139800	0	139800	2023-02-01
103246	2023	73900	0	73900	2023-12-18
103247	2022	139800	0	139800	2023-02-01
103247	2023	73900	0	73900	2023-12-18
103248	2022	155900	0	155900	2023-02-01
103248	2023	86300	0	86300	2023-12-18
103249	2022	141600	0	141600	2023-02-01
103249	2023	75800	0	75800	2023-12-18
103250	2022	158900	0	158900	2023-02-01
103250	2023	88600	0	88600	2023-12-18
103251	2022	144800	0	144800	2023-02-01
103251	2023	31300	0	31300	2023-12-18
103252	2023	102100	140400	242500	2023-12-18
103252	No Data for Assessment History				2023-02-01
103252	No Data for PID				2023-08-17
103253	2023	0	12400	12400	2023-12-18
103253	No Data for PID				2023-08-17
103254	2023	33800	111300	145100	2023-12-18
103254	No Data for PID				2023-08-17
103255	2023	0	1700	1700	2023-12-18
103255	No Data for PID				2023-08-17
103257	2023	0	300	300	2023-12-18
1033	2020	229300	139800	369100	2023-02-01
1033	2021	298200	179500	477700	2023-02-01
1033	2022	298200	179500	477700	2023-02-01
1033	2023	298200	179500	477700	2023-12-18
1034	2020	15300	13100	28400	2023-02-01
1034	2021	17100	16600	33700	2023-02-01
1034	2022	17100	16600	33700	2023-02-01
1034	2023	17100	16600	33700	2023-12-18
1035	2020	140800	195200	336000	2023-02-01
1035	2021	162400	251800	414200	2023-02-01
1035	2022	162400	251800	414200	2023-02-01
1035	2023	162400	251800	414200	2023-12-18
1037	2020	29400	226000	255400	2023-02-01
1037	2021	53700	226100	279800	2023-02-01
1037	2022	53700	226100	279800	2023-02-01
1037	2023	53700	226100	279800	2023-12-18
1038	2020	70800	87600	158400	2023-02-01
1038	2021	103600	97000	200600	2023-02-01
1038	2022	114400	97000	211400	2023-02-01
1038	2023	114400	97000	211400	2023-12-18
1039	2020	0	108100	108100	2023-02-01
1039	2021	0	113300	113300	2023-02-01
1039	2022	0	6000	6000	2023-02-01
1039	2023	0	6400	6400	2023-12-18
104	2020	923900	298600	1222500	2023-02-01
104	2021	1055000	394300	1449300	2023-02-01
104	2022	1055000	394300	1449300	2023-02-01
104	2023	1055000	394300	1449300	2023-12-18
1040	2020	332600	144300	476900	2023-02-01
1040	2021	355700	143100	498800	2023-02-01
1040	2022	391100	143100	534200	2023-02-01
1040	2023	404300	143100	547400	2023-12-18
1041	2020	301900	152300	454200	2023-02-01
1041	2021	348600	147700	496300	2023-02-01
1041	2022	348600	147700	496300	2023-02-01
1041	2023	348600	147700	496300	2023-12-18
1042	2020	228600	139800	368400	2023-02-01
1042	2021	245800	152800	398600	2023-02-01
1042	2022	245800	152800	398600	2023-02-01
1042	2023	245800	152800	398600	2023-12-18
1043	2020	122000	80700	202700	2023-02-01
1043	2021	125600	100500	226100	2023-02-01
1043	2022	125600	100500	226100	2023-02-01
1043	2023	125600	100500	226100	2023-12-18
1045	2020	65600	96400	162000	2023-02-01
1045	2021	68200	105400	173600	2023-02-01
1045	2022	68200	105400	173600	2023-02-01
1045	2023	68200	105400	173600	2023-12-18
1046	2020	121700	99600	221300	2023-02-01
1046	2021	128000	131300	259300	2023-02-01
1046	2022	128000	131300	259300	2023-02-01
1046	2023	128000	131300	259300	2023-12-18
1048	2020	0	4100	4100	2023-02-01
1048	2021	0	4400	4400	2023-02-01
1048	2022	0	4400	4400	2023-02-01
1048	2023	0	4400	4400	2023-12-18
1049	2020	28800	132700	161500	2023-02-01
1049	2021	31100	161400	192500	2023-02-01
1049	2022	31100	161400	192500	2023-02-01
1049	2023	31100	161400	192500	2023-12-18
105	2020	219000	249200	468200	2023-02-01
105	2021	236100	274300	510400	2023-02-01
105	2022	236100	274300	510400	2023-02-01
105	2023	236100	274300	510400	2023-12-18
1051	2020	66800	114100	180900	2023-02-01
1051	2021	73600	147200	220800	2023-02-01
1051	2022	73600	147200	220800	2023-02-01
1051	2023	73600	147200	220800	2023-12-18
1052	2020	73500	94100	167600	2023-02-01
1052	2021	118300	136000	254300	2023-02-01
1052	2022	118300	136000	254300	2023-02-01
1052	2023	118300	136100	254400	2023-12-18
1053	2020	779800	366200	1146000	2023-02-01
1053	2021	859100	328400	1187500	2023-02-01
1053	2022	859100	328400	1187500	2023-02-01
1053	2023	859100	327700	1186800	2023-12-18
1054	2020	1158900	417200	1576100	2023-02-01
1054	2021	1616600	469200	2085800	2023-02-01
1054	2022	1622000	407700	2029700	2023-02-01
1054	2023	1622000	407500	2029500	2023-12-18
1055	2020	0	16900	16900	2023-02-01
1055	2021	0	16900	16900	2023-02-01
1055	2022	0	16900	16900	2023-02-01
1055	2023	0	16800	16800	2023-12-18
1057	2020	0	1700	1700	2023-02-01
1057	2021	0	1700	1700	2023-02-01
1057	2022	0	1700	1700	2023-02-01
1057	2023	0	1800	1800	2023-12-18
1058	2020	8900	12400	21300	2023-02-01
1058	2021	9400	17000	26400	2023-02-01
1058	2022	9400	17000	26400	2023-02-01
1058	2023	9400	16900	26300	2023-12-18
106	2020	1164400	388300	1552700	2023-02-01
106	2021	1421000	488300	1909300	2023-02-01
106	2022	1421000	488300	1909300	2023-02-01
106	2023	1421000	488300	1909300	2023-12-18
1060	2020	766000	147900	913900	2023-02-01
1060	2021	952200	193100	1145300	2023-02-01
1060	2022	952200	193100	1145300	2023-02-01
1060	2023	952200	193100	1145300	2023-12-18
1061	2020	123300	155500	278800	2023-02-01
1061	2021	132200	194200	326400	2023-02-01
1061	2022	132200	194200	326400	2023-02-01
1061	2023	132200	194200	326400	2023-12-18
1064	2020	492900	121100	614000	2023-02-01
1064	2021	536700	155500	692200	2023-02-01
1064	2022	536700	155500	692200	2023-02-01
1064	2023	536700	155400	692100	2023-12-18
1068	2020	607300	148600	755900	2023-02-01
1068	2021	620900	192600	813500	2023-02-01
1068	2022	620900	192600	813500	2023-02-01
1068	2023	620900	193300	814200	2023-12-18
1069	2020	0	1600	1600	2023-02-01
1069	2021	0	1600	1600	2023-02-01
1069	2022	0	1600	1600	2023-02-01
1069	2023	0	1600	1600	2023-12-18
107	2020	340500	233900	574400	2023-02-01
107	2021	359500	263700	623200	2023-02-01
107	2022	359500	263700	623200	2023-02-01
107	2023	359500	263700	623200	2023-12-18
1070	2020	48800	134300	183100	2023-02-01
1070	2021	62100	169800	231900	2023-02-01
1070	2022	62100	169800	231900	2023-02-01
1070	2023	62100	169800	231900	2023-12-18
1071	2020	452100	106500	558600	2023-02-01
1071	2021	496200	139200	635400	2023-02-01
1071	2022	496200	139200	635400	2023-02-01
1071	2023	496200	139200	635400	2023-12-18
1076	2020	0	5300	5300	2023-02-01
1076	2021	0	5300	5300	2023-02-01
1076	2022	0	5300	5300	2023-02-01
1076	2023	0	5100	5100	2023-12-18
1077	2020	0	30700	30700	2023-02-01
1077	2021	0	30700	30700	2023-02-01
1077	2022	0	30700	30700	2023-02-01
1077	2023	0	29800	29800	2023-12-18
1078	2020	166600	82200	248800	2023-02-01
1078	2021	200900	103900	304800	2023-02-01
1078	2022	200900	103900	304800	2023-02-01
1078	2023	200900	103900	304800	2023-12-18
1079	2020	0	100	100	2023-02-01
1079	2021	0	100	100	2023-02-01
1079	2022	0	100	100	2023-02-01
1079	2023	0	100	100	2023-12-18
1081	2020	0	100	100	2023-02-01
1081	2021	0	100	100	2023-02-01
1081	2022	0	100	100	2023-02-01
1081	2023	0	100	100	2023-12-18
1082	2020	49500	72100	121600	2023-02-01
1082	2021	33700	95900	129600	2023-02-01
1082	2022	33700	95900	129600	2023-02-01
1082	2023	33700	95900	129600	2023-12-18
1083	2020	0	3900	3900	2023-02-01
1083	2021	0	3900	3900	2023-02-01
1083	2022	0	3900	3900	2023-02-01
1083	2023	0	4000	4000	2023-12-18
1084	2020	0	100	100	2023-02-01
1084	2021	0	100	100	2023-02-01
1084	2022	0	100	100	2023-02-01
1084	2023	0	100	100	2023-12-18
1085	2020	0	1300	1300	2023-02-01
1085	2021	0	1300	1300	2023-02-01
1085	2022	0	1300	1300	2023-02-01
1085	2023	0	1400	1400	2023-12-18
1087	2020	0	68100	68100	2023-02-01
1087	2021	0	83500	83500	2023-02-01
1087	2022	0	83500	83500	2023-02-01
1087	2023	0	83500	83500	2023-12-18
1091	2020	76500	99500	176000	2023-02-01
1091	2021	89200	145200	234400	2023-02-01
1091	2022	80800	145200	226000	2023-02-01
1091	2023	80800	145200	226000	2023-12-18
1092	2020	308900	125600	434500	2023-02-01
1092	2021	309500	161300	470800	2023-02-01
1092	2022	309500	161300	470800	2023-02-01
1092	2023	309500	161300	470800	2023-12-18
1093	2020	0	113400	113400	2023-02-01
1093	2021	0	139200	139200	2023-02-01
1093	2022	0	139200	139200	2023-02-01
1093	2023	0	139200	139200	2023-12-18
1094	2020	161200	186300	347500	2023-02-01
1094	2021	179900	240600	420500	2023-02-01
1094	2022	179900	240600	420500	2023-02-01
1094	2023	179900	240600	420500	2023-12-18
1096	2020	1186300	299800	1486100	2023-02-01
1096	2021	1543900	319000	1862900	2023-02-01
1096	2022	1589900	319000	1908900	2023-02-01
1096	2023	1589900	318800	1908700	2023-12-18
1097	2020	0	900	900	2023-02-01
1097	2021	0	900	900	2023-02-01
1097	2022	0	900	900	2023-02-01
1097	2023	0	900	900	2023-12-18
1098	2020	0	1800	1800	2023-02-01
1098	2021	0	1800	1800	2023-02-01
1098	2022	0	1800	1800	2023-02-01
1098	2023	0	1700	1700	2023-12-18
1099	2020	190800	109900	300700	2023-02-01
1099	2021	237600	194800	432400	2023-02-01
1099	2022	257600	194800	452400	2023-02-01
1099	2023	269700	194800	464500	2023-12-18
1100	2020	0	400	400	2023-02-01
1100	2021	0	400	400	2023-02-01
1100	2022	0	400	400	2023-02-01
1100	2023	0	300	300	2023-12-18
1101	2020	157500	86200	243700	2023-02-01
1101	2021	176500	127400	303900	2023-02-01
1101	2022	176500	127400	303900	2023-02-01
1101	2023	176500	127400	303900	2023-12-18
1102	2020	79300	92900	172200	2023-02-01
1102	2021	94200	134800	229000	2023-02-01
1102	2022	94200	134800	229000	2023-02-01
1102	2023	94200	134800	229000	2023-12-18
1103	2020	0	3100	3100	2023-02-01
1103	2021	0	3100	3100	2023-02-01
1103	2022	0	3100	3100	2023-02-01
1103	2023	0	2900	2900	2023-12-18
1104	2020	527000	156600	683600	2023-02-01
1104	2021	535000	189900	724900	2023-02-01
1104	2022	535000	189900	724900	2023-02-01
1104	2023	535000	189900	724900	2023-12-18
1105	2020	498600	165900	664500	2023-02-01
1105	2021	538000	187500	725500	2023-02-01
1105	2022	538000	187500	725500	2023-02-01
1105	2023	538000	187500	725500	2023-12-18
1109	2020	600500	209100	809600	2023-02-01
1109	2021	653900	214600	868500	2023-02-01
1109	2022	653900	214600	868500	2023-02-01
1109	2023	653900	214500	868400	2023-12-18
111	2020	4000	337700	341700	2023-02-01
111	2021	4400	424700	429100	2023-02-01
111	2022	4400	424700	429100	2023-02-01
111	2023	4400	424700	429100	2023-12-18
1111	2020	0	103700	103700	2023-02-01
1111	2021	0	128800	128800	2023-02-01
1111	2022	0	128800	128800	2023-02-01
1111	2023	0	128800	128800	2023-12-18
1112	2020	161500	134800	296300	2023-02-01
1112	2021	196600	168700	365300	2023-02-01
1112	2022	196600	168700	365300	2023-02-01
1112	2023	196600	168700	365300	2023-12-18
1113	2020	46300	178700	225000	2023-02-01
1113	2021	73200	222800	296000	2023-02-01
1113	2022	73200	222800	296000	2023-02-01
1113	2023	73200	222800	296000	2023-12-18
1118	2020	195400	93200	288600	2023-02-01
1118	2021	204900	130200	335100	2023-02-01
1118	2022	204900	130200	335100	2023-02-01
1118	2023	204900	130200	335100	2023-12-18
1119	2020	0	3700	3700	2023-02-01
1119	2021	0	3700	3700	2023-02-01
1119	2022	0	3700	3700	2023-02-01
1119	2023	0	3800	3800	2023-12-18
1120	2020	336800	140600	477400	2023-02-01
1120	2021	370500	163700	534200	2023-02-01
1120	2022	370500	163700	534200	2023-02-01
1120	2023	370500	163700	534200	2023-12-18
1121	2020	195500	102800	298300	2023-02-01
1121	2021	221000	148900	369900	2023-02-01
1121	2022	221000	148900	369900	2023-02-01
1121	2023	221000	148900	369900	2023-12-18
1122	2020	10300	67100	77400	2023-02-01
1122	2021	27800	97300	125100	2023-02-01
1122	2022	27800	97300	125100	2023-02-01
1122	2023	27800	97300	125100	2023-12-18
1123	2020	14500	115400	129900	2023-02-01
1123	2021	37100	140400	177500	2023-02-01
1123	2022	37100	140400	177500	2023-02-01
1123	2023	37100	140400	177500	2023-12-18
1124	2020	120300	68900	189200	2023-02-01
1124	2021	39500	95000	134500	2023-02-01
1124	2022	39500	95000	134500	2023-02-01
1124	2023	39500	95000	134500	2023-12-18
1125	2020	12200	44600	56800	2023-02-01
1125	2021	27000	50400	77400	2023-02-01
1125	2022	27000	50400	77400	2023-02-01
1125	2023	27000	50400	77400	2023-12-18
1126	2020	168200	79300	247500	2023-02-01
1126	2021	194300	103600	297900	2023-02-01
1126	2022	194300	103600	297900	2023-02-01
1126	2023	194300	103600	297900	2023-12-18
1127	2020	39800	123100	162900	2023-02-01
1127	2021	50200	120200	170400	2023-02-01
1127	2022	50200	120200	170400	2023-02-01
1127	2023	50200	120200	170400	2023-12-18
1129	2020	0	100	100	2023-02-01
1129	2021	0	100	100	2023-02-01
1129	2022	0	100	100	2023-02-01
1129	2023	0	100	100	2023-12-18
1131	2020	30900	91200	122100	2023-02-01
1131	2021	54200	119100	173300	2023-02-01
1131	2022	54200	119100	173300	2023-02-01
1131	2023	54200	119000	173200	2023-12-18
1132	2020	529300	142800	672100	2023-02-01
1132	2021	605600	163900	769500	2023-02-01
1132	2022	605600	163900	769500	2023-02-01
1132	2023	605600	164700	770300	2023-12-18
1133	2020	85800	88100	173900	2023-02-01
1133	2021	121200	111300	232500	2023-02-01
1133	2022	121200	111300	232500	2023-02-01
1133	2023	121200	111300	232500	2023-12-18
1136	2020	68400	70500	138900	2023-02-01
1136	2021	82700	92300	175000	2023-02-01
1136	2022	82700	92300	175000	2023-02-01
1136	2023	82700	92300	175000	2023-12-18
1137	2020	12800	62700	75500	2023-02-01
1137	2021	26500	75000	101500	2023-02-01
1137	2022	26500	75000	101500	2023-02-01
1137	2023	26500	75000	101500	2023-12-18
1138	2020	32600	36700	69300	2023-02-01
1138	2021	40000	46500	86500	2023-02-01
1138	2022	40000	46500	86500	2023-02-01
1138	2023	40000	46500	86500	2023-12-18
1140	2020	211300	84300	295600	2023-02-01
1140	2021	275600	143300	418900	2023-02-01
1140	2022	233000	150300	383300	2023-02-01
1140	2023	233000	150300	383300	2023-12-18
1141	2020	0	3000	3000	2023-02-01
1141	2021	0	3300	3300	2023-02-01
1141	2022	0	3300	3300	2023-02-01
1141	2023	0	3300	3300	2023-12-18
1142	2020	61500	96900	158400	2023-02-01
1142	2021	68200	151900	220100	2023-02-01
1142	2022	252600	151900	404500	2023-02-01
1142	2023	298500	151900	450400	2023-12-18
1144	2020	395700	121000	516700	2023-02-01
1144	2021	380000	148900	528900	2023-02-01
1144	2022	380000	145800	525800	2023-02-01
1144	2023	380000	145700	525700	2023-12-18
1149	2020	127500	130200	257700	2023-02-01
1149	2021	165700	169900	335600	2023-02-01
1149	2022	164600	169900	334500	2023-02-01
1149	2023	164600	169900	334500	2023-12-18
115	2020	168500	105400	273900	2023-02-01
115	2021	221200	137700	358900	2023-02-01
115	2022	51000	123500	174500	2023-02-01
115	2023	89200	123500	212700	2023-12-18
1150	2020	217700	164100	381800	2023-02-01
1150	2021	195100	190700	385800	2023-02-01
1150	2022	195100	190700	385800	2023-02-01
1150	2023	195100	190700	385800	2023-12-18
1151	2020	0	299700	299700	2023-02-01
1151	2021	0	347500	347500	2023-02-01
1151	2022	0	347500	347500	2023-02-01
1151	2023	0	347500	347500	2023-12-18
1152	2020	0	4800	4800	2023-02-01
1152	2021	0	4800	4800	2023-02-01
1152	2022	0	4800	4800	2023-02-01
1152	2023	0	4700	4700	2023-12-18
1154	2020	0	79000	79000	2023-02-01
1154	2021	0	100400	100400	2023-02-01
1154	2022	0	100400	100400	2023-02-01
1154	2023	0	100400	100400	2023-12-18
1155	2020	0	1100	1100	2023-02-01
1155	2021	0	1100	1100	2023-02-01
1155	2022	0	1100	1100	2023-02-01
1155	2023	0	1100	1100	2023-12-18
1156	2020	333100	114000	447100	2023-02-01
1156	2021	343100	149700	492800	2023-02-01
1156	2022	343100	149700	492800	2023-02-01
1156	2023	343100	149800	492900	2023-12-18
1157	2020	87100	95500	182600	2023-02-01
1157	2021	77200	125000	202200	2023-02-01
1157	2022	77200	125100	202300	2023-02-01
1157	2023	77200	125100	202300	2023-12-18
1158	2020	0	4400	4400	2023-02-01
1158	2021	0	4400	4400	2023-02-01
1158	2022	0	4400	4400	2023-02-01
1158	2023	0	4100	4100	2023-12-18
116	2020	222400	119300	341700	2023-02-01
116	2021	249500	148200	397700	2023-02-01
116	2022	249500	148200	397700	2023-02-01
116	2023	249500	148200	397700	2023-12-18
1163	2020	0	3600	3600	2023-02-01
1163	2021	0	3600	3600	2023-02-01
1163	2022	0	3600	3600	2023-02-01
1163	2023	0	3500	3500	2023-12-18
1164	2020	0	102500	102500	2023-02-01
1164	2021	0	102500	102500	2023-02-01
1164	2022	0	102500	102500	2023-02-01
1164	2023	0	95100	95100	2023-12-18
1165	2020	57300	71800	129100	2023-02-01
1165	2021	70500	85100	155600	2023-02-01
1165	2022	70500	85100	155600	2023-02-01
1165	2023	70600	85100	155700	2023-12-18
1166	2020	191000	121100	312100	2023-02-01
1166	2021	182400	154900	337300	2023-02-01
1166	2022	182400	154900	337300	2023-02-01
1166	2023	185000	154900	339900	2023-12-18
1167	2020	132500	111500	244000	2023-02-01
1167	2021	154000	142600	296600	2023-02-01
1167	2022	154000	142600	296600	2023-02-01
1167	2023	156100	142600	298700	2023-12-18
1169	2020	509600	146000	655600	2023-02-01
1169	2021	527000	191300	718300	2023-02-01
1169	2022	527000	191300	718300	2023-02-01
1169	2023	527000	191300	718300	2023-12-18
117	2020	388500	0	388500	2023-02-01
117	2021	426300	0	426300	2023-02-01
117	2022	426300	0	426300	2023-02-01
117	2023	435400	0	435400	2023-12-18
1170	2020	274400	143000	417400	2023-02-01
1170	2021	261600	171700	433300	2023-02-01
1170	2022	261600	171800	433400	2023-02-01
1170	2023	267100	171700	438800	2023-12-18
1171	2020	0	1200	1200	2023-02-01
1171	2021	0	1200	1200	2023-02-01
1171	2022	0	1200	1200	2023-02-01
1171	2023	0	1200	1200	2023-12-18
1173	2020	52300	45300	97600	2023-02-01
1173	2021	58600	123700	182300	2023-02-01
1173	2022	58600	123700	182300	2023-02-01
1173	2023	58600	124100	182700	2023-12-18
1177	2020	0	13700	13700	2023-02-01
1177	2021	0	13700	13700	2023-02-01
1177	2022	0	13700	13700	2023-02-01
1177	2023	0	13300	13300	2023-12-18
118	2020	143400	287600	431000	2023-02-01
118	2021	155800	405100	560900	2023-02-01
118	2022	155800	405100	560900	2023-02-01
118	2023	155800	405100	560900	2023-12-18
1186	2020	0	1200	1200	2023-02-01
1186	2021	0	1200	1200	2023-02-01
1186	2022	0	1200	1200	2023-02-01
1186	2023	0	1200	1200	2023-12-18
1187	2020	0	500	500	2023-02-01
1187	2021	0	500	500	2023-02-01
1187	2022	0	500	500	2023-02-01
1187	2023	0	500	500	2023-12-18
1188	2020	464400	130100	594500	2023-02-01
1188	2021	477000	167100	644100	2023-02-01
1188	2022	477000	167100	644100	2023-02-01
1188	2023	500600	167300	667900	2023-12-18
1189	2020	0	6800	6800	2023-02-01
1189	2021	0	6800	6800	2023-02-01
1189	2022	0	6800	6800	2023-02-01
1189	2023	0	6500	6500	2023-12-18
1190	2020	1000	87200	88200	2023-02-01
1190	2021	1200	113100	114300	2023-02-01
1190	2022	1200	113100	114300	2023-02-01
1190	2023	1200	113100	114300	2023-12-18
1191	2020	0	84500	84500	2023-02-01
1191	2021	0	110100	110100	2023-02-01
1191	2022	0	110100	110100	2023-02-01
1191	2023	0	110100	110100	2023-12-18
1192	2020	0	18100	18100	2023-02-01
1192	2021	0	22300	22300	2023-02-01
1192	2022	0	22300	22300	2023-02-01
1192	2023	0	22300	22300	2023-12-18
1193	2020	0	68300	68300	2023-02-01
1193	2021	0	77500	77500	2023-02-01
1193	2022	0	77500	77500	2023-02-01
1193	2023	0	77500	77500	2023-12-18
1195	2020	289100	125600	414700	2023-02-01
1195	2021	314400	160200	474600	2023-02-01
1195	2022	318700	160200	478900	2023-02-01
1195	2023	318700	160200	478900	2023-12-18
1196	2020	347600	106300	453900	2023-02-01
1196	2021	325600	168700	494300	2023-02-01
1196	2022	325600	168700	494300	2023-02-01
1196	2023	328700	168700	497400	2023-12-18
1197	2020	3900	48900	52800	2023-02-01
1197	2021	4300	63600	67900	2023-02-01
1197	2022	4300	63600	67900	2023-02-01
1197	2023	4300	63600	67900	2023-12-18
1198	2020	0	0	0	2023-02-01
1198	2021	0	0	0	2023-02-01
1198	2022	0	0	0	2023-02-01
1198	2023	0	0	0	2023-12-18
1199	2020	106300	100200	206500	2023-02-01
1199	2021	119800	138500	258300	2023-02-01
1199	2022	119800	138500	258300	2023-02-01
1199	2023	119900	138500	258400	2023-12-18
12	2020	260800	171900	432700	2023-02-01
12	2021	261800	225200	487000	2023-02-01
12	2022	261800	225200	487000	2023-02-01
12	2023	261800	225200	487000	2023-12-18
120	2020	461500	277700	739200	2023-02-01
120	2021	462100	360800	822900	2023-02-01
120	2022	462100	360800	822900	2023-02-01
120	2023	462100	360800	822900	2023-12-18
1200	2020	121900	99800	221700	2023-02-01
1200	2021	165800	130700	296500	2023-02-01
1200	2022	165800	130700	296500	2023-02-01
1200	2023	168200	130700	298900	2023-12-18
1201	2020	271600	105500	377100	2023-02-01
1201	2021	284500	138100	422600	2023-02-01
1201	2022	284500	138100	422600	2023-02-01
1201	2023	272000	138100	410100	2023-12-18
1202	2020	308300	105500	413800	2023-02-01
1202	2021	294100	138100	432200	2023-02-01
1202	2022	294100	138100	432200	2023-02-01
1202	2023	296000	138100	434100	2023-12-18
1203	2020	169000	99800	268800	2023-02-01
1203	2021	189100	138100	327200	2023-02-01
1203	2022	189100	138100	327200	2023-02-01
1203	2023	189600	138100	327700	2023-12-18
1204	2020	223100	105500	328600	2023-02-01
1204	2021	187600	145500	333100	2023-02-01
1204	2022	187600	145500	333100	2023-02-01
1204	2023	190600	145500	336100	2023-12-18
1206	2020	0	565200	565200	2023-02-01
1206	2021	0	625400	625400	2023-02-01
1206	2022	0	625400	625400	2023-02-01
1206	2023	0	625400	625400	2023-12-18
1207	2020	0	12600	12600	2023-02-01
1207	2021	0	16100	16100	2023-02-01
1207	2022	0	16100	16100	2023-02-01
1207	2023	0	16100	16100	2023-12-18
1208	2020	288100	141600	429700	2023-02-01
1208	2021	293700	162800	456500	2023-02-01
1208	2022	293700	162800	456500	2023-02-01
1208	2023	299400	162800	462200	2023-12-18
1209	2020	278000	156700	434700	2023-02-01
1209	2021	294100	199500	493600	2023-02-01
1209	2022	294100	199500	493600	2023-02-01
1209	2023	300400	199500	499900	2023-12-18
121	2020	73600	115200	188800	2023-02-01
121	2021	2400	143700	146100	2023-02-01
121	2022	2900	143700	146600	2023-02-01
121	2023	124500	143700	268200	2023-12-18
1211	2020	112900	120000	232900	2023-02-01
1211	2021	116300	167700	284000	2023-02-01
1211	2022	116300	167700	284000	2023-02-01
1211	2023	118500	167700	286200	2023-12-18
1212	2020	369200	160700	529900	2023-02-01
1212	2021	470800	190000	660800	2023-02-01
1212	2022	474700	190000	664700	2023-02-01
1212	2023	474700	190000	664700	2023-12-18
1213	2020	393500	160800	554300	2023-02-01
1213	2021	390400	189300	579700	2023-02-01
1213	2022	390400	189300	579700	2023-02-01
1213	2023	400100	189300	589400	2023-12-18
1214	2020	0	200	200	2023-02-01
1214	2021	0	200	200	2023-02-01
1214	2022	0	200	200	2023-02-01
1214	2023	0	200	200	2023-12-18
1215	2020	0	5000	5000	2023-02-01
1215	2021	0	5000	5000	2023-02-01
1215	2022	0	5000	5000	2023-02-01
1215	2023	0	5000	5000	2023-12-18
122	2020	223700	105800	329500	2023-02-01
122	2021	273000	133300	406300	2023-02-01
122	2022	273000	133300	406300	2023-02-01
122	2023	273000	133300	406300	2023-12-18
1222	2020	316000	155300	471300	2023-02-01
1222	2021	376600	195800	572400	2023-02-01
1222	2022	428200	195800	624000	2023-02-01
1222	2023	479600	195700	675300	2023-12-18
1223	2020	0	7600	7600	2023-02-01
1223	2021	0	7600	7600	2023-02-01
1223	2022	0	7600	7600	2023-02-01
1223	2023	0	7300	7300	2023-12-18
1225	2020	215800	147900	363700	2023-02-01
1225	2021	222900	171500	394400	2023-02-01
1225	2022	222900	171500	394400	2023-02-01
1225	2023	224600	171400	396000	2023-12-18
1226	2020	828300	475500	1303800	2023-02-01
1226	2021	831300	458200	1289500	2023-02-01
1226	2022	831300	458400	1289700	2023-02-01
1226	2023	857800	458500	1316300	2023-12-18
1227	2020	404100	146300	550400	2023-02-01
1227	2021	425300	149000	574300	2023-02-01
1227	2022	425300	149000	574300	2023-02-01
1227	2023	425300	148800	574100	2023-12-18
1228	2020	139600	144500	284100	2023-02-01
1228	2021	162200	168600	330800	2023-02-01
1228	2022	162200	168600	330800	2023-02-01
1228	2023	161900	168600	330500	2023-12-18
1229	2020	38700	29100	67800	2023-02-01
1229	2021	34700	33200	67900	2023-02-01
1229	2022	34700	33200	67900	2023-02-01
1229	2023	34700	33200	67900	2023-12-18
123	2020	120600	105500	226100	2023-02-01
123	2021	151900	132200	284100	2023-02-01
123	2022	151900	132200	284100	2023-02-01
123	2023	151900	132200	284100	2023-12-18
1230	2020	302600	103300	405900	2023-02-01
1230	2021	358200	135100	493300	2023-02-01
1230	2022	358200	135200	493400	2023-02-01
1230	2023	358300	135100	493400	2023-12-18
1232	2020	157000	113400	270400	2023-02-01
1232	2021	156500	147100	303600	2023-02-01
1232	2022	156500	147100	303600	2023-02-01
1232	2023	155200	147100	302300	2023-12-18
1233	2020	277100	166400	443500	2023-02-01
1233	2021	304300	176600	480900	2023-02-01
1233	2022	304300	176600	480900	2023-02-01
1233	2023	304300	176600	480900	2023-12-18
1234	2020	100400	93900	194300	2023-02-01
1234	2021	129400	136700	266100	2023-02-01
1234	2022	129400	136700	266100	2023-02-01
1234	2023	132600	136700	269300	2023-12-18
1235	2020	71100	91700	162800	2023-02-01
1235	2021	114800	120800	235600	2023-02-01
1235	2022	114800	120800	235600	2023-02-01
1235	2023	114400	120800	235200	2023-12-18
1236	2020	51800	106900	158700	2023-02-01
1236	2021	66500	143200	209700	2023-02-01
1236	2022	66500	143200	209700	2023-02-01
1236	2023	65700	143200	208900	2023-12-18
124	2020	326200	140700	466900	2023-02-01
124	2021	354900	223000	577900	2023-02-01
124	2022	354900	223000	577900	2023-02-01
124	2023	354900	223000	577900	2023-12-18
1243	2020	0	3400	3400	2023-02-01
1243	2021	0	3400	3400	2023-02-01
1243	2022	0	3400	3400	2023-02-01
1243	2023	0	3300	3300	2023-12-18
1247	2020	426000	236900	662900	2023-02-01
1247	2021	510900	281800	792700	2023-02-01
1247	2022	510900	281800	792700	2023-02-01
1247	2023	520900	281700	802600	2023-12-18
1248	2020	431100	217500	648600	2023-02-01
1248	2021	455900	235400	691300	2023-02-01
1248	2022	455900	235400	691300	2023-02-01
1248	2023	521400	235400	756800	2023-12-18
1249	2020	161600	375100	536700	2023-02-01
1249	2021	176600	414100	590700	2023-02-01
1249	2022	176600	414100	590700	2023-02-01
1249	2023	176800	414100	590900	2023-12-18
125	2020	227400	119300	346700	2023-02-01
125	2021	272000	155700	427700	2023-02-01
125	2022	272000	155700	427700	2023-02-01
125	2023	272000	155700	427700	2023-12-18
1250	2020	275100	134800	409900	2023-02-01
1250	2021	278300	168700	447000	2023-02-01
1250	2022	278300	168700	447000	2023-02-01
1250	2023	281200	168700	449900	2023-12-18
1251	2020	382500	100300	482800	2023-02-01
1251	2021	457500	129900	587400	2023-02-01
1251	2022	457500	129900	587400	2023-02-01
1251	2023	457700	129900	587600	2023-12-18
1255	2020	284600	125300	409900	2023-02-01
1255	2021	363500	157800	521300	2023-02-01
1255	2022	363500	157800	521300	2023-02-01
1255	2023	368200	157800	526000	2023-12-18
1256	2020	244700	109400	354100	2023-02-01
1256	2021	238500	140300	378800	2023-02-01
1256	2022	238500	140300	378800	2023-02-01
1256	2023	240200	140300	380500	2023-12-18
1257	2020	130800	90300	221100	2023-02-01
1257	2021	149000	130700	279700	2023-02-01
1257	2022	149000	130700	279700	2023-02-01
1257	2023	149800	130700	280500	2023-12-18
1263	2020	156600	129000	285600	2023-02-01
1263	2021	156000	170500	326500	2023-02-01
1263	2022	156000	170500	326500	2023-02-01
1263	2023	156000	170300	326300	2023-12-18
1265	2020	249900	118100	368000	2023-02-01
1265	2021	255500	146600	402100	2023-02-01
1265	2022	255500	146600	402100	2023-02-01
1265	2023	256800	146600	403400	2023-12-18
1266	2020	302300	140100	442400	2023-02-01
1266	2021	324100	173300	497400	2023-02-01
1266	2022	324100	173300	497400	2023-02-01
1266	2023	338200	173300	511500	2023-12-18
1267	2020	209900	103700	313600	2023-02-01
1267	2021	278100	149300	427400	2023-02-01
1267	2022	278100	149300	427400	2023-02-01
1267	2023	278700	149300	428000	2023-12-18
1268	2020	13000	91900	104900	2023-02-01
1268	2021	28300	126800	155100	2023-02-01
1268	2022	21400	118300	139700	2023-02-01
1268	2023	21400	118300	139700	2023-12-18
1269	2020	190400	100000	290400	2023-02-01
1269	2021	184700	136800	321500	2023-02-01
1269	2022	184700	136800	321500	2023-02-01
1269	2023	184700	136800	321500	2023-12-18
127	2020	263100	114100	377200	2023-02-01
127	2021	240200	153300	393500	2023-02-01
127	2022	240200	153300	393500	2023-02-01
127	2023	240200	153300	393500	2023-12-18
1270	2020	0	4500	4500	2023-02-01
1270	2021	0	5200	5200	2023-02-01
1270	2022	0	5200	5200	2023-02-01
1270	2023	0	5200	5200	2023-12-18
1271	2020	321200	111500	432700	2023-02-01
1271	2021	312500	150800	463300	2023-02-01
1271	2022	312500	150800	463300	2023-02-01
1271	2023	312500	150800	463300	2023-12-18
1272	2020	367100	120100	487200	2023-02-01
1272	2021	369200	151700	520900	2023-02-01
1272	2022	389400	151700	541100	2023-02-01
1272	2023	389400	151500	540900	2023-12-18
1274	2020	306100	128300	434400	2023-02-01
1274	2021	312200	168100	480300	2023-02-01
1274	2022	312200	168100	480300	2023-02-01
1274	2023	305400	168100	473500	2023-12-18
1277	2020	0	13900	13900	2023-02-01
1277	2021	0	13900	13900	2023-02-01
1277	2022	0	13900	13900	2023-02-01
1277	2023	0	13700	13700	2023-12-18
128	2020	416100	111500	527600	2023-02-01
128	2021	395000	188500	583500	2023-02-01
128	2022	395000	188500	583500	2023-02-01
128	2023	395000	188500	583500	2023-12-18
1282	2020	0	261200	261200	2023-02-01
1282	2021	0	304600	304600	2023-02-01
1282	2022	0	304600	304600	2023-02-01
1282	2023	0	304600	304600	2023-12-18
1289	2020	0	2600	2600	2023-02-01
1289	2021	0	2600	2600	2023-02-01
1289	2022	0	2600	2600	2023-02-01
1289	2023	0	2600	2600	2023-12-18
129	2020	170700	124600	295300	2023-02-01
129	2021	182300	157500	339800	2023-02-01
129	2022	182300	157500	339800	2023-02-01
129	2023	182300	157500	339800	2023-12-18
1291	2020	0	400	400	2023-02-01
1291	2021	0	400	400	2023-02-01
1291	2022	0	400	400	2023-02-01
1291	2023	0	400	400	2023-12-18
1292	2020	0	168000	168000	2023-02-01
1292	2021	0	186800	186800	2023-02-01
1292	2022	0	186800	186800	2023-02-01
1292	2023	0	186800	186800	2023-12-18
1298	2020	900600	225200	1125800	2023-02-01
1298	2021	1009200	171600	1180800	2023-02-01
1298	2022	1014200	171600	1185800	2023-02-01
1298	2023	1015500	171500	1187000	2023-12-18
1299	2020	312600	93000	405600	2023-02-01
1299	2021	329400	124400	453800	2023-02-01
1299	2022	329400	124400	453800	2023-02-01
1299	2023	334900	124400	459300	2023-12-18
13	2020	257200	186800	444000	2023-02-01
13	2021	275700	280700	556400	2023-02-01
13	2022	275700	280700	556400	2023-02-01
13	2023	275700	280700	556400	2023-12-18
1302	2020	0	157900	157900	2023-02-01
1302	2021	0	191600	191600	2023-02-01
1302	2022	0	191600	191600	2023-02-01
1302	2023	0	191600	191600	2023-12-18
1304	2020	782300	765000	1547300	2023-02-01
1304	2021	830300	1101600	1931900	2023-02-01
1304	2022	830300	1101600	1931900	2023-02-01
1304	2023	830300	1101100	1931400	2023-12-18
1305	2020	3564000	286000	3850000	2023-02-01
1305	2021	3697300	337000	4034300	2023-02-01
1305	2022	3697300	337000	4034300	2023-02-01
1305	2023	3697300	337000	4034300	2023-12-18
1309	2020	0	5200	5200	2023-02-01
1309	2021	0	5200	5200	2023-02-01
1309	2022	0	5200	5200	2023-02-01
1309	2023	0	5000	5000	2023-12-18
1311	2020	411300	215900	627200	2023-02-01
1311	2021	441600	237500	679100	2023-02-01
1311	2022	441600	237500	679100	2023-02-01
1311	2023	441600	237500	679100	2023-12-18
1312	2020	0	708000	708000	2023-02-01
1312	2021	0	778800	778800	2023-02-01
1312	2022	0	778800	778800	2023-02-01
1312	2023	0	778800	778800	2023-12-18
1313	2020	235400	97100	332500	2023-02-01
1313	2021	241900	133700	375600	2023-02-01
1313	2022	241900	133700	375600	2023-02-01
1313	2023	266300	133800	400100	2023-12-18
1319	2020	3900	20900	24800	2023-02-01
1319	2021	5700	17500	23200	2023-02-01
1319	2022	5700	17500	23200	2023-02-01
1319	2023	5700	17400	23100	2023-12-18
132	2020	0	33700	33700	2023-02-01
132	2021	0	40300	40300	2023-02-01
132	2022	0	40300	40300	2023-02-01
132	2023	0	40300	40300	2023-12-18
1323	2020	368900	171300	540200	2023-02-01
1323	2021	402700	163300	566000	2023-02-01
1323	2022	402700	163300	566000	2023-02-01
1323	2023	405400	163300	568700	2023-12-18
1325	2020	176000	193300	369300	2023-02-01
1325	2021	207200	252600	459800	2023-02-01
1325	2022	207200	252600	459800	2023-02-01
1325	2023	224400	252600	477000	2023-12-18
1326	2020	693500	280700	974200	2023-02-01
1326	2021	780700	260200	1040900	2023-02-01
1326	2022	780700	260200	1040900	2023-02-01
1326	2023	788400	260100	1048500	2023-12-18
1327	2020	0	396800	396800	2023-02-01
1327	2021	0	435200	435200	2023-02-01
1327	2022	0	435200	435200	2023-02-01
1327	2023	0	435200	435200	2023-12-18
133	2020	38500	0	38500	2023-02-01
133	2021	42000	0	42000	2023-02-01
133	2022	42000	0	42000	2023-02-01
133	2023	42000	0	42000	2023-12-18
1332	2020	0	2700	2700	2023-02-01
1332	2021	0	2700	2700	2023-02-01
1332	2022	0	2700	2700	2023-02-01
1332	2023	0	2600	2600	2023-12-18
1333	2020	417400	217900	635300	2023-02-01
1333	2021	527300	224000	751300	2023-02-01
1333	2022	527300	224000	751300	2023-02-01
1333	2023	527300	223900	751200	2023-12-18
1335	2020	309700	243500	553200	2023-02-01
1335	2021	307900	254700	562600	2023-02-01
1335	2022	307900	254700	562600	2023-02-01
1335	2023	308200	254700	562900	2023-12-18
1336	2020	0	7000	7000	2023-02-01
1336	2021	0	7000	7000	2023-02-01
1336	2022	0	7000	7000	2023-02-01
1336	2023	0	6900	6900	2023-12-18
1337	2020	0	800	800	2023-02-01
1337	2021	0	800	800	2023-02-01
1337	2022	0	800	800	2023-02-01
1337	2023	0	800	800	2023-12-18
1338	2020	518300	155300	673600	2023-02-01
1338	2021	546500	178300	724800	2023-02-01
1338	2022	546500	178300	724800	2023-02-01
1338	2023	547800	178300	726100	2023-12-18
1340	2020	306100	194900	501000	2023-02-01
1340	2021	225000	195500	420500	2023-02-01
1340	2022	225000	195500	420500	2023-02-01
1340	2023	225000	195500	420500	2023-12-18
1341	2020	540800	231100	771900	2023-02-01
1341	2021	644800	202500	847300	2023-02-01
1341	2022	644800	202500	847300	2023-02-01
1341	2023	632100	202500	834600	2023-12-18
1342	2020	405700	196500	602200	2023-02-01
1342	2021	456000	230800	686800	2023-02-01
1342	2022	456000	230800	686800	2023-02-01
1342	2023	456000	230800	686800	2023-12-18
1343	2020	111900	160500	272400	2023-02-01
1343	2021	100700	198500	299200	2023-02-01
1343	2022	100700	198500	299200	2023-02-01
1343	2023	104100	198500	302600	2023-12-18
1344	2020	503200	271000	774200	2023-02-01
1344	2021	518400	278300	796700	2023-02-01
1344	2022	518400	278300	796700	2023-02-01
1344	2023	544800	278800	823600	2023-12-18
1352	2020	248600	244300	492900	2023-02-01
1352	2021	280600	235100	515700	2023-02-01
1352	2022	280600	235100	515700	2023-02-01
1352	2023	310500	235000	545500	2023-12-18
1353	2020	674200	246700	920900	2023-02-01
1353	2021	716800	255300	972100	2023-02-01
1353	2022	716800	255300	972100	2023-02-01
1353	2023	725400	255300	980700	2023-12-18
1354	2020	390500	244400	634900	2023-02-01
1354	2021	328100	345100	673200	2023-02-01
1354	2022	328100	345100	673200	2023-02-01
1354	2023	328100	345100	673200	2023-12-18
1355	2020	0	7500	7500	2023-02-01
1355	2021	0	7500	7500	2023-02-01
1355	2022	0	7500	7500	2023-02-01
1355	2023	0	7700	7700	2023-12-18
1356	2020	0	59500	59500	2023-02-01
1356	2021	0	59500	59500	2023-02-01
1356	2022	0	59500	59500	2023-02-01
1356	2023	0	60500	60500	2023-12-18
1358	2020	0	1800	1800	2023-02-01
1358	2021	0	1800	1800	2023-02-01
1358	2022	0	1900	1900	2023-02-01
1358	2023	0	1800	1800	2023-12-18
136	2020	13400	9700	23100	2023-02-01
136	2021	15200	12200	27400	2023-02-01
136	2022	15200	12200	27400	2023-02-01
136	2023	15200	12200	27400	2023-12-18
1360	2020	0	12400	12400	2023-02-01
1360	2021	0	12400	12400	2023-02-01
1360	2022	0	12400	12400	2023-02-01
1360	2023	0	12500	12500	2023-12-18
1361	2020	0	3000	3000	2023-02-01
1361	2021	0	3000	3000	2023-02-01
1361	2022	0	3000	3000	2023-02-01
1361	2023	0	2900	2900	2023-12-18
1362	2020	0	13300	13300	2023-02-01
1362	2021	0	14700	14700	2023-02-01
1362	2022	0	14700	14700	2023-02-01
1362	2023	0	14700	14700	2023-12-18
1363	2020	0	7600	7600	2023-02-01
1363	2021	0	8500	8500	2023-02-01
1363	2022	0	8500	8500	2023-02-01
1363	2023	0	8800	8800	2023-12-18
1364	2020	0	1500	1500	2023-02-01
1364	2021	0	1500	1500	2023-02-01
1364	2022	0	1500	1500	2023-02-01
1364	2023	0	1500	1500	2023-12-18
1365	2020	0	200	200	2023-02-01
1365	2021	0	200	200	2023-02-01
1365	2022	0	200	200	2023-02-01
1365	2023	0	200	200	2023-12-18
1366	2020	0	1600	1600	2023-02-01
1366	2021	0	1600	1600	2023-02-01
1366	2022	0	1600	1600	2023-02-01
1366	2023	0	1500	1500	2023-12-18
1367	2020	3300	162900	166200	2023-02-01
1367	2021	1900	207700	209600	2023-02-01
1367	2022	1900	207700	209600	2023-02-01
1367	2023	1900	207700	209600	2023-12-18
137	2020	42400	154600	197000	2023-02-01
137	2021	46900	189400	236300	2023-02-01
137	2022	46900	189400	236300	2023-02-01
137	2023	46900	189400	236300	2023-12-18
1373	2020	946000	403700	1349700	2023-02-01
1373	2021	970800	433900	1404700	2023-02-01
1373	2022	970800	433900	1404700	2023-02-01
1373	2023	969500	433700	1403200	2023-12-18
1374	2020	181700	207800	389500	2023-02-01
1374	2021	271300	225400	496700	2023-02-01
1374	2022	271300	225400	496700	2023-02-01
1374	2023	271300	225400	496700	2023-12-18
1375	2020	1201400	535400	1736800	2023-02-01
1375	2021	1454000	363600	1817600	2023-02-01
1375	2022	1454000	363600	1817600	2023-02-01
1375	2023	1454000	365500	1819500	2023-12-18
1379	2020	0	4300	4300	2023-02-01
1379	2021	0	4300	4300	2023-02-01
1379	2022	0	4300	4300	2023-02-01
1379	2023	0	4100	4100	2023-12-18
138	2020	1092000	237600	1329600	2023-02-01
138	2021	1194500	246000	1440500	2023-02-01
138	2022	1194500	246000	1440500	2023-02-01
138	2023	1194500	246000	1440500	2023-12-18
1382	2020	495200	390700	885900	2023-02-01
1382	2021	613200	345400	958600	2023-02-01
1382	2022	613200	345400	958600	2023-02-01
1382	2023	630500	345400	975900	2023-12-18
1384	2020	514900	340200	855100	2023-02-01
1384	2021	633900	226500	860400	2023-02-01
1384	2022	633900	226400	860300	2023-02-01
1384	2023	644500	226300	870800	2023-12-18
1385	2020	468200	224500	692700	2023-02-01
1385	2021	596200	172300	768500	2023-02-01
1385	2022	596100	172400	768500	2023-02-01
1385	2023	596100	172400	768500	2023-12-18
1386	2020	843000	392100	1235100	2023-02-01
1386	2021	800900	405800	1206700	2023-02-01
1386	2022	800900	405800	1206700	2023-02-01
1386	2023	800900	405800	1206700	2023-12-18
1387	2020	0	2800	2800	2023-02-01
1387	2021	0	2800	2800	2023-02-01
1387	2022	0	2900	2900	2023-02-01
1387	2023	0	2800	2800	2023-12-18
1388	2020	0	8200	8200	2023-02-01
1388	2021	0	8200	8200	2023-02-01
1388	2022	0	8200	8200	2023-02-01
1388	2023	0	8500	8500	2023-12-18
1389	2020	111500	141900	253400	2023-02-01
1389	2021	159400	177400	336800	2023-02-01
1389	2022	159400	177400	336800	2023-02-01
1389	2023	159400	177400	336800	2023-12-18
139	2020	73400	132400	205800	2023-02-01
139	2021	81400	166400	247800	2023-02-01
139	2022	81400	166400	247800	2023-02-01
139	2023	81400	166400	247800	2023-12-18
1394	2020	0	11800	11800	2023-02-01
1394	2021	0	11800	11800	2023-02-01
1394	2022	0	12400	12400	2023-02-01
1394	2023	0	12700	12700	2023-12-18
1399	2020	0	3600	3600	2023-02-01
1399	2021	0	3600	3600	2023-02-01
1399	2022	0	3600	3600	2023-02-01
1399	2023	0	3500	3500	2023-12-18
140	2020	531800	156000	687800	2023-02-01
140	2021	575300	151500	726800	2023-02-01
140	2022	575300	151500	726800	2023-02-01
140	2023	595300	151500	746800	2023-12-18
1400	2020	0	6300	6300	2023-02-01
1400	2021	0	6300	6300	2023-02-01
1400	2022	0	6700	6700	2023-02-01
1400	2023	0	6100	6100	2023-12-18
1401	2020	0	3300	3300	2023-02-01
1401	2021	0	3300	3300	2023-02-01
1401	2022	0	3300	3300	2023-02-01
1401	2023	0	3600	3600	2023-12-18
1402	2020	0	4000	4000	2023-02-01
1402	2021	0	4000	4000	2023-02-01
1402	2022	0	4000	4000	2023-02-01
1402	2023	0	3800	3800	2023-12-18
1403	2020	0	100	100	2023-02-01
1403	2021	0	100	100	2023-02-01
1403	2022	0	100	100	2023-02-01
1403	2023	0	100	100	2023-12-18
1406	2020	754700	274500	1029200	2023-02-01
1406	2021	703700	230000	933700	2023-02-01
1406	2022	703700	229900	933600	2023-02-01
1406	2023	694100	229600	923700	2023-12-18
1410	2020	153800	114800	268600	2023-02-01
1410	2021	165400	109200	274600	2023-02-01
1410	2022	165400	109200	274600	2023-02-01
1410	2023	165400	109100	274500	2023-12-18
1412	2020	96200	75900	172100	2023-02-01
1412	2021	105000	97900	202900	2023-02-01
1412	2022	105000	97900	202900	2023-02-01
1412	2023	105000	97700	202700	2023-12-18
1413	2020	0	2100	2100	2023-02-01
1413	2021	0	2100	2100	2023-02-01
1413	2022	0	2100	2100	2023-02-01
1413	2023	0	2200	2200	2023-12-18
1417	2020	0	16700	16700	2023-02-01
1417	2021	0	16700	16700	2023-02-01
1417	2022	0	16700	16700	2023-02-01
1417	2023	0	16300	16300	2023-12-18
142	2020	190500	184600	375100	2023-02-01
142	2021	183800	209900	393700	2023-02-01
142	2022	183800	209900	393700	2023-02-01
142	2023	183800	209900	393700	2023-12-18
1423	2020	0	311000	311000	2023-02-01
1423	2021	0	342200	342200	2023-02-01
1423	2022	0	342200	342200	2023-02-01
1423	2023	0	342200	342200	2023-12-18
143	2020	289400	181800	471200	2023-02-01
143	2021	334100	206900	541000	2023-02-01
143	2022	334100	206900	541000	2023-02-01
143	2023	334100	206900	541000	2023-12-18
1435	2020	0	80300	80300	2023-02-01
1435	2021	0	88300	88300	2023-02-01
1435	2022	0	88300	88300	2023-02-01
1435	2023	0	88300	88300	2023-12-18
1436	2020	0	51900	51900	2023-02-01
1436	2021	0	57100	57100	2023-02-01
1436	2022	0	57100	57100	2023-02-01
1436	2023	0	57100	57100	2023-12-18
1437	2020	0	166900	166900	2023-02-01
1437	2021	0	183500	183500	2023-02-01
1437	2022	0	183500	183500	2023-02-01
1437	2023	0	183500	183500	2023-12-18
1438	2020	0	159300	159300	2023-02-01
1438	2021	0	177200	177200	2023-02-01
1438	2022	0	177200	177200	2023-02-01
1438	2023	0	177200	177200	2023-12-18
1439	2020	0	77200	77200	2023-02-01
1439	2021	0	85000	85000	2023-02-01
1439	2022	0	85000	85000	2023-02-01
1439	2023	0	85000	85000	2023-12-18
144	2020	138000	111800	249800	2023-02-01
144	2021	144800	133000	277800	2023-02-01
144	2022	145200	133000	278200	2023-02-01
144	2023	145200	133000	278200	2023-12-18
1440	2020	0	367600	367600	2023-02-01
1440	2021	0	404400	404400	2023-02-01
1440	2022	0	404400	404400	2023-02-01
1440	2023	0	404400	404400	2023-12-18
1441	2020	0	6800	6800	2023-02-01
1441	2021	0	7500	7500	2023-02-01
1441	2022	0	7500	7500	2023-02-01
1441	2023	0	7500	7500	2023-12-18
1442	2020	0	9200	9200	2023-02-01
1442	2021	0	10900	10900	2023-02-01
1442	2022	0	10900	10900	2023-02-01
1442	2023	0	10900	10900	2023-12-18
1443	2020	0	5900	5900	2023-02-01
1443	2021	0	5900	5900	2023-02-01
1443	2022	0	5900	5900	2023-02-01
1443	2023	0	5600	5600	2023-12-18
1446	2020	0	11000	11000	2023-02-01
1446	2021	0	11000	11000	2023-02-01
1446	2022	0	11000	11000	2023-02-01
1446	2023	0	11100	11100	2023-12-18
1447	2020	200	2500	2700	2023-02-01
1447	2021	200	2500	2700	2023-02-01
1447	2022	200	2500	2700	2023-02-01
1447	2023	200	2500	2700	2023-12-18
1448	2020	0	142000	142000	2023-02-01
1448	2021	0	183000	183000	2023-02-01
1448	2022	0	183000	183000	2023-02-01
1448	2023	0	183100	183100	2023-12-18
1449	2020	79000	179900	258900	2023-02-01
1449	2021	60700	274900	335600	2023-02-01
1449	2022	60700	274900	335600	2023-02-01
1449	2023	60900	274900	335800	2023-12-18
1450	2020	16600	64000	80600	2023-02-01
1450	2021	18900	73200	92100	2023-02-01
1450	2022	18900	73200	92100	2023-02-01
1450	2023	20000	73200	93200	2023-12-18
1451	2020	86700	118800	205500	2023-02-01
1451	2021	109100	145500	254600	2023-02-01
1451	2022	109100	145500	254600	2023-02-01
1451	2023	110600	145500	256100	2023-12-18
1455	2020	208300	142200	350500	2023-02-01
1455	2021	219200	230900	450100	2023-02-01
1455	2022	224900	230900	455800	2023-02-01
1455	2023	224900	230900	455800	2023-12-18
1456	2020	27700	110900	138600	2023-02-01
1456	2021	34800	173700	208500	2023-02-01
1456	2022	18300	173700	192000	2023-02-01
1456	2023	16800	173700	190500	2023-12-18
1457	2020	123200	132400	255600	2023-02-01
1457	2021	122000	159100	281100	2023-02-01
1457	2022	122000	159100	281100	2023-02-01
1457	2023	123900	159100	283000	2023-12-18
1462	2020	280900	216200	497100	2023-02-01
1462	2021	316800	276100	592900	2023-02-01
1462	2022	316800	276100	592900	2023-02-01
1462	2023	301600	276100	577700	2023-12-18
1464	2020	0	1300	1300	2023-02-01
1464	2021	0	1300	1300	2023-02-01
1464	2022	0	1300	1300	2023-02-01
1464	2023	0	1300	1300	2023-12-18
1466	2020	0	3600	3600	2023-02-01
1466	2021	0	3600	3600	2023-02-01
1466	2022	0	3600	3600	2023-02-01
1466	2023	0	3300	3300	2023-12-18
1468	2020	232700	186000	418700	2023-02-01
1468	2021	280800	257500	538300	2023-02-01
1468	2022	280800	257600	538400	2023-02-01
1468	2023	281600	257500	539100	2023-12-18
1469	2020	0	70600	70600	2023-02-01
1469	2021	0	75600	75600	2023-02-01
1469	2022	0	75600	75600	2023-02-01
1469	2023	0	75600	75600	2023-12-18
1471	2020	13000	67300	80300	2023-02-01
1471	2021	13000	165800	178800	2023-02-01
1471	2022	13000	165800	178800	2023-02-01
1471	2023	12900	165800	178700	2023-12-18
1472	2020	44100	156400	200500	2023-02-01
1472	2021	51300	236400	287700	2023-02-01
1472	2022	56000	236400	292400	2023-02-01
1472	2023	59200	236400	295600	2023-12-18
1473	2020	165800	161000	326800	2023-02-01
1473	2021	163200	276700	439900	2023-02-01
1473	2022	163200	276700	439900	2023-02-01
1473	2023	167300	276700	444000	2023-12-18
1475	2020	46200	126000	172200	2023-02-01
1475	2021	32700	240800	273500	2023-02-01
1475	2022	64200	240800	305000	2023-02-01
1475	2023	72800	240700	313500	2023-12-18
1477	2020	79700	106000	185700	2023-02-01
1477	2021	95100	139000	234100	2023-02-01
1477	2022	94400	139000	233400	2023-02-01
1477	2023	94400	139000	233400	2023-12-18
148	2020	138200	108700	246900	2023-02-01
148	2021	163800	142700	306500	2023-02-01
148	2022	163800	142700	306500	2023-02-01
148	2023	163800	142700	306500	2023-12-18
1484	2020	87300	123600	210900	2023-02-01
1484	2021	105200	166100	271300	2023-02-01
1484	2022	105200	166100	271300	2023-02-01
1484	2023	114700	166100	280800	2023-12-18
1485	2020	120000	148400	268400	2023-02-01
1485	2021	152700	201200	353900	2023-02-01
1485	2022	152700	201200	353900	2023-02-01
1485	2023	152700	201200	353900	2023-12-18
1486	2020	256300	98100	354400	2023-02-01
1486	2021	270400	120200	390600	2023-02-01
1486	2022	270400	120200	390600	2023-02-01
1486	2023	276300	119900	396200	2023-12-18
1488	2020	0	11200	11200	2023-02-01
1488	2021	0	11200	11200	2023-02-01
1488	2022	0	11200	11200	2023-02-01
1488	2023	0	10900	10900	2023-12-18
1489	2020	0	6400	6400	2023-02-01
1489	2021	0	6400	6400	2023-02-01
1489	2022	0	6400	6400	2023-02-01
1489	2023	0	6900	6900	2023-12-18
149	2020	290200	130100	420300	2023-02-01
149	2021	385600	171200	556800	2023-02-01
149	2022	385600	171200	556800	2023-02-01
149	2023	385600	171200	556800	2023-12-18
150	2020	124300	129200	253500	2023-02-01
150	2021	410700	170200	580900	2023-02-01
150	2022	410700	170200	580900	2023-02-01
150	2023	402500	170200	572700	2023-12-18
151	2020	0	137300	137300	2023-02-01
151	2021	0	218500	218500	2023-02-01
151	2022	0	218500	218500	2023-02-01
151	2023	0	218500	218500	2023-12-18
152	2020	130800	70400	201200	2023-02-01
152	2021	175200	84800	260000	2023-02-01
152	2022	176000	84800	260800	2023-02-01
152	2023	176000	84800	260800	2023-12-18
153	2020	138400	90300	228700	2023-02-01
153	2021	149400	111300	260700	2023-02-01
153	2022	149400	111300	260700	2023-02-01
153	2023	149400	111300	260700	2023-12-18
154	2020	66800	72000	138800	2023-02-01
154	2021	82500	82400	164900	2023-02-01
154	2022	82500	82400	164900	2023-02-01
154	2023	82500	82400	164900	2023-12-18
159	2020	17900	127200	145100	2023-02-01
159	2021	21200	166100	187300	2023-02-01
159	2022	21200	166100	187300	2023-02-01
159	2023	23700	166100	189800	2023-12-18
16	2020	913900	292700	1206600	2023-02-01
16	2021	1016100	385700	1401800	2023-02-01
16	2022	1016100	385700	1401800	2023-02-01
16	2023	1016100	385700	1401800	2023-12-18
161	2020	592300	158900	751200	2023-02-01
161	2021	562100	219600	781700	2023-02-01
161	2022	562100	219600	781700	2023-02-01
161	2023	562100	219600	781700	2023-12-18
162	2020	165400	97100	262500	2023-02-01
162	2021	165400	126800	292200	2023-02-01
162	2022	165400	126800	292200	2023-02-01
162	2023	172300	126800	299100	2023-12-18
163	2020	298800	97300	396100	2023-02-01
163	2021	269600	158900	428500	2023-02-01
163	2022	269600	158900	428500	2023-02-01
163	2023	269600	158900	428500	2023-12-18
164	2020	38900	83100	122000	2023-02-01
164	2021	46200	98300	144500	2023-02-01
164	2022	46200	98300	144500	2023-02-01
164	2023	46200	98300	144500	2023-12-18
167	2020	279800	110300	390100	2023-02-01
167	2021	289300	224000	513300	2023-02-01
167	2022	289300	224000	513300	2023-02-01
167	2023	289300	224000	513300	2023-12-18
168	2020	146700	98800	245500	2023-02-01
168	2021	174500	129600	304100	2023-02-01
168	2022	174500	129600	304100	2023-02-01
168	2023	174500	129600	304100	2023-12-18
169	2020	130800	92200	223000	2023-02-01
169	2021	154200	111100	265300	2023-02-01
169	2022	154200	111100	265300	2023-02-01
169	2023	154200	111100	265300	2023-12-18
170	2020	1095300	204200	1299500	2023-02-01
170	2021	1225500	266800	1492300	2023-02-01
170	2022	1225500	266800	1492300	2023-02-01
170	2023	1225500	266800	1492300	2023-12-18
171	2020	0	200	200	2023-02-01
171	2021	0	200	200	2023-02-01
171	2022	0	200	200	2023-02-01
171	2023	0	200	200	2023-12-18
172	2020	0	300	300	2023-02-01
172	2021	0	300	300	2023-02-01
172	2022	0	300	300	2023-02-01
172	2023	0	300	300	2023-12-18
173	2020	361400	117800	479200	2023-02-01
173	2021	465200	154000	619200	2023-02-01
173	2022	465200	146600	611800	2023-02-01
173	2023	465200	146600	611800	2023-12-18
174	2020	136900	100500	237400	2023-02-01
174	2021	152300	132200	284500	2023-02-01
174	2022	152300	132200	284500	2023-02-01
174	2023	152300	132200	284500	2023-12-18
176	2020	116500	105000	221500	2023-02-01
176	2021	156600	137900	294500	2023-02-01
176	2022	156600	137900	294500	2023-02-01
176	2023	156600	137900	294500	2023-12-18
177	2020	92300	88300	180600	2023-02-01
177	2021	85100	129800	214900	2023-02-01
177	2022	81400	129800	211200	2023-02-01
177	2023	81400	129800	211200	2023-12-18
178	2020	205300	97000	302300	2023-02-01
178	2021	231800	126600	358400	2023-02-01
178	2022	231800	126600	358400	2023-02-01
178	2023	231800	126600	358400	2023-12-18
179	2020	140700	105200	245900	2023-02-01
179	2021	149400	138100	287500	2023-02-01
179	2022	149400	138100	287500	2023-02-01
179	2023	149400	138100	287500	2023-12-18
18	2020	161500	138400	299900	2023-02-01
18	2021	162500	139100	301600	2023-02-01
18	2022	194000	139100	333100	2023-02-01
18	2023	194000	122600	316600	2023-12-18
180	2020	557700	225900	783600	2023-02-01
180	2021	597800	214300	812100	2023-02-01
180	2022	597800	214300	812100	2023-02-01
180	2023	597800	214300	812100	2023-12-18
181	2020	0	2400	2400	2023-02-01
181	2021	0	2500	2500	2023-02-01
181	2022	0	2500	2500	2023-02-01
181	2023	0	2500	2500	2023-12-18
182	2020	520800	227800	748600	2023-02-01
182	2021	507900	178200	686100	2023-02-01
182	2022	507900	178200	686100	2023-02-01
182	2023	546700	178200	724900	2023-12-18
183	2020	12500	67000	79500	2023-02-01
183	2021	10900	103000	113900	2023-02-01
183	2022	282900	103000	385900	2023-02-01
183	2023	282900	103000	385900	2023-12-18
187	2020	259400	131200	390600	2023-02-01
187	2021	351200	193100	544300	2023-02-01
187	2022	314000	170900	484900	2023-02-01
187	2023	314000	170800	484800	2023-12-18
188	2020	234300	161800	396100	2023-02-01
188	2021	329500	218400	547900	2023-02-01
188	2022	613900	260000	873900	2023-02-01
188	2023	613900	260000	873900	2023-12-18
189	2020	7800	35200	43000	2023-02-01
189	2021	8500	44800	53300	2023-02-01
189	2022	8500	44800	53300	2023-02-01
189	2023	8500	44800	53300	2023-12-18
19	2020	82100	53500	135600	2023-02-01
19	2021	91700	62300	154000	2023-02-01
19	2022	125000	62300	187300	2023-02-01
19	2023	125000	106300	231300	2023-12-18
190	2020	0	1000	1000	2023-02-01
190	2021	0	1000	1000	2023-02-01
190	2022	0	1000	1000	2023-02-01
190	2023	0	1000	1000	2023-12-18
191	2020	0	6000	6000	2023-02-01
191	2021	0	6000	6000	2023-02-01
191	2022	0	6000	6000	2023-02-01
191	2023	0	5700	5700	2023-12-18
192	2020	0	25500	25500	2023-02-01
192	2021	0	25500	25500	2023-02-01
192	2022	0	25500	25500	2023-02-01
192	2023	0	24100	24100	2023-12-18
194	2020	0	100	100	2023-02-01
194	2021	0	100	100	2023-02-01
194	2022	0	100	100	2023-02-01
194	2023	0	100	100	2023-12-18
195	2020	328100	138000	466100	2023-02-01
195	2021	343500	176200	519700	2023-02-01
195	2022	343500	176200	519700	2023-02-01
195	2023	343500	176200	519700	2023-12-18
197	2020	0	2500	2500	2023-02-01
197	2021	0	2500	2500	2023-02-01
197	2022	0	2500	2500	2023-02-01
197	2023	0	2600	2600	2023-12-18
20	2020	367500	206400	573900	2023-02-01
20	2021	381400	234400	615800	2023-02-01
20	2022	381400	234400	615800	2023-02-01
20	2023	381400	234400	615800	2023-12-18
201	2020	350000	101500	451500	2023-02-01
201	2021	322700	134800	457500	2023-02-01
201	2022	322700	134800	457500	2023-02-01
201	2023	322700	134700	457400	2023-12-18
202	2020	377800	227900	605700	2023-02-01
202	2021	392300	293300	685600	2023-02-01
202	2022	418600	293300	711900	2023-02-01
202	2023	420600	292700	713300	2023-12-18
203	2020	195200	93600	288800	2023-02-01
203	2021	232400	125100	357500	2023-02-01
203	2022	232400	125100	357500	2023-02-01
203	2023	232400	125100	357500	2023-12-18
204	2020	256600	173200	429800	2023-02-01
204	2021	396000	324800	720800	2023-02-01
204	2022	396000	324800	720800	2023-02-01
204	2023	396000	324500	720500	2023-12-18
206	2020	566800	103200	670000	2023-02-01
206	2021	606800	135800	742600	2023-02-01
206	2022	606800	135800	742600	2023-02-01
206	2023	606800	135700	742500	2023-12-18
207	2020	1500	52700	54200	2023-02-01
207	2021	1700	52700	54400	2023-02-01
207	2022	1700	52700	54400	2023-02-01
207	2023	1700	52300	54000	2023-12-18
208	2020	172800	98300	271100	2023-02-01
208	2021	180600	142400	323000	2023-02-01
208	2022	180600	142400	323000	2023-02-01
208	2023	136600	142400	279000	2023-12-18
209	2020	102800	99100	201900	2023-02-01
209	2021	119000	143300	262300	2023-02-01
209	2022	124500	143300	267800	2023-02-01
209	2023	124500	143300	267800	2023-12-18
21	2020	409800	203600	613400	2023-02-01
21	2021	398100	288400	686500	2023-02-01
21	2022	398100	288400	686500	2023-02-01
21	2023	398100	288400	686500	2023-12-18
210	2020	186600	99100	285700	2023-02-01
210	2021	193800	143300	337100	2023-02-01
210	2022	193800	143300	337100	2023-02-01
210	2023	193800	143300	337100	2023-12-18
217	2020	0	2600	2600	2023-02-01
217	2021	0	2600	2600	2023-02-01
217	2022	0	2600	2600	2023-02-01
217	2023	0	2500	2500	2023-12-18
219	2020	189400	99100	288500	2023-02-01
219	2021	176100	164500	340600	2023-02-01
219	2022	176100	164500	340600	2023-02-01
219	2023	176100	164500	340600	2023-12-18
22	2020	211300	178700	390000	2023-02-01
22	2021	269300	179700	449000	2023-02-01
22	2022	269300	179700	449000	2023-02-01
22	2023	269300	179700	449000	2023-12-18
220	2020	140700	82700	223400	2023-02-01
220	2021	180400	108100	288500	2023-02-01
220	2022	180400	108100	288500	2023-02-01
220	2023	180400	108100	288500	2023-12-18
221	2020	173600	73500	247100	2023-02-01
221	2021	221900	95600	317500	2023-02-01
221	2022	221900	95600	317500	2023-02-01
221	2023	221900	95600	317500	2023-12-18
222	2020	232300	126700	359000	2023-02-01
222	2021	269100	168700	437800	2023-02-01
222	2022	269100	168700	437800	2023-02-01
222	2023	269100	168700	437800	2023-12-18
223	2020	288000	113500	401500	2023-02-01
223	2021	322900	125900	448800	2023-02-01
223	2022	334100	125900	460000	2023-02-01
223	2023	334100	125900	460000	2023-12-18
224	2020	222000	167900	389900	2023-02-01
224	2021	234300	215300	449600	2023-02-01
224	2022	234300	215300	449600	2023-02-01
224	2023	234300	215300	449600	2023-12-18
225	2020	73100	113900	187000	2023-02-01
225	2021	86100	176600	262700	2023-02-01
225	2022	86100	176600	262700	2023-02-01
225	2023	86100	176600	262700	2023-12-18
229	2020	290000	105400	395400	2023-02-01
229	2021	312700	179600	492300	2023-02-01
229	2022	312700	179600	492300	2023-02-01
229	2023	312700	179600	492300	2023-12-18
23	2020	227500	214300	441800	2023-02-01
23	2021	233100	245600	478700	2023-02-01
23	2022	233100	245600	478700	2023-02-01
23	2023	233100	245600	478700	2023-12-18
230	2020	0	2800	2800	2023-02-01
230	2021	0	2800	2800	2023-02-01
230	2022	0	2800	2800	2023-02-01
230	2023	0	2500	2500	2023-12-18
231	2020	57100	69500	126600	2023-02-01
231	2021	82800	91300	174100	2023-02-01
231	2022	82800	91300	174100	2023-02-01
231	2023	0	91300	91300	2023-12-18
232	2020	54200	52500	106700	2023-02-01
232	2021	72200	57800	130000	2023-02-01
232	2022	72200	57800	130000	2023-02-01
232	2023	72200	57800	130000	2023-12-18
233	2020	59900	59000	118900	2023-02-01
233	2021	81500	65100	146600	2023-02-01
233	2022	81500	65100	146600	2023-02-01
233	2023	81500	65100	146600	2023-12-18
234	2020	234500	78100	312600	2023-02-01
234	2021	228500	134400	362900	2023-02-01
234	2022	228500	134400	362900	2023-02-01
234	2023	228500	134400	362900	2023-12-18
235	2020	403100	107900	511000	2023-02-01
235	2021	455900	169300	625200	2023-02-01
235	2022	455900	169300	625200	2023-02-01
235	2023	455900	169300	625200	2023-12-18
236	2020	152400	67800	220200	2023-02-01
236	2021	184400	119700	304100	2023-02-01
236	2022	184400	119700	304100	2023-02-01
236	2023	184400	119700	304100	2023-12-18
237	2020	39500	53000	92500	2023-02-01
237	2021	45100	88200	133300	2023-02-01
237	2022	45100	88200	133300	2023-02-01
237	2023	45100	88200	133300	2023-12-18
238	2020	108100	93500	201600	2023-02-01
238	2021	149100	133300	282400	2023-02-01
238	2022	149100	133300	282400	2023-02-01
238	2023	149100	133300	282400	2023-12-18
241	2020	120900	116900	237800	2023-02-01
241	2021	143900	163300	307200	2023-02-01
241	2022	143900	163300	307200	2023-02-01
241	2023	62700	163000	225700	2023-12-18
243	2020	0	900	900	2023-02-01
243	2021	0	900	900	2023-02-01
243	2022	0	900	900	2023-02-01
243	2023	0	900	900	2023-12-18
244	2020	0	700	700	2023-02-01
244	2021	0	800	800	2023-02-01
244	2022	0	800	800	2023-02-01
244	2023	0	800	800	2023-12-18
245	2020	98100	86300	184400	2023-02-01
245	2021	193200	115700	308900	2023-02-01
245	2022	193200	115700	308900	2023-02-01
245	2023	193200	115700	308900	2023-12-18
246	2020	0	6200	6200	2023-02-01
246	2021	0	6200	6200	2023-02-01
246	2022	0	6200	6200	2023-02-01
246	2023	0	6100	6100	2023-12-18
247	2020	10400	92900	103300	2023-02-01
247	2021	13400	149200	162600	2023-02-01
247	2022	13400	149200	162600	2023-02-01
247	2023	13400	149200	162600	2023-12-18
248	2020	144000	105500	249500	2023-02-01
248	2021	126300	137700	264000	2023-02-01
248	2022	126300	137700	264000	2023-02-01
248	2023	126300	137700	264000	2023-12-18
249	2020	167400	122000	289400	2023-02-01
249	2021	155900	144300	300200	2023-02-01
249	2022	155900	144300	300200	2023-02-01
249	2023	155900	144300	300200	2023-12-18
25	2020	319400	149000	468400	2023-02-01
25	2021	410600	170500	581100	2023-02-01
25	2022	378700	170500	549200	2023-02-01
25	2023	392500	170500	563000	2023-12-18
250	2020	0	2700	2700	2023-02-01
250	2021	0	2700	2700	2023-02-01
250	2022	0	2700	2700	2023-02-01
250	2023	0	2700	2700	2023-12-18
251	2020	163700	182600	346300	2023-02-01
251	2021	367000	232200	599200	2023-02-01
251	2022	367000	232200	599200	2023-02-01
251	2023	367000	232100	599100	2023-12-18
252	2020	155600	94600	250200	2023-02-01
252	2021	176700	144300	321000	2023-02-01
252	2022	176700	144300	321000	2023-02-01
252	2023	176700	144200	320900	2023-12-18
253	2020	187200	116400	303600	2023-02-01
253	2021	212100	150400	362500	2023-02-01
253	2022	212100	150400	362500	2023-02-01
253	2023	212100	150400	362500	2023-12-18
254	2020	243100	117600	360700	2023-02-01
254	2021	356800	150800	507600	2023-02-01
254	2022	356800	150800	507600	2023-02-01
254	2023	356800	150700	507500	2023-12-18
255	2020	188200	99500	287700	2023-02-01
255	2021	435400	129400	564800	2023-02-01
255	2022	471100	129400	600500	2023-02-01
255	2023	523800	129400	653200	2023-12-18
256	2020	1251500	237700	1489200	2023-02-01
256	2021	1367900	364300	1732200	2023-02-01
256	2022	1367900	364300	1732200	2023-02-01
256	2023	1367900	364300	1732200	2023-12-18
257	2020	67900	100700	168600	2023-02-01
257	2021	56900	130700	187600	2023-02-01
257	2022	56900	130700	187600	2023-02-01
257	2023	56900	130700	187600	2023-12-18
258	2020	347600	0	347600	2023-02-01
258	2021	378800	0	378800	2023-02-01
258	2022	378800	0	378800	2023-02-01
258	2023	378800	0	378800	2023-12-18
259	2020	2190400	492700	2683100	2023-02-01
259	2021	2454700	592700	3047400	2023-02-01
259	2022	2454700	592700	3047400	2023-02-01
259	2023	2454700	592700	3047400	2023-12-18
26	2020	143500	150400	293900	2023-02-01
26	2021	151100	205300	356400	2023-02-01
26	2022	144700	205300	350000	2023-02-01
26	2023	144700	205300	350000	2023-12-18
260	2020	61100	157300	218400	2023-02-01
260	2021	82600	164500	247100	2023-02-01
260	2022	82600	164500	247100	2023-02-01
260	2023	82600	164500	247100	2023-12-18
267	2020	36300	96600	132900	2023-02-01
267	2021	66900	122600	189500	2023-02-01
267	2022	66900	122600	189500	2023-02-01
267	2023	66900	122600	189500	2023-12-18
27	2020	325200	184600	509800	2023-02-01
27	2021	326700	210000	536700	2023-02-01
27	2022	327100	210000	537100	2023-02-01
27	2023	327100	210000	537100	2023-12-18
270	2020	33700	92300	126000	2023-02-01
270	2021	54400	117800	172200	2023-02-01
270	2022	54400	117800	172200	2023-02-01
270	2023	54400	117800	172200	2023-12-18
271	2020	313300	78200	391500	2023-02-01
271	2021	293800	127600	421400	2023-02-01
271	2022	293800	127600	421400	2023-02-01
271	2023	293800	127600	421400	2023-12-18
272	2020	0	9000	9000	2023-02-01
272	2021	0	11300	11300	2023-02-01
272	2022	0	11300	11300	2023-02-01
272	2023	0	11300	11300	2023-12-18
273	2020	25700	69300	95000	2023-02-01
273	2021	32800	100700	133500	2023-02-01
273	2022	32800	100700	133500	2023-02-01
273	2023	32800	100700	133500	2023-12-18
274	2020	197900	101700	299600	2023-02-01
274	2021	230700	139000	369700	2023-02-01
274	2022	230700	139000	369700	2023-02-01
274	2023	230700	139000	369700	2023-12-18
275	2020	14200	84200	98400	2023-02-01
275	2021	30200	109800	140000	2023-02-01
275	2022	15500	109800	125300	2023-02-01
275	2023	15500	109800	125300	2023-12-18
276	2020	122700	167400	290100	2023-02-01
276	2021	133100	173400	306500	2023-02-01
276	2022	133100	173400	306500	2023-02-01
276	2023	133100	173400	306500	2023-12-18
277	2020	0	1500	1500	2023-02-01
277	2021	0	1500	1500	2023-02-01
277	2022	0	1500	1500	2023-02-01
277	2023	0	1500	1500	2023-12-18
278	2020	72200	168600	240800	2023-02-01
278	2021	159300	191000	350300	2023-02-01
278	2022	147100	180500	327600	2023-02-01
278	2023	147100	180100	327200	2023-12-18
279	2020	123600	148700	272300	2023-02-01
279	2021	161300	176800	338100	2023-02-01
279	2022	161300	176800	338100	2023-02-01
279	2023	161300	176800	338100	2023-12-18
28	2020	284900	215400	500300	2023-02-01
28	2021	292900	244000	536900	2023-02-01
28	2022	298800	244000	542800	2023-02-01
28	2023	302000	244000	546000	2023-12-18
280	2020	0	8400	8400	2023-02-01
280	2021	0	8400	8400	2023-02-01
280	2022	0	8400	8400	2023-02-01
280	2023	0	8200	8200	2023-12-18
283	2020	32600	130600	163200	2023-02-01
283	2021	25500	171600	197100	2023-02-01
283	2022	25500	171600	197100	2023-02-01
283	2023	25500	171600	197100	2023-12-18
287	2020	518800	278200	797000	2023-02-01
287	2021	566500	297100	863600	2023-02-01
287	2022	566500	297100	863600	2023-02-01
287	2023	566500	297100	863600	2023-12-18
288	2020	204100	307200	511300	2023-02-01
288	2021	245600	328100	573700	2023-02-01
288	2022	245600	328100	573700	2023-02-01
288	2023	245600	328100	573700	2023-12-18
29	2020	393200	207900	601100	2023-02-01
29	2021	420400	235700	656100	2023-02-01
29	2022	420400	235700	656100	2023-02-01
29	2023	420400	235700	656100	2023-12-18
290	2020	269000	281000	550000	2023-02-01
290	2021	618200	290500	908700	2023-02-01
290	2022	618200	290500	908700	2023-02-01
290	2023	618200	290500	908700	2023-12-18
291	2020	0	6400	6400	2023-02-01
291	2021	0	6400	6400	2023-02-01
291	2022	0	6400	6400	2023-02-01
291	2023	0	6400	6400	2023-12-18
292	2020	317300	137000	454300	2023-02-01
292	2021	376400	174100	550500	2023-02-01
292	2022	376500	174000	550500	2023-02-01
292	2023	376400	174300	550700	2023-12-18
294	2020	378500	138900	517400	2023-02-01
294	2021	411100	180800	591900	2023-02-01
294	2022	411100	180800	591900	2023-02-01
294	2023	411100	180700	591800	2023-12-18
295	2020	130300	90500	220800	2023-02-01
295	2021	132400	104100	236500	2023-02-01
295	2022	132400	104100	236500	2023-02-01
295	2023	132400	104100	236500	2023-12-18
296	2020	127600	0	127600	2023-02-01
296	2021	131100	0	131100	2023-02-01
296	2022	131100	0	131100	2023-02-01
296	2023	131100	0	131100	2023-12-18
297	2020	31400	70400	101800	2023-02-01
297	2021	40800	88400	129200	2023-02-01
297	2022	40800	88400	129200	2023-02-01
297	2023	40800	88400	129200	2023-12-18
298	2020	130400	95400	225800	2023-02-01
298	2021	168100	118200	286300	2023-02-01
298	2022	168100	118200	286300	2023-02-01
298	2023	168100	118200	286300	2023-12-18
299	2020	100300	95400	195700	2023-02-01
299	2021	108200	133400	241600	2023-02-01
299	2022	108200	133400	241600	2023-02-01
299	2023	108200	133400	241600	2023-12-18
30	2020	273700	161800	435500	2023-02-01
30	2021	275800	218200	494000	2023-02-01
30	2022	275300	218200	493500	2023-02-01
30	2023	275300	218200	493500	2023-12-18
300	2020	105200	84900	190100	2023-02-01
300	2021	116500	93400	209900	2023-02-01
300	2022	116500	93400	209900	2023-02-01
300	2023	116500	93400	209900	2023-12-18
301	2020	150800	112000	262800	2023-02-01
301	2021	197200	148800	346000	2023-02-01
301	2022	197200	148800	346000	2023-02-01
301	2023	197200	148800	346000	2023-12-18
303	2020	310800	142900	453700	2023-02-01
303	2021	392100	179200	571300	2023-02-01
303	2022	392100	179200	571300	2023-02-01
303	2023	392100	179200	571300	2023-12-18
306	2020	173800	201400	375200	2023-02-01
306	2021	254500	220000	474500	2023-02-01
306	2022	252100	220000	472100	2023-02-01
306	2023	252100	220000	472100	2023-12-18
307	2020	498800	229400	728200	2023-02-01
307	2021	498100	260400	758500	2023-02-01
307	2022	498100	260400	758500	2023-02-01
307	2023	498100	260400	758500	2023-12-18
308	2020	274500	150300	424800	2023-02-01
308	2021	280100	196600	476700	2023-02-01
308	2022	280100	196600	476700	2023-02-01
308	2023	280100	196600	476700	2023-12-18
309	2020	264700	232900	497600	2023-02-01
309	2021	283000	306800	589800	2023-02-01
309	2022	283000	306800	589800	2023-02-01
309	2023	283000	306100	589100	2023-12-18
310	2020	475100	178800	653900	2023-02-01
310	2021	511300	183400	694700	2023-02-01
310	2022	511300	183400	694700	2023-02-01
310	2023	511300	183100	694400	2023-12-18
311	2020	0	15600	15600	2023-02-01
311	2021	0	15600	15600	2023-02-01
311	2022	0	15600	15600	2023-02-01
311	2023	0	14500	14500	2023-12-18
313	2020	606600	485300	1091900	2023-02-01
313	2021	675600	430100	1105700	2023-02-01
313	2022	675600	430100	1105700	2023-02-01
313	2023	675600	429800	1105400	2023-12-18
315	2020	437000	136800	573800	2023-02-01
315	2021	484200	174900	659100	2023-02-01
315	2022	484200	174900	659100	2023-02-01
315	2023	484200	174900	659100	2023-12-18
316	2020	228100	143200	371300	2023-02-01
316	2021	229500	180700	410200	2023-02-01
316	2022	229500	180700	410200	2023-02-01
316	2023	229500	180700	410200	2023-12-18
317	2020	361600	127700	489300	2023-02-01
317	2021	361800	152900	514700	2023-02-01
317	2022	361800	152900	514700	2023-02-01
317	2023	361800	152900	514700	2023-12-18
319	2020	351600	172500	524100	2023-02-01
319	2021	381800	222900	604700	2023-02-01
319	2022	381800	222900	604700	2023-02-01
319	2023	381800	222900	604700	2023-12-18
32	2020	119100	154700	273800	2023-02-01
32	2021	131000	146800	277800	2023-02-01
32	2022	131000	146800	277800	2023-02-01
32	2023	136200	146800	283000	2023-12-18
320	2020	0	9700	9700	2023-02-01
320	2021	0	9700	9700	2023-02-01
320	2022	0	9700	9700	2023-02-01
320	2023	0	9500	9500	2023-12-18
321	2020	67200	99000	166200	2023-02-01
321	2021	74900	140500	215400	2023-02-01
321	2022	74900	140500	215400	2023-02-01
321	2023	74900	140500	215400	2023-12-18
322	2020	0	115400	115400	2023-02-01
322	2021	0	151200	151200	2023-02-01
322	2022	0	151200	151200	2023-02-01
322	2023	0	151200	151200	2023-12-18
323	2020	119400	110400	229800	2023-02-01
323	2021	149300	143800	293100	2023-02-01
323	2022	150100	143800	293900	2023-02-01
323	2023	150100	143800	293900	2023-12-18
324	2020	303200	99600	402800	2023-02-01
324	2021	319900	137800	457700	2023-02-01
324	2022	319900	137800	457700	2023-02-01
324	2023	319900	137800	457700	2023-12-18
325	2020	713100	197900	911000	2023-02-01
325	2021	750700	251100	1001800	2023-02-01
325	2022	750700	251100	1001800	2023-02-01
325	2023	750700	251100	1001800	2023-12-18
326	2020	338700	138200	476900	2023-02-01
326	2021	327800	180100	507900	2023-02-01
326	2022	327800	180100	507900	2023-02-01
326	2023	327800	180100	507900	2023-12-18
327	2020	166900	103600	270500	2023-02-01
327	2021	244400	153200	397600	2023-02-01
327	2022	252500	153200	405700	2023-02-01
327	2023	266500	153200	419700	2023-12-18
328	2020	201300	124200	325500	2023-02-01
328	2021	178800	161000	339800	2023-02-01
328	2022	178800	161000	339800	2023-02-01
328	2023	178800	161000	339800	2023-12-18
329	2020	105000	83900	188900	2023-02-01
329	2021	130800	93200	224000	2023-02-01
329	2022	110800	93200	204000	2023-02-01
329	2023	113100	93200	206300	2023-12-18
33	2020	148000	153900	301900	2023-02-01
33	2021	176400	151600	328000	2023-02-01
33	2022	176400	151600	328000	2023-02-01
33	2023	176400	151600	328000	2023-12-18
330	2020	176300	100700	277000	2023-02-01
330	2021	228000	134000	362000	2023-02-01
330	2022	216200	134000	350200	2023-02-01
330	2023	216200	134000	350200	2023-12-18
331	2020	75800	95300	171100	2023-02-01
331	2021	62500	131800	194300	2023-02-01
331	2022	62500	131800	194300	2023-02-01
331	2023	62500	131800	194300	2023-12-18
333	2020	0	12100	12100	2023-02-01
333	2021	0	15700	15700	2023-02-01
333	2022	0	15700	15700	2023-02-01
333	2023	0	15700	15700	2023-12-18
334	2020	375400	154800	530200	2023-02-01
334	2021	459600	175600	635200	2023-02-01
334	2022	459600	175600	635200	2023-02-01
334	2023	459600	175400	635000	2023-12-18
335	2020	121500	119100	240600	2023-02-01
335	2021	103500	157100	260600	2023-02-01
335	2022	103500	157100	260600	2023-02-01
335	2023	130700	157100	287800	2023-12-18
336	2020	205600	120200	325800	2023-02-01
336	2021	210700	158300	369000	2023-02-01
336	2022	210700	158300	369000	2023-02-01
336	2023	210700	158300	369000	2023-12-18
337	2020	656400	120600	777000	2023-02-01
337	2021	630400	197400	827800	2023-02-01
337	2022	630400	197400	827800	2023-02-01
337	2023	630400	197400	827800	2023-12-18
339	2020	170300	89400	259700	2023-02-01
339	2021	153000	140300	293300	2023-02-01
339	2022	153000	140300	293300	2023-02-01
339	2023	153000	140300	293300	2023-12-18
34	2020	391300	166100	557400	2023-02-01
34	2021	395200	157700	552900	2023-02-01
34	2022	395200	157700	552900	2023-02-01
34	2023	395200	157700	552900	2023-12-18
340	2020	350400	132800	483200	2023-02-01
340	2021	389200	199000	588200	2023-02-01
340	2022	382600	176700	559300	2023-02-01
340	2023	382600	176700	559300	2023-12-18
341	2020	149100	80700	229800	2023-02-01
341	2021	191600	123800	315400	2023-02-01
341	2022	191600	123800	315400	2023-02-01
341	2023	198000	123800	321800	2023-12-18
343	2020	220700	159000	379700	2023-02-01
343	2021	238400	197200	435600	2023-02-01
343	2022	238400	197200	435600	2023-02-01
343	2023	238400	197200	435600	2023-12-18
344	2020	178700	100400	279100	2023-02-01
344	2021	265500	109500	375000	2023-02-01
344	2022	265500	109500	375000	2023-02-01
344	2023	265500	109500	375000	2023-12-18
345	2020	248600	119100	367700	2023-02-01
345	2021	288300	153300	441600	2023-02-01
345	2022	288300	153300	441600	2023-02-01
345	2023	288300	153300	441600	2023-12-18
346	2020	195900	119000	314900	2023-02-01
346	2021	256900	159200	416100	2023-02-01
346	2022	256900	159200	416100	2023-02-01
346	2023	256900	159200	416100	2023-12-18
347	2020	8200	16000	24200	2023-02-01
347	2021	8800	18600	27400	2023-02-01
347	2022	8800	18600	27400	2023-02-01
347	2023	8800	18600	27400	2023-12-18
348	2020	301800	115500	417300	2023-02-01
348	2021	287400	149400	436800	2023-02-01
348	2022	287400	149400	436800	2023-02-01
348	2023	287400	149400	436800	2023-12-18
349	2020	0	93300	93300	2023-02-01
349	2021	0	102600	102600	2023-02-01
349	2022	0	102600	102600	2023-02-01
349	2023	0	102600	102600	2023-12-18
35	2020	0	24000	24000	2023-02-01
35	2021	0	29200	29200	2023-02-01
35	2022	0	29200	29200	2023-02-01
35	2023	0	29200	29200	2023-12-18
350	2020	0	45700	45700	2023-02-01
350	2021	0	52200	52200	2023-02-01
350	2022	0	52200	52200	2023-02-01
350	2023	0	52200	52200	2023-12-18
351	2020	276100	115000	391100	2023-02-01
351	2021	284700	148900	433600	2023-02-01
351	2022	284700	148900	433600	2023-02-01
351	2023	284700	148900	433600	2023-12-18
355	2020	0	279100	279100	2023-02-01
355	2021	0	330300	330300	2023-02-01
355	2022	0	330300	330300	2023-02-01
355	2023	0	330300	330300	2023-12-18
357	2020	0	124500	124500	2023-02-01
357	2021	0	159000	159000	2023-02-01
357	2022	0	159000	159000	2023-02-01
357	2023	0	159000	159000	2023-12-18
358	2020	0	8400	8400	2023-02-01
358	2021	0	9300	9300	2023-02-01
358	2022	0	9300	9300	2023-02-01
358	2023	0	9300	9300	2023-12-18
359	2020	71900	97200	169100	2023-02-01
359	2021	92400	135100	227500	2023-02-01
359	2022	92400	135100	227500	2023-02-01
359	2023	92400	135100	227500	2023-12-18
36	2020	404700	318600	723300	2023-02-01
36	2021	303000	416200	719200	2023-02-01
36	2022	303000	416200	719200	2023-02-01
36	2023	377800	416200	794000	2023-12-18
360	2020	93600	84300	177900	2023-02-01
360	2021	128100	101800	229900	2023-02-01
360	2022	128100	101800	229900	2023-02-01
360	2023	128100	101800	229900	2023-12-18
361	2020	315000	120400	435400	2023-02-01
361	2021	344600	156600	501200	2023-02-01
361	2022	344600	156600	501200	2023-02-01
361	2023	344600	156400	501000	2023-12-18
363	2020	314800	108300	423100	2023-02-01
363	2021	391000	128100	519100	2023-02-01
363	2022	392400	128100	520500	2023-02-01
363	2023	392400	128100	520500	2023-12-18
364	2020	83300	72900	156200	2023-02-01
364	2021	114400	98300	212700	2023-02-01
364	2022	114400	98300	212700	2023-02-01
364	2023	114400	98300	212700	2023-12-18
365	2020	538500	204500	743000	2023-02-01
365	2021	544900	257400	802300	2023-02-01
365	2022	544900	257400	802300	2023-02-01
365	2023	544900	257000	801900	2023-12-18
368	2020	238100	102400	340500	2023-02-01
368	2021	242900	111700	354600	2023-02-01
368	2022	242900	111700	354600	2023-02-01
368	2023	242900	111700	354600	2023-12-18
369	2020	450900	244500	695400	2023-02-01
369	2021	477100	240900	718000	2023-02-01
369	2022	477100	240900	718000	2023-02-01
369	2023	477100	240900	718000	2023-12-18
37	2020	199500	286400	485900	2023-02-01
37	2021	297500	353000	650500	2023-02-01
37	2022	297500	353000	650500	2023-02-01
37	2023	297500	353000	650500	2023-12-18
370	2020	0	255600	255600	2023-02-01
370	2021	0	312000	312000	2023-02-01
370	2022	0	312000	312000	2023-02-01
370	2023	0	312000	312000	2023-12-18
371	2020	323100	154400	477500	2023-02-01
371	2021	342300	166800	509100	2023-02-01
371	2022	342300	166800	509100	2023-02-01
371	2023	342300	166800	509100	2023-12-18
372	2020	209400	199900	409300	2023-02-01
372	2021	219900	208700	428600	2023-02-01
372	2022	219900	208700	428600	2023-02-01
372	2023	219900	208700	428600	2023-12-18
375	2020	0	156600	156600	2023-02-01
375	2021	0	303100	303100	2023-02-01
375	2022	0	244100	244100	2023-02-01
375	2023	0	244100	244100	2023-12-18
376	2020	330500	144100	474600	2023-02-01
376	2021	387900	163300	551200	2023-02-01
376	2022	387900	163300	551200	2023-02-01
376	2023	387900	163100	551000	2023-12-18
377	2020	42400	102100	144500	2023-02-01
377	2021	34900	148800	183700	2023-02-01
377	2022	34900	148800	183700	2023-02-01
377	2023	34900	148600	183500	2023-12-18
378	2020	266300	122400	388700	2023-02-01
378	2021	345600	142700	488300	2023-02-01
378	2022	345600	142700	488300	2023-02-01
378	2023	345600	142700	488300	2023-12-18
379	2020	39200	104100	143300	2023-02-01
379	2021	60600	118000	178600	2023-02-01
379	2022	65300	118000	183300	2023-02-01
379	2023	65300	118000	183300	2023-12-18
380	2020	156000	125500	281500	2023-02-01
380	2021	184800	157400	342200	2023-02-01
380	2022	184800	157400	342200	2023-02-01
380	2023	184800	157400	342200	2023-12-18
381	2020	61200	86800	148000	2023-02-01
381	2021	73000	107800	180800	2023-02-01
381	2022	73000	107800	180800	2023-02-01
381	2023	73000	107800	180800	2023-12-18
382	2020	131200	139200	270400	2023-02-01
382	2021	150900	158900	309800	2023-02-01
382	2022	150900	158900	309800	2023-02-01
382	2023	150900	158900	309800	2023-12-18
383	2020	0	5000	5000	2023-02-01
383	2021	0	5000	5000	2023-02-01
383	2022	0	5000	5000	2023-02-01
383	2023	0	4800	4800	2023-12-18
384	2020	34500	226600	261100	2023-02-01
384	2021	115100	241800	356900	2023-02-01
384	2022	115100	241800	356900	2023-02-01
384	2023	115100	241800	356900	2023-12-18
385	2020	248400	188900	437300	2023-02-01
385	2021	285900	172600	458500	2023-02-01
385	2022	285900	172600	458500	2023-02-01
385	2023	285900	172600	458500	2023-12-18
387	2020	0	23100	23100	2023-02-01
387	2021	0	32300	32300	2023-02-01
387	2022	0	32300	32300	2023-02-01
387	2023	0	32300	32300	2023-12-18
388	2020	0	60800	60800	2023-02-01
388	2021	0	73500	73500	2023-02-01
388	2022	0	73500	73500	2023-02-01
388	2023	0	73500	73500	2023-12-18
389	2020	266600	100400	367000	2023-02-01
389	2021	267800	112600	380400	2023-02-01
389	2022	267800	112600	380400	2023-02-01
389	2023	267800	112600	380400	2023-12-18
39	2020	421400	208700	630100	2023-02-01
39	2021	339700	237000	576700	2023-02-01
39	2022	569100	237000	806100	2023-02-01
39	2023	891600	237000	1128600	2023-12-18
390	2020	0	397500	397500	2023-02-01
390	2021	0	454600	454600	2023-02-01
390	2022	0	454600	454600	2023-02-01
390	2023	0	454600	454600	2023-12-18
391	2020	78600	252200	330800	2023-02-01
391	2021	147800	321300	469100	2023-02-01
391	2022	147800	321300	469100	2023-02-01
391	2023	113000	321300	434300	2023-12-18
392	2020	439200	285600	724800	2023-02-01
392	2021	490100	360300	850400	2023-02-01
392	2022	490000	360400	850400	2023-02-01
392	2023	490000	360400	850400	2023-12-18
394	2020	366000	281200	647200	2023-02-01
394	2021	371100	355400	726500	2023-02-01
394	2022	371100	355400	726500	2023-02-01
394	2023	371100	355400	726500	2023-12-18
395	2020	289500	314100	603600	2023-02-01
395	2021	319100	335700	654800	2023-02-01
395	2022	332100	335700	667800	2023-02-01
395	2023	332100	335700	667800	2023-12-18
398	2020	601100	327800	928900	2023-02-01
398	2021	777200	1621300	2398500	2023-02-01
398	2022	777200	1621300	2398500	2023-02-01
398	2023	777200	1621300	2398500	2023-12-18
399	2020	312000	312000	624000	2023-02-01
399	2021	352100	297700	649800	2023-02-01
399	2022	354400	297700	652100	2023-02-01
399	2023	354400	297700	652100	2023-12-18
40	2020	0	37300	37300	2023-02-01
40	2021	0	43000	43000	2023-02-01
40	2022	0	43000	43000	2023-02-01
40	2023	0	43000	43000	2023-12-18
400	2020	312500	136600	449100	2023-02-01
400	2021	339100	163100	502200	2023-02-01
400	2022	339100	163100	502200	2023-02-01
400	2023	339100	163100	502200	2023-12-18
401	2020	0	1058500	1058500	2023-02-01
401	2021	0	1188900	1188900	2023-02-01
401	2022	0	1188900	1188900	2023-02-01
401	2023	0	1188900	1188900	2023-12-18
402	2020	1353500	950900	2304400	2023-02-01
402	2021	1367100	1205000	2572100	2023-02-01
402	2022	1367100	1205000	2572100	2023-02-01
402	2023	1367100	1205000	2572100	2023-12-18
405	2020	109200	109200	218400	2023-02-01
405	2021	147800	143300	291100	2023-02-01
405	2022	146300	143300	289600	2023-02-01
405	2023	146300	143300	289600	2023-12-18
407	2020	0	13900	13900	2023-02-01
407	2021	0	13900	13900	2023-02-01
407	2022	0	13900	13900	2023-02-01
407	2023	0	13800	13800	2023-12-18
408	2020	139800	163400	303200	2023-02-01
408	2021	171500	148500	320000	2023-02-01
408	2022	171500	148500	320000	2023-02-01
408	2023	171500	148500	320000	2023-12-18
41	2020	441600	175800	617400	2023-02-01
41	2021	447000	186000	633000	2023-02-01
41	2022	447000	186000	633000	2023-02-01
41	2023	447000	186000	633000	2023-12-18
415	2020	184700	163900	348600	2023-02-01
415	2021	242800	212800	455600	2023-02-01
415	2022	242800	212800	455600	2023-02-01
415	2023	242800	212800	455600	2023-12-18
417	2020	34200	17400	51600	2023-02-01
417	2021	34800	20900	55700	2023-02-01
417	2022	34800	20900	55700	2023-02-01
417	2023	34800	20800	55600	2023-12-18
418	2020	404000	207500	611500	2023-02-01
418	2021	442900	205700	648600	2023-02-01
418	2022	432100	205700	637800	2023-02-01
418	2023	432100	205700	637800	2023-12-18
42	2020	246800	192400	439200	2023-02-01
42	2021	269800	218700	488500	2023-02-01
42	2022	269800	218700	488500	2023-02-01
42	2023	269800	218700	488500	2023-12-18
427	2020	260700	131000	391700	2023-02-01
427	2021	317000	162800	479800	2023-02-01
427	2022	317000	162800	479800	2023-02-01
427	2023	317000	162800	479800	2023-12-18
429	2020	474700	240800	715500	2023-02-01
429	2021	553700	172400	726100	2023-02-01
429	2022	553700	172400	726100	2023-02-01
429	2023	555500	172400	727900	2023-12-18
43	2020	156300	163100	319400	2023-02-01
43	2021	137300	208300	345600	2023-02-01
43	2022	137300	208300	345600	2023-02-01
43	2023	137300	208300	345600	2023-12-18
432	2020	0	19200	19200	2023-02-01
432	2021	0	23700	23700	2023-02-01
432	2022	0	23700	23700	2023-02-01
432	2023	0	23700	23700	2023-12-18
433	2020	53300	76500	129800	2023-02-01
433	2021	37700	104500	142200	2023-02-01
433	2022	37700	104500	142200	2023-02-01
433	2023	37700	104500	142200	2023-12-18
434	2020	50400	122300	172700	2023-02-01
434	2021	58600	184300	242900	2023-02-01
434	2022	58600	184300	242900	2023-02-01
434	2023	58600	184300	242900	2023-12-18
435	2020	112300	164300	276600	2023-02-01
435	2021	104100	221200	325300	2023-02-01
435	2022	104100	221200	325300	2023-02-01
435	2023	104100	221200	325300	2023-12-18
436	2020	37300	165200	202500	2023-02-01
436	2021	60300	205800	266100	2023-02-01
436	2022	57700	187000	244700	2023-02-01
436	2023	57700	187000	244700	2023-12-18
437	2020	475100	298400	773500	2023-02-01
437	2021	674600	378100	1052700	2023-02-01
437	2022	682800	378100	1060900	2023-02-01
437	2023	682800	378100	1060900	2023-12-18
438	2020	254000	232800	486800	2023-02-01
438	2021	308800	261700	570500	2023-02-01
438	2022	308800	261700	570500	2023-02-01
438	2023	308800	261700	570500	2023-12-18
439	2020	0	5000	5000	2023-02-01
439	2021	0	6400	6400	2023-02-01
439	2022	0	6400	6400	2023-02-01
439	2023	0	6400	6400	2023-12-18
440	2020	43900	179000	222900	2023-02-01
440	2021	53000	228900	281900	2023-02-01
440	2022	53000	228900	281900	2023-02-01
440	2023	53000	228900	281900	2023-12-18
441	2020	382300	346700	729000	2023-02-01
441	2021	393000	455200	848200	2023-02-01
441	2022	404100	455200	859300	2023-02-01
441	2023	404100	455200	859300	2023-12-18
442	2020	240600	162200	402800	2023-02-01
442	2021	229500	196700	426200	2023-02-01
442	2022	229500	196700	426200	2023-02-01
442	2023	229500	196700	426200	2023-12-18
446	2020	433400	302800	736200	2023-02-01
446	2021	417800	216600	634400	2023-02-01
446	2022	417800	216600	634400	2023-02-01
446	2023	421000	215800	636800	2023-12-18
447	2020	151800	246200	398000	2023-02-01
447	2021	191200	228500	419700	2023-02-01
447	2022	191200	228500	419700	2023-02-01
447	2023	191200	228500	419700	2023-12-18
448	2020	379100	188000	567100	2023-02-01
448	2021	396900	255400	652300	2023-02-01
448	2022	396900	255400	652300	2023-02-01
448	2023	396900	255200	652100	2023-12-18
450	2020	483000	396900	879900	2023-02-01
450	2021	561400	397300	958700	2023-02-01
450	2022	561400	403400	964800	2023-02-01
450	2023	561400	402800	964200	2023-12-18
454	2020	471100	216400	687500	2023-02-01
454	2021	586400	243800	830200	2023-02-01
454	2022	586600	243800	830400	2023-02-01
454	2023	586600	243900	830500	2023-12-18
457	2020	666000	293700	959700	2023-02-01
457	2021	818800	225700	1044500	2023-02-01
457	2022	818800	225700	1044500	2023-02-01
457	2023	818800	225400	1044200	2023-12-18
458	2020	239700	235400	475100	2023-02-01
458	2021	234800	272600	507400	2023-02-01
458	2022	234800	272600	507400	2023-02-01
458	2023	234800	272600	507400	2023-12-18
459	2020	235200	206500	441700	2023-02-01
459	2021	293400	192000	485400	2023-02-01
459	2022	293400	192000	485400	2023-02-01
459	2023	293400	192000	485400	2023-12-18
460	2020	391500	167100	558600	2023-02-01
460	2021	479100	201800	680900	2023-02-01
460	2022	479100	201800	680900	2023-02-01
460	2023	479100	201400	680500	2023-12-18
461	2020	299300	178200	477500	2023-02-01
461	2021	673400	233000	906400	2023-02-01
461	2022	714600	233100	947700	2023-02-01
461	2023	714600	233000	947600	2023-12-18
462	2020	438100	119400	557500	2023-02-01
462	2021	544600	192700	737300	2023-02-01
462	2022	544600	192700	737300	2023-02-01
462	2023	544600	192600	737200	2023-12-18
463	2020	0	4200	4200	2023-02-01
463	2021	0	4200	4200	2023-02-01
463	2022	0	4200	4200	2023-02-01
463	2023	0	4100	4100	2023-12-18
465	2020	0	12300	12300	2023-02-01
465	2021	0	12300	12300	2023-02-01
465	2022	0	12300	12300	2023-02-01
465	2023	0	12300	12300	2023-12-18
469	2020	598800	240800	839600	2023-02-01
469	2021	725500	271500	997000	2023-02-01
469	2022	725500	271500	997000	2023-02-01
469	2023	725500	271500	997000	2023-12-18
472	2020	586900	154400	741300	2023-02-01
472	2021	715000	175300	890300	2023-02-01
472	2022	715000	175300	890300	2023-02-01
472	2023	715000	175300	890300	2023-12-18
473	2020	427400	186100	613500	2023-02-01
473	2021	535100	210400	745500	2023-02-01
473	2022	535100	210400	745500	2023-02-01
473	2023	535100	210400	745500	2023-12-18
474	2020	322500	176700	499200	2023-02-01
474	2021	358800	200000	558800	2023-02-01
474	2022	358800	200000	558800	2023-02-01
474	2023	358800	200000	558800	2023-12-18
475	2020	492300	168200	660500	2023-02-01
475	2021	472000	214600	686600	2023-02-01
475	2022	472000	214600	686600	2023-02-01
475	2023	472000	214600	686600	2023-12-18
476	2020	261600	155100	416700	2023-02-01
476	2021	285600	192300	477900	2023-02-01
476	2022	285600	192300	477900	2023-02-01
476	2023	1080000	234400	1314400	2023-12-18
478	2020	218200	207000	425200	2023-02-01
478	2021	270800	190500	461300	2023-02-01
478	2022	270800	190600	461400	2023-02-01
478	2023	270800	190700	461500	2023-12-18
479	2020	724800	309400	1034200	2023-02-01
479	2021	750500	307800	1058300	2023-02-01
479	2022	750500	307800	1058300	2023-02-01
479	2023	750500	307300	1057800	2023-12-18
480	2020	182700	129000	311700	2023-02-01
480	2021	247100	162300	409400	2023-02-01
480	2022	233500	162300	395800	2023-02-01
480	2023	233500	162200	395700	2023-12-18
482	2020	302700	122100	424800	2023-02-01
482	2021	308300	154600	462900	2023-02-01
482	2022	308300	154600	462900	2023-02-01
482	2023	308300	154500	462800	2023-12-18
483	2020	0	600	600	2023-02-01
483	2021	0	700	700	2023-02-01
483	2022	0	700	700	2023-02-01
483	2023	0	700	700	2023-12-18
484	2020	387300	164200	551500	2023-02-01
484	2021	431700	182200	613900	2023-02-01
484	2022	431700	182200	613900	2023-02-01
484	2023	431700	182200	613900	2023-12-18
486	2020	269200	196800	466000	2023-02-01
486	2021	367800	218100	585900	2023-02-01
486	2022	367800	218100	585900	2023-02-01
486	2023	367800	218100	585900	2023-12-18
487	2020	163300	162200	325500	2023-02-01
487	2021	165100	180000	345100	2023-02-01
487	2022	165100	180000	345100	2023-02-01
487	2023	170800	180000	350800	2023-12-18
488	2020	228000	265200	493200	2023-02-01
488	2021	309400	248800	558200	2023-02-01
488	2022	309400	248800	558200	2023-02-01
488	2023	314900	248800	563700	2023-12-18
489	2020	306000	244300	550300	2023-02-01
489	2021	225500	253700	479200	2023-02-01
489	2022	225500	253700	479200	2023-02-01
489	2023	225500	253700	479200	2023-12-18
490	2020	195900	249200	445100	2023-02-01
490	2021	289700	211700	501400	2023-02-01
490	2022	289700	211700	501400	2023-02-01
490	2023	289700	211700	501400	2023-12-18
491	2020	439800	259200	699000	2023-02-01
491	2021	311300	222100	533400	2023-02-01
491	2022	311300	222200	533500	2023-02-01
491	2023	311300	221900	533200	2023-12-18
492	2020	112200	145600	257800	2023-02-01
492	2021	124500	198600	323100	2023-02-01
492	2022	146800	198600	345400	2023-02-01
492	2023	146800	198600	345400	2023-12-18
493	2020	367000	295900	662900	2023-02-01
493	2021	442700	257900	700600	2023-02-01
493	2022	442700	257900	700600	2023-02-01
493	2023	442700	257800	700500	2023-12-18
494	2020	888400	273600	1162000	2023-02-01
494	2021	978200	289300	1267500	2023-02-01
494	2022	978200	289400	1267600	2023-02-01
494	2023	978200	289400	1267600	2023-12-18
495	2020	240400	323400	563800	2023-02-01
495	2021	308000	333700	641700	2023-02-01
495	2022	308000	333700	641700	2023-02-01
495	2023	308000	314900	622900	2023-12-18
5	2020	80700	130200	210900	2023-02-01
5	2021	93700	167600	261300	2023-02-01
5	2022	93700	167600	261300	2023-02-01
5	2023	93700	167600	261300	2023-12-18
50	2020	150100	0	150100	2023-02-01
50	2021	194300	0	194300	2023-02-01
50	2022	194300	0	194300	2023-02-01
50	2023	194300	0	194300	2023-12-18
501	2020	65000	159200	224200	2023-02-01
501	2021	63500	199300	262800	2023-02-01
501	2022	63500	199300	262800	2023-02-01
501	2023	63500	199300	262800	2023-12-18
505	2020	615900	361700	977600	2023-02-01
505	2021	704800	441000	1145800	2023-02-01
505	2022	704800	441000	1145800	2023-02-01
505	2023	704800	441000	1145800	2023-12-18
506	2020	490100	315000	805100	2023-02-01
506	2021	580400	356800	937200	2023-02-01
506	2022	580400	356800	937200	2023-02-01
506	2023	580400	356800	937200	2023-12-18
507	2020	283000	230900	513900	2023-02-01
507	2021	326000	284500	610500	2023-02-01
507	2022	321300	289200	610500	2023-02-01
507	2023	321300	289200	610500	2023-12-18
509	2020	346600	229600	576200	2023-02-01
509	2021	339400	260800	600200	2023-02-01
509	2022	339400	260800	600200	2023-02-01
509	2023	339400	260800	600200	2023-12-18
51	2020	144300	0	144300	2023-02-01
51	2021	197400	0	197400	2023-02-01
51	2022	197400	0	197400	2023-02-01
51	2023	197400	0	197400	2023-12-18
510	2020	383700	267900	651600	2023-02-01
510	2021	406200	253700	659900	2023-02-01
510	2022	406200	253700	659900	2023-02-01
510	2023	406200	253700	659900	2023-12-18
511	2020	190500	202000	392500	2023-02-01
511	2021	196100	212500	408600	2023-02-01
511	2022	196100	212500	408600	2023-02-01
511	2023	196100	212500	408600	2023-12-18
512	2020	0	10200	10200	2023-02-01
512	2021	0	10200	10200	2023-02-01
512	2022	0	10200	10200	2023-02-01
512	2023	0	10200	10200	2023-12-18
513	2020	233800	249000	482800	2023-02-01
513	2021	275900	214600	490500	2023-02-01
513	2022	275900	214600	490500	2023-02-01
513	2023	275900	214600	490500	2023-12-18
514	2020	330700	302200	632900	2023-02-01
514	2021	365300	278300	643600	2023-02-01
514	2022	365300	278300	643600	2023-02-01
514	2023	365300	278300	643600	2023-12-18
515	2020	156900	180400	337300	2023-02-01
515	2021	173600	187700	361300	2023-02-01
515	2022	173600	187700	361300	2023-02-01
515	2023	173600	187700	361300	2023-12-18
517	2020	279200	171100	450300	2023-02-01
517	2021	331700	181300	513000	2023-02-01
517	2022	331700	181300	513000	2023-02-01
517	2023	387600	181300	568900	2023-12-18
518	2020	275100	177700	452800	2023-02-01
518	2021	290800	217800	508600	2023-02-01
518	2022	290800	217800	508600	2023-02-01
518	2023	290800	217800	508600	2023-12-18
519	2020	124600	125100	249700	2023-02-01
519	2021	142100	156900	299000	2023-02-01
519	2022	142100	156900	299000	2023-02-01
519	2023	142100	156900	299000	2023-12-18
52	2020	141100	0	141100	2023-02-01
52	2021	184100	0	184100	2023-02-01
52	2022	184100	0	184100	2023-02-01
52	2023	184100	0	184100	2023-12-18
520	2020	392700	164000	556700	2023-02-01
520	2021	482800	204900	687700	2023-02-01
520	2022	482800	204900	687700	2023-02-01
520	2023	512800	204900	717700	2023-12-18
522	2020	118100	116600	234700	2023-02-01
522	2021	133200	162100	295300	2023-02-01
522	2022	133200	162100	295300	2023-02-01
522	2023	133200	162100	295300	2023-12-18
526	2020	112300	155900	268200	2023-02-01
526	2021	133300	217300	350600	2023-02-01
526	2022	133300	217300	350600	2023-02-01
526	2023	133300	217300	350600	2023-12-18
527	2020	342300	166300	508600	2023-02-01
527	2021	312700	207400	520100	2023-02-01
527	2022	312700	207400	520100	2023-02-01
527	2023	312700	207400	520100	2023-12-18
529	2020	138200	145200	283400	2023-02-01
529	2021	159300	181700	341000	2023-02-01
529	2022	159300	181700	341000	2023-02-01
529	2023	159300	181700	341000	2023-12-18
53	2020	162700	0	162700	2023-02-01
53	2021	208500	0	208500	2023-02-01
53	2022	208500	0	208500	2023-02-01
53	2023	208500	0	208500	2023-12-18
530	2020	496700	247700	744400	2023-02-01
530	2021	458500	287600	746100	2023-02-01
530	2022	458500	287600	746100	2023-02-01
530	2023	458500	287600	746100	2023-12-18
532	2020	54400	160700	215100	2023-02-01
532	2021	58700	182400	241100	2023-02-01
532	2022	58700	182400	241100	2023-02-01
532	2023	58700	182400	241100	2023-12-18
533	2020	497900	258900	756800	2023-02-01
533	2021	561200	195900	757100	2023-02-01
533	2022	561200	195900	757100	2023-02-01
533	2023	561200	195900	757100	2023-12-18
537	2020	601700	274900	876600	2023-02-01
537	2021	544100	312100	856200	2023-02-01
537	2022	544100	312100	856200	2023-02-01
537	2023	544100	312100	856200	2023-12-18
538	2020	336800	176900	513700	2023-02-01
538	2021	377000	175600	552600	2023-02-01
538	2022	379300	175600	554900	2023-02-01
538	2023	379300	175600	554900	2023-12-18
54	2020	137400	0	137400	2023-02-01
54	2021	179900	0	179900	2023-02-01
54	2022	179900	0	179900	2023-02-01
54	2023	179900	0	179900	2023-12-18
540	2020	244500	199900	444400	2023-02-01
540	2021	296800	184500	481300	2023-02-01
540	2022	296800	184500	481300	2023-02-01
540	2023	296800	184500	481300	2023-12-18
542	2020	164900	130300	295200	2023-02-01
542	2021	177800	147700	325500	2023-02-01
542	2022	184300	147700	332000	2023-02-01
542	2023	184300	147700	332000	2023-12-18
543	2020	0	1400	1400	2023-02-01
543	2021	0	1500	1500	2023-02-01
543	2022	0	1500	1500	2023-02-01
543	2023	0	1500	1500	2023-12-18
544	2020	47900	113500	161400	2023-02-01
544	2021	62700	171200	233900	2023-02-01
544	2022	62700	171200	233900	2023-02-01
544	2023	62700	171200	233900	2023-12-18
545	2020	86300	111000	197300	2023-02-01
545	2021	102700	168200	270900	2023-02-01
545	2022	109800	168200	278000	2023-02-01
545	2023	119600	168200	287800	2023-12-18
546	2020	107900	132900	240800	2023-02-01
546	2021	115400	167300	282700	2023-02-01
546	2022	115400	167300	282700	2023-02-01
546	2023	115400	167200	282600	2023-12-18
547	2020	168900	156700	325600	2023-02-01
547	2021	175800	185500	361300	2023-02-01
547	2022	175800	185500	361300	2023-02-01
547	2023	175800	185500	361300	2023-12-18
55	2020	151200	0	151200	2023-02-01
55	2021	195600	0	195600	2023-02-01
55	2022	195600	0	195600	2023-02-01
55	2023	195600	0	195600	2023-12-18
552	2020	3500	118200	121700	2023-02-01
552	2021	3600	133500	137100	2023-02-01
552	2022	3600	133400	137000	2023-02-01
552	2023	3600	132900	136500	2023-12-18
557	2020	91600	151000	242600	2023-02-01
557	2021	114900	203800	318700	2023-02-01
557	2022	114900	203800	318700	2023-02-01
557	2023	114900	203800	318700	2023-12-18
558	2020	50400	127300	177700	2023-02-01
558	2021	45800	161200	207000	2023-02-01
558	2022	45800	161200	207000	2023-02-01
558	2023	45800	161200	207000	2023-12-18
559	2020	257700	179400	437100	2023-02-01
559	2021	300300	147500	447800	2023-02-01
559	2022	300300	147500	447800	2023-02-01
559	2023	300300	147500	447800	2023-12-18
56	2020	908500	186700	1095200	2023-02-01
56	2021	926400	234500	1160900	2023-02-01
56	2022	976100	234500	1210600	2023-02-01
56	2023	1025200	234500	1259700	2023-12-18
560	2020	123500	128700	252200	2023-02-01
560	2021	123400	162900	286300	2023-02-01
560	2022	123400	162900	286300	2023-02-01
560	2023	123400	162900	286300	2023-12-18
561	2020	0	11900	11900	2023-02-01
561	2021	0	12200	12200	2023-02-01
561	2022	0	12200	12200	2023-02-01
561	2023	0	12200	12200	2023-12-18
563	2020	299500	204300	503800	2023-02-01
563	2021	344200	236700	580900	2023-02-01
563	2022	344200	236700	580900	2023-02-01
563	2023	344200	236700	580900	2023-12-18
564	2020	421500	290600	712100	2023-02-01
564	2021	497800	362000	859800	2023-02-01
564	2022	497800	361900	859700	2023-02-01
564	2023	544200	361900	906100	2023-12-18
565	2020	256000	188100	444100	2023-02-01
565	2021	247800	263700	511500	2023-02-01
565	2022	247800	263700	511500	2023-02-01
565	2023	247800	263700	511500	2023-12-18
569	2020	802700	321300	1124000	2023-02-01
569	2021	732700	396100	1128800	2023-02-01
569	2022	730600	396100	1126700	2023-02-01
569	2023	728700	396000	1124700	2023-12-18
57	2020	714200	202400	916600	2023-02-01
57	2021	734700	230000	964700	2023-02-01
57	2022	734700	230000	964700	2023-02-01
57	2023	734700	230000	964700	2023-12-18
570	2020	138500	281900	420400	2023-02-01
570	2021	184400	343600	528000	2023-02-01
570	2022	184400	343600	528000	2023-02-01
570	2023	184400	343600	528000	2023-12-18
571	2020	120400	158500	278900	2023-02-01
571	2021	169100	180000	349100	2023-02-01
571	2022	169100	180000	349100	2023-02-01
571	2023	169100	180000	349100	2023-12-18
572	2020	31500	117100	148600	2023-02-01
572	2021	181000	183900	364900	2023-02-01
572	2022	155200	183900	339100	2023-02-01
572	2023	155200	183900	339100	2023-12-18
575	2020	731800	537400	1269200	2023-02-01
575	2021	862000	884300	1746300	2023-02-01
575	2022	862000	884300	1746300	2023-02-01
575	2023	796700	777600	1574300	2023-12-18
576	2020	1802900	943100	2746000	2023-02-01
576	2021	2084100	1349300	3433400	2023-02-01
576	2022	2084100	1274800	3358900	2023-02-01
576	2023	2084100	1274800	3358900	2023-12-18
578	2020	931500	539800	1471300	2023-02-01
578	2021	881300	887500	1768800	2023-02-01
578	2022	881300	673600	1554900	2023-02-01
578	2023	881300	673600	1554900	2023-12-18
579	2020	360800	234300	595100	2023-02-01
579	2021	443300	212000	655300	2023-02-01
579	2022	443300	212000	655300	2023-02-01
579	2023	443300	211900	655200	2023-12-18
58	2020	604000	255500	859500	2023-02-01
58	2021	653600	262000	915600	2023-02-01
58	2022	653600	262000	915600	2023-02-01
58	2023	653600	262000	915600	2023-12-18
580	2020	0	17500	17500	2023-02-01
580	2021	0	19300	19300	2023-02-01
580	2022	0	19300	19300	2023-02-01
580	2023	0	19300	19300	2023-12-18
581	2020	153400	246300	399700	2023-02-01
581	2021	169200	246300	415500	2023-02-01
581	2022	174700	246300	421000	2023-02-01
581	2023	174700	246100	420800	2023-12-18
582	2020	519000	278800	797800	2023-02-01
582	2021	971900	406900	1378800	2023-02-01
582	2022	1700400	406900	2107300	2023-02-01
582	2023	1765300	406900	2172200	2023-12-18
584	2020	454200	275500	729700	2023-02-01
584	2021	561900	227200	789100	2023-02-01
584	2022	561900	227200	789100	2023-02-01
584	2023	561900	227200	789100	2023-12-18
59	2020	331100	165000	496100	2023-02-01
59	2021	355300	156500	511800	2023-02-01
59	2022	355300	156500	511800	2023-02-01
59	2023	355300	156500	511800	2023-12-18
591	2020	0	11200	11200	2023-02-01
591	2021	0	11200	11200	2023-02-01
591	2022	0	11200	11200	2023-02-01
591	2023	0	11100	11100	2023-12-18
592	2020	0	1000	1000	2023-02-01
592	2021	0	1000	1000	2023-02-01
592	2022	0	1000	1000	2023-02-01
592	2023	0	900	900	2023-12-18
593	2020	155100	257100	412200	2023-02-01
593	2021	234800	290800	525600	2023-02-01
593	2022	234800	290800	525600	2023-02-01
593	2023	234800	290500	525300	2023-12-18
594	2020	459400	224800	684200	2023-02-01
594	2021	541800	221200	763000	2023-02-01
594	2022	541800	221200	763000	2023-02-01
594	2023	541800	221100	762900	2023-12-18
597	2020	623600	288500	912100	2023-02-01
597	2021	689900	302100	992000	2023-02-01
597	2022	689900	302100	992000	2023-02-01
597	2023	689900	302100	992000	2023-12-18
598	2020	0	30000	30000	2023-02-01
598	2021	0	35000	35000	2023-02-01
598	2022	0	35000	35000	2023-02-01
598	2023	0	35000	35000	2023-12-18
60	2020	442800	192600	635400	2023-02-01
60	2021	485100	218900	704000	2023-02-01
60	2022	485100	218900	704000	2023-02-01
60	2023	485100	218900	704000	2023-12-18
600	2020	137600	109600	247200	2023-02-01
600	2021	133000	128800	261800	2023-02-01
600	2022	133000	128800	261800	2023-02-01
600	2023	133000	128800	261800	2023-12-18
603	2020	0	20600	20600	2023-02-01
603	2021	0	20600	20600	2023-02-01
603	2022	0	20600	20600	2023-02-01
603	2023	0	19000	19000	2023-12-18
605	2020	192500	100000	292500	2023-02-01
605	2021	189700	133300	323000	2023-02-01
605	2022	189700	133300	323000	2023-02-01
605	2023	189700	133300	323000	2023-12-18
607	2020	236400	133400	369800	2023-02-01
607	2021	243800	191800	435600	2023-02-01
607	2022	243800	191800	435600	2023-02-01
607	2023	243800	191800	435600	2023-12-18
611	2020	600800	150900	751700	2023-02-01
611	2021	672000	166800	838800	2023-02-01
611	2022	672000	166800	838800	2023-02-01
611	2023	672000	166600	838600	2023-12-18
616	2020	285900	118900	404800	2023-02-01
616	2021	403700	153200	556900	2023-02-01
616	2022	403700	153200	556900	2023-02-01
616	2023	403700	153200	556900	2023-12-18
617	2020	133900	126800	260700	2023-02-01
617	2021	153300	155200	308500	2023-02-01
617	2022	175400	155200	330600	2023-02-01
617	2023	175400	155200	330600	2023-12-18
618	2020	89400	138000	227400	2023-02-01
618	2021	83100	184500	267600	2023-02-01
618	2022	83100	184500	267600	2023-02-01
618	2023	111400	241100	352500	2023-12-18
62	2020	404000	172100	576100	2023-02-01
62	2021	485300	163900	649200	2023-02-01
62	2022	498400	163900	662300	2023-02-01
62	2023	515100	163900	679000	2023-12-18
620	2020	0	6900	6900	2023-02-01
620	2021	0	6900	6900	2023-02-01
620	2022	0	6900	6900	2023-02-01
620	2023	0	6900	6900	2023-12-18
621	2020	107100	114300	221400	2023-02-01
621	2021	147400	142200	289600	2023-02-01
621	2022	147500	142200	289700	2023-02-01
621	2023	147500	142200	289700	2023-12-18
622	2020	94200	110600	204800	2023-02-01
622	2021	97700	138300	236000	2023-02-01
622	2022	97700	138300	236000	2023-02-01
622	2023	97700	138300	236000	2023-12-18
623	2020	63100	99200	162300	2023-02-01
623	2021	89500	147700	237200	2023-02-01
623	2022	89500	147700	237200	2023-02-01
623	2023	89500	147700	237200	2023-12-18
624	2020	281600	123900	405500	2023-02-01
624	2021	301300	147500	448800	2023-02-01
624	2022	301300	147600	448900	2023-02-01
624	2023	301300	147500	448800	2023-12-18
625	2020	583700	191200	774900	2023-02-01
625	2021	553700	220500	774200	2023-02-01
625	2022	553700	220500	774200	2023-02-01
625	2023	553700	220500	774200	2023-12-18
626	2020	317100	176300	493400	2023-02-01
626	2021	428100	199300	627400	2023-02-01
626	2022	428100	199300	627400	2023-02-01
626	2023	428100	199000	627100	2023-12-18
627	2020	0	1100	1100	2023-02-01
627	2021	0	1100	1100	2023-02-01
627	2022	0	1100	1100	2023-02-01
627	2023	0	1200	1200	2023-12-18
63	2020	182300	204300	386600	2023-02-01
63	2021	258400	232100	490500	2023-02-01
63	2022	258400	232100	490500	2023-02-01
63	2023	258400	232100	490500	2023-12-18
633	2020	0	521100	521100	2023-02-01
633	2021	0	585800	585800	2023-02-01
633	2022	0	585800	585800	2023-02-01
633	2023	0	585800	585800	2023-12-18
634	2020	0	7700	7700	2023-02-01
634	2021	0	7700	7700	2023-02-01
634	2022	0	7700	7700	2023-02-01
634	2023	0	7400	7400	2023-12-18
635	2020	0	2900	2900	2023-02-01
635	2021	0	4200	4200	2023-02-01
635	2022	0	4200	4200	2023-02-01
635	2023	0	4200	4200	2023-12-18
636	2020	0	3300	3300	2023-02-01
636	2021	0	4200	4200	2023-02-01
636	2022	0	4200	4200	2023-02-01
636	2023	0	4200	4200	2023-12-18
637	2020	224000	48100	272100	2023-02-01
637	2021	228800	81000	309800	2023-02-01
637	2022	228800	81000	309800	2023-02-01
637	2023	228800	81000	309800	2023-12-18
638	2020	267000	92700	359700	2023-02-01
638	2021	279300	124600	403900	2023-02-01
638	2022	279300	124600	403900	2023-02-01
638	2023	279300	124400	403700	2023-12-18
639	2020	1516800	250100	1766900	2023-02-01
639	2021	1610400	341100	1951500	2023-02-01
639	2022	1610400	341100	1951500	2023-02-01
639	2023	1610400	340800	1951200	2023-12-18
64	2020	100700	161800	262500	2023-02-01
64	2021	103900	218200	322100	2023-02-01
64	2022	103900	218200	322100	2023-02-01
64	2023	103900	218200	322100	2023-12-18
643	2020	0	37000	37000	2023-02-01
643	2021	0	40400	40400	2023-02-01
643	2022	0	40400	40400	2023-02-01
643	2023	0	40400	40400	2023-12-18
645	2020	240600	101500	342100	2023-02-01
645	2021	243400	133300	376700	2023-02-01
645	2022	243400	133300	376700	2023-02-01
645	2023	243400	133300	376700	2023-12-18
647	2020	21600	185800	207400	2023-02-01
647	2021	30000	258800	288800	2023-02-01
647	2022	30000	258800	288800	2023-02-01
647	2023	30000	258800	288800	2023-12-18
648	2020	685900	638500	1324400	2023-02-01
648	2021	838300	492700	1331000	2023-02-01
648	2022	838300	492700	1331000	2023-02-01
648	2023	838300	492700	1331000	2023-12-18
649	2020	282700	268400	551100	2023-02-01
649	2021	318500	254900	573400	2023-02-01
649	2022	318500	254900	573400	2023-02-01
649	2023	318500	254900	573400	2023-12-18
65	2020	288100	201400	489500	2023-02-01
65	2021	316000	228900	544900	2023-02-01
65	2022	436100	228900	665000	2023-02-01
65	2023	482500	228900	711400	2023-12-18
650	2020	187900	222000	409900	2023-02-01
650	2021	183500	235400	418900	2023-02-01
650	2022	183500	235400	418900	2023-02-01
650	2023	183500	235400	418900	2023-12-18
651	2020	180700	244500	425200	2023-02-01
651	2021	183300	278100	461400	2023-02-01
651	2022	183300	278100	461400	2023-02-01
651	2023	183300	278100	461400	2023-12-18
652	2020	32100	154400	186500	2023-02-01
652	2021	23900	208300	232200	2023-02-01
652	2022	23900	208300	232200	2023-02-01
652	2023	23900	208300	232200	2023-12-18
653	2020	94600	198400	293000	2023-02-01
653	2021	68500	262400	330900	2023-02-01
653	2022	68500	262400	330900	2023-02-01
653	2023	68500	262400	330900	2023-12-18
654	2020	80800	196700	277500	2023-02-01
654	2021	107000	269200	376200	2023-02-01
654	2022	107000	269200	376200	2023-02-01
654	2023	107000	268900	375900	2023-12-18
655	2020	421300	275600	696900	2023-02-01
655	2021	480400	433200	913600	2023-02-01
655	2022	480400	433200	913600	2023-02-01
655	2023	480400	433200	913600	2023-12-18
659	2020	0	12100	12100	2023-02-01
659	2021	0	13900	13900	2023-02-01
659	2022	0	13900	13900	2023-02-01
659	2023	0	13900	13900	2023-12-18
66	2020	205200	203200	408400	2023-02-01
66	2021	218800	230900	449700	2023-02-01
66	2022	218800	230900	449700	2023-02-01
66	2023	218800	230900	449700	2023-12-18
664	2020	69800	107300	177100	2023-02-01
664	2021	55700	128400	184100	2023-02-01
664	2022	55700	128400	184100	2023-02-01
664	2023	55700	128400	184100	2023-12-18
667	2020	21800	65500	87300	2023-02-01
667	2021	18200	100700	118900	2023-02-01
667	2022	18200	100700	118900	2023-02-01
667	2023	18200	100700	118900	2023-12-18
67	2020	0	87400	87400	2023-02-01
67	2021	0	103200	103200	2023-02-01
67	2022	0	103200	103200	2023-02-01
67	2023	0	103200	103200	2023-12-18
673	2020	51500	141300	192800	2023-02-01
673	2021	44600	194900	239500	2023-02-01
673	2022	44600	194900	239500	2023-02-01
673	2023	44600	194900	239500	2023-12-18
675	2020	0	10300	10300	2023-02-01
675	2021	0	11300	11300	2023-02-01
675	2022	0	11300	11300	2023-02-01
675	2023	0	11200	11200	2023-12-18
68	2020	136000	120600	256600	2023-02-01
68	2021	127000	157100	284100	2023-02-01
68	2022	127000	157100	284100	2023-02-01
68	2023	127000	157100	284100	2023-12-18
686	2020	0	10500	10500	2023-02-01
686	2021	0	11600	11600	2023-02-01
686	2022	0	11600	11600	2023-02-01
686	2023	0	11600	11600	2023-12-18
688	2020	2300	50000	52300	2023-02-01
688	2021	2600	47600	50200	2023-02-01
688	2022	2600	47600	50200	2023-02-01
688	2023	2600	47600	50200	2023-12-18
689	2020	223400	142500	365900	2023-02-01
689	2021	301300	161700	463000	2023-02-01
689	2022	309800	161700	471500	2023-02-01
689	2023	281400	161600	443000	2023-12-18
69	2020	0	8400	8400	2023-02-01
69	2021	0	8600	8600	2023-02-01
69	2022	0	8600	8600	2023-02-01
69	2023	0	8600	8600	2023-12-18
690	2020	591800	191700	783500	2023-02-01
690	2021	726400	200500	926900	2023-02-01
690	2022	726400	200500	926900	2023-02-01
690	2023	726400	200500	926900	2023-12-18
691	2020	405100	169900	575000	2023-02-01
691	2021	400600	212900	613500	2023-02-01
691	2022	400600	212900	613500	2023-02-01
691	2023	400600	212900	613500	2023-12-18
692	2020	516900	151300	668200	2023-02-01
692	2021	578500	227500	806000	2023-02-01
692	2022	578500	227500	806000	2023-02-01
692	2023	578500	227500	806000	2023-12-18
694	2020	163000	114700	277700	2023-02-01
694	2021	191000	152200	343200	2023-02-01
694	2022	192900	152200	345100	2023-02-01
694	2023	192900	152200	345100	2023-12-18
695	2020	138900	157700	296600	2023-02-01
695	2021	179300	193800	373100	2023-02-01
695	2022	179300	193800	373100	2023-02-01
695	2023	179300	193800	373100	2023-12-18
696	2020	294500	165700	460200	2023-02-01
696	2021	301800	191200	493000	2023-02-01
696	2022	324100	191200	515300	2023-02-01
696	2023	324100	191200	515300	2023-12-18
697	2020	169800	153100	322900	2023-02-01
697	2021	227900	136100	364000	2023-02-01
697	2022	227900	136100	364000	2023-02-01
697	2023	227900	136000	363900	2023-12-18
698	2020	463100	180800	643900	2023-02-01
698	2021	486500	179200	665700	2023-02-01
698	2022	486500	179200	665700	2023-02-01
698	2023	486500	179200	665700	2023-12-18
7	2020	62000	88200	150200	2023-02-01
7	2021	77200	104600	181800	2023-02-01
7	2022	77200	104600	181800	2023-02-01
7	2023	77200	104600	181800	2023-12-18
700	2020	40900	72900	113800	2023-02-01
700	2021	48900	77600	126500	2023-02-01
700	2022	48900	77600	126500	2023-02-01
700	2023	48900	77600	126500	2023-12-18
701	2020	151100	142000	293100	2023-02-01
701	2021	208100	176600	384700	2023-02-01
701	2022	208100	176600	384700	2023-02-01
701	2023	211800	176600	388400	2023-12-18
702	2020	213600	119400	333000	2023-02-01
702	2021	216000	149500	365500	2023-02-01
702	2022	216000	149500	365500	2023-02-01
702	2023	216000	149500	365500	2023-12-18
703	2020	57500	143600	201100	2023-02-01
703	2021	66400	191800	258200	2023-02-01
703	2022	66400	191800	258200	2023-02-01
703	2023	66400	191800	258200	2023-12-18
704	2020	128500	111800	240300	2023-02-01
704	2021	146600	149000	295600	2023-02-01
704	2022	146600	149000	295600	2023-02-01
704	2023	146600	149000	295600	2023-12-18
705	2020	2000	8000	10000	2023-02-01
705	2021	2000	8800	10800	2023-02-01
705	2022	2000	8800	10800	2023-02-01
705	2023	2000	8800	10800	2023-12-18
706	2020	202400	158400	360800	2023-02-01
706	2021	213600	196500	410100	2023-02-01
706	2022	213600	196500	410100	2023-02-01
706	2023	213600	196500	410100	2023-12-18
707	2020	218500	139600	358100	2023-02-01
707	2021	210800	170800	381600	2023-02-01
707	2022	210800	170800	381600	2023-02-01
707	2023	210800	170800	381600	2023-12-18
708	2020	153200	119600	272800	2023-02-01
708	2021	144900	157600	302500	2023-02-01
708	2022	144900	157600	302500	2023-02-01
708	2023	144900	157600	302500	2023-12-18
711	2020	157400	96300	253700	2023-02-01
711	2021	162700	125900	288600	2023-02-01
711	2022	162700	125900	288600	2023-02-01
711	2023	162700	125900	288600	2023-12-18
717	2020	0	9600	9600	2023-02-01
717	2021	0	9600	9600	2023-02-01
717	2022	0	9600	9600	2023-02-01
717	2023	0	9400	9400	2023-12-18
719	2020	222600	143600	366200	2023-02-01
719	2021	341500	157400	498900	2023-02-01
719	2022	347200	157400	504600	2023-02-01
719	2023	347200	157300	504500	2023-12-18
720	2020	153400	137000	290400	2023-02-01
720	2021	213000	175200	388200	2023-02-01
720	2022	213000	175200	388200	2023-02-01
720	2023	213000	175200	388200	2023-12-18
723	2020	136500	112000	248500	2023-02-01
723	2021	209100	145600	354700	2023-02-01
723	2022	249500	145600	395100	2023-02-01
723	2023	262400	145600	408000	2023-12-18
724	2020	0	22000	22000	2023-02-01
724	2021	0	21900	21900	2023-02-01
724	2022	0	21900	21900	2023-02-01
724	2023	0	142400	142400	2023-12-18
725	2020	390300	192300	582600	2023-02-01
725	2021	446600	217700	664300	2023-02-01
725	2022	446600	217700	664300	2023-02-01
725	2023	446600	217700	664300	2023-12-18
734	2020	527600	227300	754900	2023-02-01
734	2021	559500	267700	827200	2023-02-01
734	2022	559500	267700	827200	2023-02-01
734	2023	559500	267700	827200	2023-12-18
735	2020	0	205100	205100	2023-02-01
735	2021	0	270500	270500	2023-02-01
735	2022	0	258100	258100	2023-02-01
735	2023	0	258100	258100	2023-12-18
736	2020	977700	289500	1267200	2023-02-01
736	2021	1054700	284700	1339400	2023-02-01
736	2022	1054700	284700	1339400	2023-02-01
736	2023	1054700	284700	1339400	2023-12-18
737	2020	732000	185900	917900	2023-02-01
737	2021	854300	275100	1129400	2023-02-01
737	2022	854300	275100	1129400	2023-02-01
737	2023	854300	275100	1129400	2023-12-18
738	2020	354000	183600	537600	2023-02-01
738	2021	375400	271100	646500	2023-02-01
738	2022	375400	271100	646500	2023-02-01
738	2023	375400	271100	646500	2023-12-18
739	2020	409400	265000	674400	2023-02-01
739	2021	540400	329500	869900	2023-02-01
739	2022	471700	329500	801200	2023-02-01
739	2023	420500	329500	750000	2023-12-18
740	2020	651900	298400	950300	2023-02-01
740	2021	668000	334400	1002400	2023-02-01
740	2022	668000	334400	1002400	2023-02-01
740	2023	668000	334400	1002400	2023-12-18
741	2020	120000	163100	283100	2023-02-01
741	2021	146100	243200	389300	2023-02-01
741	2022	136000	199900	335900	2023-02-01
741	2023	136000	199700	335700	2023-12-18
742	2020	562800	252000	814800	2023-02-01
742	2021	602000	274100	876100	2023-02-01
742	2022	602000	274100	876100	2023-02-01
742	2023	602000	274100	876100	2023-12-18
743	2020	254400	215800	470200	2023-02-01
743	2021	256800	294500	551300	2023-02-01
743	2022	258000	268600	526600	2023-02-01
743	2023	254600	268600	523200	2023-12-18
744	2020	446100	255900	702000	2023-02-01
744	2021	525500	222500	748000	2023-02-01
744	2022	525500	222500	748000	2023-02-01
744	2023	330000	222500	552500	2023-12-18
745	2020	0	7000	7000	2023-02-01
745	2021	0	7000	7000	2023-02-01
745	2022	0	7000	7000	2023-02-01
745	2023	0	7000	7000	2023-12-18
746	2020	609500	263000	872500	2023-02-01
746	2021	657300	297600	954900	2023-02-01
746	2022	657300	297600	954900	2023-02-01
746	2023	657300	297600	954900	2023-12-18
747	2020	362200	228900	591100	2023-02-01
747	2021	394000	330800	724800	2023-02-01
747	2022	454400	330800	785200	2023-02-01
747	2023	456000	330800	786800	2023-12-18
748	2020	373100	252700	625800	2023-02-01
748	2021	424400	311400	735800	2023-02-01
748	2022	424400	311400	735800	2023-02-01
748	2023	424400	311300	735700	2023-12-18
749	2020	1049800	378300	1428100	2023-02-01
749	2021	1062400	477600	1540000	2023-02-01
749	2022	1062400	477700	1540100	2023-02-01
749	2023	1062400	477700	1540100	2023-12-18
750	2020	822300	206900	1029200	2023-02-01
750	2021	926200	272500	1198700	2023-02-01
750	2022	1008100	272500	1280600	2023-02-01
750	2023	1008100	272500	1280600	2023-12-18
751	2020	284300	142000	426300	2023-02-01
751	2021	299700	169900	469600	2023-02-01
751	2022	311800	169900	481700	2023-02-01
751	2023	311800	169900	481700	2023-12-18
752	2020	293500	185500	479000	2023-02-01
752	2021	335600	185000	520600	2023-02-01
752	2022	335600	185000	520600	2023-02-01
752	2023	335600	184900	520500	2023-12-18
753	2020	415300	348400	763700	2023-02-01
753	2021	475900	353400	829300	2023-02-01
753	2022	475900	353400	829300	2023-02-01
753	2023	475900	353400	829300	2023-12-18
754	2020	499500	173600	673100	2023-02-01
754	2021	506500	179500	686000	2023-02-01
754	2022	506500	179500	686000	2023-02-01
754	2023	506500	179200	685700	2023-12-18
755	2020	139600	115500	255100	2023-02-01
755	2021	167000	173400	340400	2023-02-01
755	2022	173500	173400	346900	2023-02-01
755	2023	173500	173400	346900	2023-12-18
756	2020	350100	251200	601300	2023-02-01
756	2021	363200	293800	657000	2023-02-01
756	2022	363200	293900	657100	2023-02-01
756	2023	363200	293900	657100	2023-12-18
757	2020	0	226900	226900	2023-02-01
757	2021	0	251800	251800	2023-02-01
757	2022	0	251800	251800	2023-02-01
757	2023	0	251800	251800	2023-12-18
758	2020	108400	128600	237000	2023-02-01
758	2021	122500	165700	288200	2023-02-01
758	2022	122500	165700	288200	2023-02-01
758	2023	122500	165700	288200	2023-12-18
759	2020	95400	139500	234900	2023-02-01
759	2021	103400	177900	281300	2023-02-01
759	2022	103400	177900	281300	2023-02-01
759	2023	103400	177900	281300	2023-12-18
76	2020	537500	206400	743900	2023-02-01
76	2021	519800	234400	754200	2023-02-01
76	2022	519800	234400	754200	2023-02-01
76	2023	519800	234400	754200	2023-12-18
760	2020	0	113100	113100	2023-02-01
760	2021	0	136500	136500	2023-02-01
760	2022	0	136500	136500	2023-02-01
760	2023	0	136300	136300	2023-12-18
762	2020	0	500	500	2023-02-01
762	2021	0	500	500	2023-02-01
762	2022	0	500	500	2023-02-01
762	2023	0	500	500	2023-12-18
764	2020	55500	84500	140000	2023-02-01
764	2021	53400	141100	194500	2023-02-01
764	2022	53400	141100	194500	2023-02-01
764	2023	53400	141100	194500	2023-12-18
765	2020	313300	175800	489100	2023-02-01
765	2021	313700	150400	464100	2023-02-01
765	2022	313700	150400	464100	2023-02-01
765	2023	313700	148700	462400	2023-12-18
767	2020	7400	26600	34000	2023-02-01
767	2021	8700	29100	37800	2023-02-01
767	2022	8700	29100	37800	2023-02-01
767	2023	8700	29600	38300	2023-12-18
768	2020	464000	168200	632200	2023-02-01
768	2021	627900	215800	843700	2023-02-01
768	2022	639200	215800	855000	2023-02-01
768	2023	639200	215800	855000	2023-12-18
769	2020	193700	115300	309000	2023-02-01
769	2021	195800	149200	345000	2023-02-01
769	2022	195800	149200	345000	2023-02-01
769	2023	195800	149200	345000	2023-12-18
77	2020	338100	206800	544900	2023-02-01
77	2021	343500	234900	578400	2023-02-01
77	2022	343500	234900	578400	2023-02-01
77	2023	343500	234900	578400	2023-12-18
770	2020	0	6400	6400	2023-02-01
770	2021	0	6400	6400	2023-02-01
770	2022	0	6400	6400	2023-02-01
770	2023	0	6300	6300	2023-12-18
771	2020	216300	160700	377000	2023-02-01
771	2021	283000	205900	488900	2023-02-01
771	2022	283000	205900	488900	2023-02-01
771	2023	283000	205900	488900	2023-12-18
772	2020	250900	124800	375700	2023-02-01
772	2021	256700	176600	433300	2023-02-01
772	2022	256700	176600	433300	2023-02-01
772	2023	256700	176600	433300	2023-12-18
773	2020	0	107300	107300	2023-02-01
773	2021	0	142900	142900	2023-02-01
773	2022	0	142900	142900	2023-02-01
773	2023	0	142900	142900	2023-12-18
774	2020	125900	107500	233400	2023-02-01
774	2021	161200	147700	308900	2023-02-01
774	2022	161200	147700	308900	2023-02-01
774	2023	161200	147700	308900	2023-12-18
775	2020	91900	123000	214900	2023-02-01
775	2021	127300	164800	292100	2023-02-01
775	2022	127300	164800	292100	2023-02-01
775	2023	127300	164800	292100	2023-12-18
776	2020	370200	131400	501600	2023-02-01
776	2021	404000	206900	610900	2023-02-01
776	2022	404000	206900	610900	2023-02-01
776	2023	404000	206900	610900	2023-12-18
78	2020	132600	190400	323000	2023-02-01
78	2021	173800	216500	390300	2023-02-01
78	2022	173800	216500	390300	2023-02-01
78	2023	173800	216500	390300	2023-12-18
782	2020	760400	308000	1068400	2023-02-01
782	2021	831100	285700	1116800	2023-02-01
782	2022	831100	285700	1116800	2023-02-01
782	2023	831100	285700	1116800	2023-12-18
783	2020	117400	106300	223700	2023-02-01
783	2021	94200	152700	246900	2023-02-01
783	2022	94200	152700	246900	2023-02-01
783	2023	94200	152700	246900	2023-12-18
784	2020	10400	140300	150700	2023-02-01
784	2021	11200	149400	160600	2023-02-01
784	2022	11200	149400	160600	2023-02-01
784	2023	11200	149400	160600	2023-12-18
785	2020	701000	398200	1099200	2023-02-01
785	2021	857100	314100	1171200	2023-02-01
785	2022	857100	314100	1171200	2023-02-01
785	2023	857100	314000	1171100	2023-12-18
786	2020	419400	311500	730900	2023-02-01
786	2021	484200	240000	724200	2023-02-01
786	2022	484200	240000	724200	2023-02-01
786	2023	484200	240000	724200	2023-12-18
787	2020	247800	95100	342900	2023-02-01
787	2021	238800	166500	405300	2023-02-01
787	2022	238800	166500	405300	2023-02-01
787	2023	238800	166500	405300	2023-12-18
788	2020	95300	122000	217300	2023-02-01
788	2021	136300	156300	292600	2023-02-01
788	2022	136300	156300	292600	2023-02-01
788	2023	136300	156300	292600	2023-12-18
789	2020	194500	102000	296500	2023-02-01
789	2021	273500	130600	404100	2023-02-01
789	2022	288700	130600	419300	2023-02-01
789	2023	288700	130600	419300	2023-12-18
79	2020	105400	190200	295600	2023-02-01
79	2021	116800	216500	333300	2023-02-01
79	2022	116800	216500	333300	2023-02-01
79	2023	116800	216500	333300	2023-12-18
792	2020	408600	137100	545700	2023-02-01
792	2021	413000	181300	594300	2023-02-01
792	2022	413000	181300	594300	2023-02-01
792	2023	413000	181300	594300	2023-12-18
793	2020	0	2800	2800	2023-02-01
793	2021	0	2800	2800	2023-02-01
793	2022	0	2800	2800	2023-02-01
793	2023	0	2700	2700	2023-12-18
795	2020	200700	124300	325000	2023-02-01
795	2021	236000	161200	397200	2023-02-01
795	2022	236000	161200	397200	2023-02-01
795	2023	236000	161200	397200	2023-12-18
796	2020	48000	53000	101000	2023-02-01
796	2021	55500	94000	149500	2023-02-01
796	2022	55500	94000	149500	2023-02-01
796	2023	55500	94000	149500	2023-12-18
797	2020	529200	183900	713100	2023-02-01
797	2021	535400	214900	750300	2023-02-01
797	2022	535400	214900	750300	2023-02-01
797	2023	535400	214900	750300	2023-12-18
798	2020	5200	133200	138400	2023-02-01
798	2021	5400	148600	154000	2023-02-01
798	2022	5400	148600	154000	2023-02-01
798	2023	5400	147600	153000	2023-12-18
799	2020	363200	161600	524800	2023-02-01
799	2021	375900	182900	558800	2023-02-01
799	2022	375900	182900	558800	2023-02-01
799	2023	375900	182900	558800	2023-12-18
8	2020	106600	101200	207800	2023-02-01
8	2021	114000	140400	254400	2023-02-01
8	2022	114000	140400	254400	2023-02-01
8	2023	114000	140400	254400	2023-12-18
80	2020	226900	265000	491900	2023-02-01
80	2021	301600	317200	618800	2023-02-01
80	2022	301600	317200	618800	2023-02-01
80	2023	301600	317200	618800	2023-12-18
800	2020	1126900	310300	1437200	2023-02-01
800	2021	1185500	328400	1513900	2023-02-01
800	2022	1185500	328400	1513900	2023-02-01
800	2023	1185500	328400	1513900	2023-12-18
801	2020	384700	192800	577500	2023-02-01
801	2021	395700	215800	611500	2023-02-01
801	2022	395700	216100	611800	2023-02-01
801	2023	395700	215700	611400	2023-12-18
804	2020	364800	170300	535100	2023-02-01
804	2021	453900	235100	689000	2023-02-01
804	2022	453900	235100	689000	2023-02-01
804	2023	453900	235000	688900	2023-12-18
806	2020	545900	178900	724800	2023-02-01
806	2021	715100	206400	921500	2023-02-01
806	2022	715100	206400	921500	2023-02-01
806	2023	715100	206300	921400	2023-12-18
807	2020	0	14500	14500	2023-02-01
807	2021	0	14500	14500	2023-02-01
807	2022	0	14500	14500	2023-02-01
807	2023	0	13700	13700	2023-12-18
808	2020	227400	162700	390100	2023-02-01
808	2021	268500	184100	452600	2023-02-01
808	2022	268500	184100	452600	2023-02-01
808	2023	268500	184100	452600	2023-12-18
809	2020	157100	169000	326100	2023-02-01
809	2021	194900	182800	377700	2023-02-01
809	2022	194900	182800	377700	2023-02-01
809	2023	194900	182800	377700	2023-12-18
81	2020	119100	255500	374600	2023-02-01
81	2021	139400	290400	429800	2023-02-01
81	2022	92200	233300	325500	2023-02-01
81	2023	92200	233300	325500	2023-12-18
810	2020	780200	262300	1042500	2023-02-01
810	2021	747800	259700	1007500	2023-02-01
810	2022	747800	259700	1007500	2023-02-01
810	2023	747800	259700	1007500	2023-12-18
811	2020	15100	191000	206100	2023-02-01
811	2021	17300	214900	232200	2023-02-01
811	2022	17300	214900	232200	2023-02-01
811	2023	17300	214800	232100	2023-12-18
812	2020	207600	107200	314800	2023-02-01
812	2021	256800	139900	396700	2023-02-01
812	2022	261500	139900	401400	2023-02-01
812	2023	225800	136500	362300	2023-12-18
814	2020	513600	155000	668600	2023-02-01
814	2021	494100	176200	670300	2023-02-01
814	2022	494100	176200	670300	2023-02-01
814	2023	494100	176200	670300	2023-12-18
815	2020	334900	200900	535800	2023-02-01
815	2021	378600	252100	630700	2023-02-01
815	2022	378600	252100	630700	2023-02-01
815	2023	378600	252100	630700	2023-12-18
816	2020	559700	166600	726300	2023-02-01
816	2021	611800	222200	834000	2023-02-01
816	2022	611800	222200	834000	2023-02-01
816	2023	641800	222100	863900	2023-12-18
82	2020	157800	186800	344600	2023-02-01
82	2021	217700	199300	417000	2023-02-01
82	2022	217700	199300	417000	2023-02-01
82	2023	217700	199300	417000	2023-12-18
820	2020	839700	207500	1047200	2023-02-01
820	2021	954300	195200	1149500	2023-02-01
820	2022	954300	195200	1149500	2023-02-01
820	2023	954300	195200	1149500	2023-12-18
821	2020	0	1300	1300	2023-02-01
821	2021	0	1300	1300	2023-02-01
821	2022	0	1300	1300	2023-02-01
821	2023	0	1300	1300	2023-12-18
824	2020	31300	146500	177800	2023-02-01
824	2021	38200	190600	228800	2023-02-01
824	2022	38200	190600	228800	2023-02-01
824	2023	38200	190600	228800	2023-12-18
826	2020	278700	152800	431500	2023-02-01
826	2021	301900	207100	509000	2023-02-01
826	2022	301900	207100	509000	2023-02-01
826	2023	301900	207100	509000	2023-12-18
827	2020	728500	531300	1259800	2023-02-01
827	2021	749700	566000	1315700	2023-02-01
827	2022	749700	566000	1315700	2023-02-01
827	2023	749700	565900	1315600	2023-12-18
829	2020	325300	210600	535900	2023-02-01
829	2021	393900	294900	688800	2023-02-01
829	2022	393900	294900	688800	2023-02-01
829	2023	393900	294900	688800	2023-12-18
83	2020	151100	170400	321500	2023-02-01
83	2021	189900	161800	351700	2023-02-01
83	2022	190300	161800	352100	2023-02-01
83	2023	190300	161800	352100	2023-12-18
830	2020	133400	93400	226800	2023-02-01
830	2021	159900	138800	298700	2023-02-01
830	2022	159900	138800	298700	2023-02-01
830	2023	159900	138800	298700	2023-12-18
831	2020	1092100	661200	1753300	2023-02-01
831	2021	1136400	699600	1836000	2023-02-01
831	2022	1136400	699600	1836000	2023-02-01
831	2023	1136400	699600	1836000	2023-12-18
832	2020	0	69000	69000	2023-02-01
832	2021	0	100800	100800	2023-02-01
832	2022	0	100800	100800	2023-02-01
832	2023	0	100800	100800	2023-12-18
833	2020	287200	122800	410000	2023-02-01
833	2021	392400	180000	572400	2023-02-01
833	2022	342900	180000	522900	2023-02-01
833	2023	342900	180000	522900	2023-12-18
834	2020	150100	100700	250800	2023-02-01
834	2021	156300	120200	276500	2023-02-01
834	2022	156300	120200	276500	2023-02-01
834	2023	156300	120200	276500	2023-12-18
835	2020	325000	172600	497600	2023-02-01
835	2021	342000	236200	578200	2023-02-01
835	2022	342000	236200	578200	2023-02-01
835	2023	342000	236200	578200	2023-12-18
836	2020	7700	15700	23400	2023-02-01
836	2021	0	18800	18800	2023-02-01
836	2022	0	18800	18800	2023-02-01
836	2023	0	18800	18800	2023-12-18
837	2020	355900	146000	501900	2023-02-01
837	2021	484200	244700	728900	2023-02-01
837	2022	498200	244700	742900	2023-02-01
837	2023	499700	244700	744400	2023-12-18
838	2020	236500	110900	347400	2023-02-01
838	2021	258300	142000	400300	2023-02-01
838	2022	258600	142000	400600	2023-02-01
838	2023	258600	142000	400600	2023-12-18
839	2020	470800	139800	610600	2023-02-01
839	2021	534600	180000	714600	2023-02-01
839	2022	534600	180000	714600	2023-02-01
839	2023	534600	179900	714500	2023-12-18
84	2020	2800400	1387500	4187900	2023-02-01
84	2021	3187200	2000100	5187300	2023-02-01
84	2022	3187200	2000100	5187300	2023-02-01
84	2023	3187200	2000100	5187300	2023-12-18
840	2020	19400	99100	118500	2023-02-01
840	2021	106100	130700	236800	2023-02-01
840	2022	107300	130700	238000	2023-02-01
840	2023	127400	137200	264600	2023-12-18
841	2020	507800	156800	664600	2023-02-01
841	2021	543500	205900	749400	2023-02-01
841	2022	543500	205900	749400	2023-02-01
841	2023	543500	205900	749400	2023-12-18
842	2020	116200	83900	200100	2023-02-01
842	2021	127100	93200	220300	2023-02-01
842	2022	127100	93200	220300	2023-02-01
842	2023	127100	93200	220300	2023-12-18
843	2020	75700	118000	193700	2023-02-01
843	2021	83600	152200	235800	2023-02-01
843	2022	83600	152200	235800	2023-02-01
843	2023	83600	152200	235800	2023-12-18
844	2020	5900	79900	85800	2023-02-01
844	2021	4300	88900	93200	2023-02-01
844	2022	4300	88900	93200	2023-02-01
844	2023	4300	88700	93000	2023-12-18
845	2020	180800	108400	289200	2023-02-01
845	2021	211500	141600	353100	2023-02-01
845	2022	211500	141600	353100	2023-02-01
845	2023	211500	141600	353100	2023-12-18
846	2020	0	87900	87900	2023-02-01
846	2021	0	113800	113800	2023-02-01
846	2022	0	113800	113800	2023-02-01
846	2023	0	113800	113800	2023-12-18
849	2020	0	104600	104600	2023-02-01
849	2021	0	117700	117700	2023-02-01
849	2022	0	117700	117700	2023-02-01
849	2023	0	117700	117700	2023-12-18
85	2020	0	16400	16400	2023-02-01
85	2021	0	16900	16900	2023-02-01
85	2022	0	16900	16900	2023-02-01
85	2023	0	16900	16900	2023-12-18
850	2020	45400	99500	144900	2023-02-01
850	2021	33500	152200	185700	2023-02-01
850	2022	33500	152200	185700	2023-02-01
850	2023	33500	152200	185700	2023-12-18
851	2020	1400	38000	39400	2023-02-01
851	2021	1500	46500	48000	2023-02-01
851	2022	1500	46500	48000	2023-02-01
851	2023	1500	46500	48000	2023-12-18
852	2020	45000	85400	130400	2023-02-01
852	2021	35100	139500	174600	2023-02-01
852	2022	35100	139500	174600	2023-02-01
852	2023	35100	139500	174600	2023-12-18
853	2020	104000	64000	168000	2023-02-01
853	2021	79000	125500	204500	2023-02-01
853	2022	79000	125500	204500	2023-02-01
853	2023	79000	125500	204500	2023-12-18
855	2020	52900	77600	130500	2023-02-01
855	2021	42800	128800	171600	2023-02-01
855	2022	42800	128800	171600	2023-02-01
855	2023	42800	128800	171600	2023-12-18
858	2020	0	8700	8700	2023-02-01
858	2021	0	8700	8700	2023-02-01
858	2022	0	8700	8700	2023-02-01
858	2023	0	8500	8500	2023-12-18
86	2020	422300	201400	623700	2023-02-01
86	2021	471700	228900	700600	2023-02-01
86	2022	471700	228900	700600	2023-02-01
86	2023	471700	228900	700600	2023-12-18
860	2020	0	7000	7000	2023-02-01
860	2021	0	7000	7000	2023-02-01
860	2022	0	7000	7000	2023-02-01
860	2023	0	7000	7000	2023-12-18
861	2020	217300	106000	323300	2023-02-01
861	2021	203600	139000	342600	2023-02-01
861	2022	203600	139000	342600	2023-02-01
861	2023	203600	139000	342600	2023-12-18
862	2020	750000	273400	1023400	2023-02-01
862	2021	714500	334100	1048600	2023-02-01
862	2022	714100	334100	1048200	2023-02-01
862	2023	714100	334100	1048200	2023-12-18
863	2020	0	300	300	2023-02-01
863	2021	0	300	300	2023-02-01
863	2022	0	300	300	2023-02-01
863	2023	0	300	300	2023-12-18
864	2020	0	300	300	2023-02-01
864	2021	0	300	300	2023-02-01
864	2022	0	300	300	2023-02-01
864	2023	0	300	300	2023-12-18
865	2020	722900	360000	1082900	2023-02-01
865	2021	913800	228200	1142000	2023-02-01
865	2022	913800	228200	1142000	2023-02-01
865	2023	913800	228300	1142100	2023-12-18
867	2020	1013800	592200	1606000	2023-02-01
867	2021	1064900	632100	1697000	2023-02-01
867	2022	1064900	632100	1697000	2023-02-01
867	2023	1064900	632100	1697000	2023-12-18
868	2020	306200	141600	447800	2023-02-01
868	2021	314000	177800	491800	2023-02-01
868	2022	314000	177800	491800	2023-02-01
868	2023	314000	177700	491700	2023-12-18
869	2020	163800	126000	289800	2023-02-01
869	2021	209700	155600	365300	2023-02-01
869	2022	209700	155600	365300	2023-02-01
869	2023	209700	155600	365300	2023-12-18
87	2020	373400	225400	598800	2023-02-01
87	2021	379700	256000	635700	2023-02-01
87	2022	379700	256000	635700	2023-02-01
87	2023	379700	256000	635700	2023-12-18
871	2020	313200	182700	495900	2023-02-01
871	2021	367100	181500	548600	2023-02-01
871	2022	367100	181500	548600	2023-02-01
871	2023	367100	181500	548600	2023-12-18
872	2020	411800	141500	553300	2023-02-01
872	2021	397900	202700	600600	2023-02-01
872	2022	397900	202700	600600	2023-02-01
872	2023	397900	202600	600500	2023-12-18
873	2020	504500	320300	824800	2023-02-01
873	2021	522300	318800	841100	2023-02-01
873	2022	522300	318800	841100	2023-02-01
873	2023	522300	318300	840600	2023-12-18
874	2020	117400	287800	405200	2023-02-01
874	2021	146500	300200	446700	2023-02-01
874	2022	146500	300200	446700	2023-02-01
874	2023	146500	300200	446700	2023-12-18
875	2020	411400	201500	612900	2023-02-01
875	2021	434800	228300	663100	2023-02-01
875	2022	434800	228300	663100	2023-02-01
875	2023	434800	228300	663100	2023-12-18
876	2020	157300	247200	404500	2023-02-01
876	2021	187900	263500	451400	2023-02-01
876	2022	187900	263400	451300	2023-02-01
876	2023	187900	263400	451300	2023-12-18
877	2020	401000	322800	723800	2023-02-01
877	2021	468400	315800	784200	2023-02-01
877	2022	468400	315800	784200	2023-02-01
877	2023	468400	315800	784200	2023-12-18
878	2020	294700	221600	516300	2023-02-01
878	2021	325900	336100	662000	2023-02-01
878	2022	325900	336100	662000	2023-02-01
878	2023	326300	335900	662200	2023-12-18
879	2020	167000	130600	297600	2023-02-01
879	2021	183200	164800	348000	2023-02-01
879	2022	183200	164700	347900	2023-02-01
879	2023	183200	164500	347700	2023-12-18
88	2020	36900	75200	112100	2023-02-01
88	2021	43200	113400	156600	2023-02-01
88	2022	43200	113400	156600	2023-02-01
88	2023	43200	113400	156600	2023-12-18
880	2020	345800	160000	505800	2023-02-01
880	2021	384400	181600	566000	2023-02-01
880	2022	384400	181600	566000	2023-02-01
880	2023	384400	181600	566000	2023-12-18
881	2020	990200	361200	1351400	2023-02-01
881	2021	1268800	289500	1558300	2023-02-01
881	2022	1268800	289500	1558300	2023-02-01
881	2023	1268800	289500	1558300	2023-12-18
883	2020	31000	37900	68900	2023-02-01
883	2021	21300	51700	73000	2023-02-01
883	2022	21300	51700	73000	2023-02-01
883	2023	21300	51700	73000	2023-12-18
884	2020	169000	142300	311300	2023-02-01
884	2021	191000	161500	352500	2023-02-01
884	2022	191000	161500	352500	2023-02-01
884	2023	191000	161600	352600	2023-12-18
887	2020	950800	398700	1349500	2023-02-01
887	2021	998100	362200	1360300	2023-02-01
887	2022	998100	362200	1360300	2023-02-01
887	2023	998100	362200	1360300	2023-12-18
888	2020	0	800	800	2023-02-01
888	2021	0	800	800	2023-02-01
888	2022	0	800	800	2023-02-01
888	2023	0	800	800	2023-12-18
89	2020	272500	211800	484300	2023-02-01
89	2021	252300	239500	491800	2023-02-01
89	2022	252300	239000	491300	2023-02-01
89	2023	269500	238900	508400	2023-12-18
891	2020	334900	113000	447900	2023-02-01
891	2021	403600	113200	516800	2023-02-01
891	2022	403600	113200	516800	2023-02-01
891	2023	405300	113200	518500	2023-12-18
892	2020	0	5100	5100	2023-02-01
892	2021	0	155100	155100	2023-02-01
892	2022	0	155100	155100	2023-02-01
892	2023	0	5000	5000	2023-12-18
895	2020	574400	192900	767300	2023-02-01
895	2021	743700	198200	941900	2023-02-01
895	2022	786900	198200	985100	2023-02-01
895	2023	786900	198200	985100	2023-12-18
896	2020	885800	307400	1193200	2023-02-01
896	2021	1117300	270000	1387300	2023-02-01
896	2022	1117300	270000	1387300	2023-02-01
896	2023	1117300	270000	1387300	2023-12-18
897	2020	0	6100	6100	2023-02-01
897	2021	0	6100	6100	2023-02-01
897	2022	0	6100	6100	2023-02-01
897	2023	0	6100	6100	2023-12-18
898	2020	0	1200	1200	2023-02-01
898	2021	0	1200	1200	2023-02-01
898	2022	0	1200	1200	2023-02-01
898	2023	0	1200	1200	2023-12-18
899	2020	604100	267900	872000	2023-02-01
899	2021	738600	266100	1004700	2023-02-01
899	2022	581100	266100	847200	2023-02-01
899	2023	581100	266100	847200	2023-12-18
9	2020	89500	121300	210800	2023-02-01
9	2021	108900	157900	266800	2023-02-01
9	2022	112100	157900	270000	2023-02-01
9	2023	112100	157900	270000	2023-12-18
900	2020	517700	391600	909300	2023-02-01
900	2021	563900	440300	1004200	2023-02-01
900	2022	563900	440300	1004200	2023-02-01
900	2023	563900	440300	1004200	2023-12-18
901	2020	96400	109300	205700	2023-02-01
901	2021	114200	178100	292300	2023-02-01
901	2022	114200	178100	292300	2023-02-01
901	2023	114200	178100	292300	2023-12-18
907	2020	0	700	700	2023-02-01
907	2021	0	700	700	2023-02-01
907	2022	0	700	700	2023-02-01
907	2023	0	700	700	2023-12-18
908	2020	0	3300	3300	2023-02-01
908	2021	0	3300	3300	2023-02-01
908	2022	0	3300	3300	2023-02-01
908	2023	0	3300	3300	2023-12-18
909	2020	1308200	483300	1791500	2023-02-01
909	2021	1264700	637700	1902400	2023-02-01
909	2022	1264700	637700	1902400	2023-02-01
909	2023	1264700	637200	1901900	2023-12-18
91	2020	548900	191900	740800	2023-02-01
91	2021	526300	277000	803300	2023-02-01
91	2022	526300	277000	803300	2023-02-01
91	2023	526300	277000	803300	2023-12-18
910	2020	411800	244200	656000	2023-02-01
910	2021	487700	250900	738600	2023-02-01
910	2022	487700	250900	738600	2023-02-01
910	2023	487700	250900	738600	2023-12-18
911	2020	382300	310000	692300	2023-02-01
911	2021	420600	317400	738000	2023-02-01
911	2022	420600	317400	738000	2023-02-01
911	2023	420600	317400	738000	2023-12-18
912	2020	0	3700	3700	2023-02-01
912	2021	0	3700	3700	2023-02-01
912	2022	0	3700	3700	2023-02-01
912	2023	0	3700	3700	2023-12-18
913	2020	26500	100800	127300	2023-02-01
913	2021	25900	149300	175200	2023-02-01
913	2022	25900	149300	175200	2023-02-01
913	2023	277400	149300	426700	2023-12-18
915	2020	134200	110300	244500	2023-02-01
915	2021	133700	155800	289500	2023-02-01
915	2022	133700	155800	289500	2023-02-01
915	2023	133700	155800	289500	2023-12-18
916	2020	143400	141200	284600	2023-02-01
916	2021	171000	178500	349500	2023-02-01
916	2022	171000	178500	349500	2023-02-01
916	2023	171000	178500	349500	2023-12-18
917	2020	249900	163200	413100	2023-02-01
917	2021	250500	235300	485800	2023-02-01
917	2022	250500	235300	485800	2023-02-01
917	2023	250500	235300	485800	2023-12-18
92	2020	63100	149400	212500	2023-02-01
92	2021	77800	179500	257300	2023-02-01
92	2022	77800	179500	257300	2023-02-01
92	2023	77800	179500	257300	2023-12-18
920	2020	360500	215300	575800	2023-02-01
920	2021	399600	269300	668900	2023-02-01
920	2022	403900	269300	673200	2023-02-01
920	2023	441800	269200	711000	2023-12-18
921	2020	267600	128800	396400	2023-02-01
921	2021	302400	205200	507600	2023-02-01
921	2022	302400	205200	507600	2023-02-01
921	2023	302400	205200	507600	2023-12-18
923	2020	26300	128300	154600	2023-02-01
923	2021	29900	171500	201400	2023-02-01
923	2022	29900	171500	201400	2023-02-01
923	2023	29900	171500	201400	2023-12-18
924	2020	0	6500	6500	2023-02-01
924	2021	0	6500	6500	2023-02-01
924	2022	0	6500	6500	2023-02-01
924	2023	0	3700	3700	2023-12-18
925	2020	0	400	400	2023-02-01
925	2021	0	400	400	2023-02-01
925	2022	0	400	400	2023-02-01
925	2023	0	400	400	2023-12-18
93	2020	298700	188200	486900	2023-02-01
93	2021	475800	204300	680100	2023-02-01
93	2022	548900	204300	753200	2023-02-01
93	2023	548900	204300	753200	2023-12-18
934	2020	0	1200	1200	2023-02-01
934	2021	0	1200	1200	2023-02-01
934	2022	0	1200	1200	2023-02-01
934	2023	0	1200	1200	2023-12-18
935	2020	412900	232400	645300	2023-02-01
935	2021	458600	263000	721600	2023-02-01
935	2022	458600	263000	721600	2023-02-01
935	2023	458600	263000	721600	2023-12-18
939	2020	518000	293400	811400	2023-02-01
939	2021	596300	245000	841300	2023-02-01
939	2022	596300	245000	841300	2023-02-01
939	2023	596300	244800	841100	2023-12-18
94	2020	266600	178700	445300	2023-02-01
94	2021	385500	179200	564700	2023-02-01
94	2022	385500	179200	564700	2023-02-01
94	2023	385500	179200	564700	2023-12-18
940	2020	406400	159900	566300	2023-02-01
940	2021	432600	152100	584700	2023-02-01
940	2022	432600	152100	584700	2023-02-01
940	2023	442600	152100	594700	2023-12-18
941	2020	361200	163000	524200	2023-02-01
941	2021	397900	168600	566500	2023-02-01
941	2022	397900	168600	566500	2023-02-01
941	2023	397900	168600	566500	2023-12-18
942	2020	377500	222300	599800	2023-02-01
942	2021	402700	227300	630000	2023-02-01
942	2022	402700	227300	630000	2023-02-01
942	2023	402700	227300	630000	2023-12-18
943	2020	301800	186200	488000	2023-02-01
943	2021	324200	261900	586100	2023-02-01
943	2022	324200	261900	586100	2023-02-01
943	2023	324200	261900	586100	2023-12-18
944	2020	309200	227700	536900	2023-02-01
944	2021	393600	258300	651900	2023-02-01
944	2022	331800	216000	547800	2023-02-01
944	2023	331800	216000	547800	2023-12-18
947	2020	311900	93500	405400	2023-02-01
947	2021	334800	143600	478400	2023-02-01
947	2022	334800	143600	478400	2023-02-01
947	2023	334800	143600	478400	2023-12-18
949	2020	349600	201000	550600	2023-02-01
949	2021	383600	201100	584700	2023-02-01
949	2022	423400	201100	624500	2023-02-01
949	2023	425800	200600	626400	2023-12-18
95	2020	287100	189100	476200	2023-02-01
95	2021	410100	207600	617700	2023-02-01
95	2022	410100	207600	617700	2023-02-01
95	2023	410100	207600	617700	2023-12-18
951	2020	181500	74700	256200	2023-02-01
951	2021	161600	106600	268200	2023-02-01
951	2022	161600	106600	268200	2023-02-01
951	2023	161600	106600	268200	2023-12-18
952	2020	94600	97000	191600	2023-02-01
952	2021	134400	133800	268200	2023-02-01
952	2022	122200	125500	247700	2023-02-01
952	2023	122200	125500	247700	2023-12-18
953	2020	196900	129800	326700	2023-02-01
953	2021	183800	126300	310100	2023-02-01
953	2022	183800	126300	310100	2023-02-01
953	2023	183800	126300	310100	2023-12-18
954	2020	128500	135400	263900	2023-02-01
954	2021	134700	156100	290800	2023-02-01
954	2022	134700	156100	290800	2023-02-01
954	2023	134700	156100	290800	2023-12-18
955	2020	78700	94100	172800	2023-02-01
955	2021	91100	124900	216000	2023-02-01
955	2022	91100	124900	216000	2023-02-01
955	2023	91100	124900	216000	2023-12-18
958	2020	254000	114300	368300	2023-02-01
958	2021	311600	108600	420200	2023-02-01
958	2022	311600	108600	420200	2023-02-01
958	2023	311600	108600	420200	2023-12-18
959	2020	201500	106300	307800	2023-02-01
959	2021	229100	112600	341700	2023-02-01
959	2022	229100	112600	341700	2023-02-01
959	2023	229100	112600	341700	2023-12-18
960	2020	196300	111100	307400	2023-02-01
960	2021	209600	115100	324700	2023-02-01
960	2022	209600	115100	324700	2023-02-01
960	2023	209600	115100	324700	2023-12-18
961	2020	349400	201300	550700	2023-02-01
961	2021	383800	243800	627600	2023-02-01
961	2022	383800	243800	627600	2023-02-01
961	2023	383800	243800	627600	2023-12-18
962	2020	311100	118200	429300	2023-02-01
962	2021	371900	112400	484300	2023-02-01
962	2022	371900	112400	484300	2023-02-01
962	2023	371900	112400	484300	2023-12-18
963	2020	261400	167800	429200	2023-02-01
963	2021	245600	239300	484900	2023-02-01
963	2022	245600	239300	484900	2023-02-01
963	2023	245600	239300	484900	2023-12-18
964	2020	79100	153500	232600	2023-02-01
964	2021	0	211200	211200	2023-02-01
964	2022	0	211200	211200	2023-02-01
964	2023	0	211200	211200	2023-12-18
965	2020	459700	188600	648300	2023-02-01
965	2021	524400	231100	755500	2023-02-01
965	2022	528500	231100	759600	2023-02-01
965	2023	528500	231100	759600	2023-12-18
966	2020	330800	144000	474800	2023-02-01
966	2021	376200	166000	542200	2023-02-01
966	2022	376200	166000	542200	2023-02-01
966	2023	376200	166000	542200	2023-12-18
967	2020	438500	152000	590500	2023-02-01
967	2021	467700	172900	640600	2023-02-01
967	2022	467700	172900	640600	2023-02-01
967	2023	467700	172900	640600	2023-12-18
968	2020	168400	126100	294500	2023-02-01
968	2021	207300	162600	369900	2023-02-01
968	2022	215000	162500	377500	2023-02-01
968	2023	234500	162300	396800	2023-12-18
969	2020	118900	103800	222700	2023-02-01
969	2021	143300	156100	299400	2023-02-01
969	2022	143300	156100	299400	2023-02-01
969	2023	143300	156100	299400	2023-12-18
971	2020	191500	136900	328400	2023-02-01
971	2021	207900	172600	380500	2023-02-01
971	2022	207900	172600	380500	2023-02-01
971	2023	207900	172600	380500	2023-12-18
972	2020	0	1600	1600	2023-02-01
972	2021	0	1600	1600	2023-02-01
972	2022	0	1600	1600	2023-02-01
972	2023	0	1500	1500	2023-12-18
973	2020	246700	116700	363400	2023-02-01
973	2021	245500	151600	397100	2023-02-01
973	2022	253200	151600	404800	2023-02-01
973	2023	253200	151600	404800	2023-12-18
974	2020	395700	183300	579000	2023-02-01
974	2021	463100	181400	644500	2023-02-01
974	2022	463100	181400	644500	2023-02-01
974	2023	466700	181400	648100	2023-12-18
975	2020	0	900	900	2023-02-01
975	2021	0	900	900	2023-02-01
975	2022	0	900	900	2023-02-01
975	2023	0	800	800	2023-12-18
976	2020	198300	167700	366000	2023-02-01
976	2021	262700	211800	474500	2023-02-01
976	2022	261400	211800	473200	2023-02-01
976	2023	261400	211800	473200	2023-12-18
977	2020	565300	152800	718100	2023-02-01
977	2021	584200	192500	776700	2023-02-01
977	2022	584200	192500	776700	2023-02-01
977	2023	603500	192500	796000	2023-12-18
978	2020	22400	101900	124300	2023-02-01
978	2021	26100	134100	160200	2023-02-01
978	2022	26100	134100	160200	2023-02-01
978	2023	26100	134100	160200	2023-12-18
979	2020	87600	98700	186300	2023-02-01
979	2021	94700	130300	225000	2023-02-01
979	2022	94700	130300	225000	2023-02-01
979	2023	94700	130300	225000	2023-12-18
981	2020	226600	97500	324100	2023-02-01
981	2021	270900	128900	399800	2023-02-01
981	2022	270900	128900	399800	2023-02-01
981	2023	270900	128900	399800	2023-12-18
982	2020	72500	104800	177300	2023-02-01
982	2021	112400	137000	249400	2023-02-01
982	2022	112400	137000	249400	2023-02-01
982	2023	112400	137000	249400	2023-12-18
983	2020	4600	106700	111300	2023-02-01
983	2021	12100	137300	149400	2023-02-01
983	2022	12100	137300	149400	2023-02-01
983	2023	12100	137300	149400	2023-12-18
984	2020	78500	90100	168600	2023-02-01
984	2021	90800	118300	209100	2023-02-01
984	2022	90800	118300	209100	2023-02-01
984	2023	90800	118300	209100	2023-12-18
986	2020	122600	96500	219100	2023-02-01
986	2021	107000	139600	246600	2023-02-01
986	2022	107000	139600	246600	2023-02-01
986	2023	107000	139600	246600	2023-12-18
987	2020	231400	117700	349100	2023-02-01
987	2021	258800	164100	422900	2023-02-01
987	2022	258800	164100	422900	2023-02-01
987	2023	258800	163600	422400	2023-12-18
99	2020	308800	0	308800	2023-02-01
99	2021	328500	0	328500	2023-02-01
99	2022	328500	0	328500	2023-02-01
99	2023	328500	0	328500	2023-12-18
990	2020	3800	1100	4900	2023-02-01
990	2021	4100	1100	5200	2023-02-01
990	2022	4100	1100	5200	2023-02-01
990	2023	4100	1100	5200	2023-12-18
991	2020	73200	99300	172500	2023-02-01
991	2021	77800	131000	208800	2023-02-01
991	2022	77800	131000	208800	2023-02-01
991	2023	77800	131000	208800	2023-12-18
992	2020	0	13500	13500	2023-02-01
992	2021	0	13500	13500	2023-02-01
992	2022	0	13500	13500	2023-02-01
992	2023	0	12800	12800	2023-12-18
993	2020	194900	99100	294000	2023-02-01
993	2021	210700	135900	346600	2023-02-01
993	2022	226300	135900	362200	2023-02-01
993	2023	226300	135900	362200	2023-12-18
994	2020	121500	122900	244400	2023-02-01
994	2021	145200	171100	316300	2023-02-01
994	2022	145200	171100	316300	2023-02-01
994	2023	145200	171100	316300	2023-12-18
995	2020	111000	49900	160900	2023-02-01
995	2021	165900	89400	255300	2023-02-01
995	2022	165900	84200	250100	2023-02-01
995	2023	165900	84200	250100	2023-12-18
996	2020	310800	163900	474700	2023-02-01
996	2021	336100	186700	522800	2023-02-01
996	2022	336100	186700	522800	2023-02-01
996	2023	336100	186700	522800	2023-12-18
997	2020	208500	141500	350000	2023-02-01
997	2021	212500	160700	373200	2023-02-01
997	2022	212500	160700	373200	2023-02-01
997	2023	212500	160700	373200	2023-12-18
998	2020	435600	162900	598500	2023-02-01
998	2021	442600	212200	654800	2023-02-01
998	2022	442600	212200	654800	2023-02-01
998	2023	442600	212100	654700	2023-12-18
PID	Ass. Year	Improvements	Land	Total	CollectedOn
