PID	Ass. Year	Improvements	Land	Total	CollectedOn
1	2025	0	0	0	2024-12-03
1	2023	0	0	0	2024-12-03
1	2022	1254000	0	1254000	2024-12-03
2	2025	2246700	0	2246700	2024-12-03
2	2023	2705300	0	2705300	2024-12-03
2	2022	3294400	0	3294400	2024-12-03
3	2025	1601800	0	1601800	2024-12-03
3	2023	2007300	0	2007300	2024-12-03
3	2022	2353000	0	2353000	2024-12-03
4	2025	10300	0	10300	2024-12-03
4	2023	12600	0	12600	2024-12-03
4	2022	12600	0	12600	2024-12-03
5	2025	93700	167600	261300	2024-12-03
5	2023	93700	167600	261300	2024-12-03
5	2022	93700	167600	261300	2024-12-03
7	2025	77200	104600	181800	2024-12-03
7	2023	77200	104600	181800	2024-12-03
7	2022	77200	104600	181800	2024-12-03
8	2025	114000	140400	254400	2024-12-03
8	2023	114000	140400	254400	2024-12-03
8	2022	114000	140400	254400	2024-12-03
9	2025	112100	157900	270000	2024-12-03
9	2023	112100	157900	270000	2024-12-03
9	2022	112100	157900	270000	2024-12-03
10	2025	254100	163000	417100	2024-12-03
10	2023	254100	163000	417100	2024-12-03
10	2022	254100	163000	417100	2024-12-03
12	2025	261800	225200	487000	2024-12-03
12	2023	261800	225200	487000	2024-12-03
12	2022	261800	225200	487000	2024-12-03
13	2025	275700	280700	556400	2024-12-03
13	2023	275700	280700	556400	2024-12-03
13	2022	275700	280700	556400	2024-12-03
16	2025	1016100	385700	1401800	2024-12-03
16	2023	1016100	385700	1401800	2024-12-03
16	2022	1016100	385700	1401800	2024-12-03
18	2025	201700	136700	338400	2024-12-03
18	2023	194000	122600	316600	2024-12-03
18	2022	194000	139100	333100	2024-12-03
19	2025	125000	95400	220400	2024-12-03
19	2023	125000	106300	231300	2024-12-03
19	2022	125000	62300	187300	2024-12-03
20	2025	386900	234400	621300	2024-12-03
20	2023	381400	234400	615800	2024-12-03
20	2022	381400	234400	615800	2024-12-03
21	2025	398100	288400	686500	2024-12-03
21	2023	398100	288400	686500	2024-12-03
21	2022	398100	288400	686500	2024-12-03
22	2025	269300	179700	449000	2024-12-03
22	2023	269300	179700	449000	2024-12-03
22	2022	269300	179700	449000	2024-12-03
23	2025	239600	243000	482600	2024-12-03
23	2023	233100	245600	478700	2024-12-03
23	2022	233100	245600	478700	2024-12-03
25	2025	392500	170500	563000	2024-12-03
25	2023	392500	170500	563000	2024-12-03
25	2022	378700	170500	549200	2024-12-03
26	2025	144700	205300	350000	2024-12-03
26	2023	144700	205300	350000	2024-12-03
26	2022	144700	205300	350000	2024-12-03
27	2025	386800	210000	596800	2024-12-03
27	2023	327100	210000	537100	2024-12-03
27	2022	327100	210000	537100	2024-12-03
28	2025	322000	244000	566000	2024-12-03
28	2023	302000	244000	546000	2024-12-03
28	2022	298800	244000	542800	2024-12-03
29	2025	420400	235700	656100	2024-12-03
29	2023	420400	235700	656100	2024-12-03
29	2022	420400	235700	656100	2024-12-03
30	2025	275300	218200	493500	2024-12-03
30	2023	275300	218200	493500	2024-12-03
30	2022	275300	218200	493500	2024-12-03
32	2025	136200	146800	283000	2024-12-03
32	2023	136200	146800	283000	2024-12-03
32	2022	131000	146800	277800	2024-12-03
33	2025	176400	151600	328000	2024-12-03
33	2023	176400	151600	328000	2024-12-03
33	2022	176400	151600	328000	2024-12-03
34	2025	395200	157700	552900	2024-12-03
34	2023	395200	157700	552900	2024-12-03
34	2022	395200	157700	552900	2024-12-03
35	2025	0	29200	29200	2024-12-03
35	2023	0	29200	29200	2024-12-03
35	2022	0	29200	29200	2024-12-03
36	2025	415200	416200	831400	2024-12-03
36	2023	377800	416200	794000	2024-12-03
36	2022	303000	416200	719200	2024-12-03
37	2025	297500	353000	650500	2024-12-03
37	2023	297500	353000	650500	2024-12-03
37	2022	297500	353000	650500	2024-12-03
40	2025	0	43000	43000	2024-12-03
40	2023	0	43000	43000	2024-12-03
40	2022	0	43000	43000	2024-12-03
41	2025	447000	186000	633000	2024-12-03
41	2023	447000	186000	633000	2024-12-03
41	2022	447000	186000	633000	2024-12-03
42	2025	269800	218700	488500	2024-12-03
42	2023	269800	218700	488500	2024-12-03
42	2022	269800	218700	488500	2024-12-03
43	2025	137300	208300	345600	2024-12-03
43	2023	137300	208300	345600	2024-12-03
43	2022	137300	208300	345600	2024-12-03
50	2025	194300	0	194300	2024-12-03
50	2023	194300	0	194300	2024-12-03
50	2022	194300	0	194300	2024-12-03
51	2025	197400	0	197400	2024-12-03
51	2023	197400	0	197400	2024-12-03
51	2022	197400	0	197400	2024-12-03
52	2025	184100	0	184100	2024-12-03
52	2023	184100	0	184100	2024-12-03
52	2022	184100	0	184100	2024-12-03
53	2025	208500	0	208500	2024-12-03
53	2023	208500	0	208500	2024-12-03
53	2022	208500	0	208500	2024-12-03
54	2025	179900	0	179900	2024-12-03
54	2023	179900	0	179900	2024-12-03
54	2022	179900	0	179900	2024-12-03
55	2025	195600	0	195600	2024-12-03
55	2023	195600	0	195600	2024-12-03
55	2022	195600	0	195600	2024-12-03
56	2025	545500	234500	780000	2024-12-03
56	2023	1025200	234500	1259700	2024-12-03
56	2022	976100	234500	1210600	2024-12-03
57	2025	734700	230000	964700	2024-12-03
57	2023	734700	230000	964700	2024-12-03
57	2022	734700	230000	964700	2024-12-03
58	2025	653600	262000	915600	2024-12-03
58	2023	653600	262000	915600	2024-12-03
58	2022	653600	262000	915600	2024-12-03
59	2025	355300	156500	511800	2024-12-03
59	2023	355300	156500	511800	2024-12-03
59	2022	355300	156500	511800	2024-12-03
60	2025	485100	218900	704000	2024-12-03
60	2023	485100	218900	704000	2024-12-03
60	2022	485100	218900	704000	2024-12-03
62	2025	515100	163900	679000	2024-12-03
62	2023	515100	163900	679000	2024-12-03
62	2022	498400	163900	662300	2024-12-03
63	2025	258400	232100	490500	2024-12-03
63	2023	258400	232100	490500	2024-12-03
63	2022	258400	232100	490500	2024-12-03
64	2025	103900	218200	322100	2024-12-03
64	2023	103900	218200	322100	2024-12-03
64	2022	103900	218200	322100	2024-12-03
65	2025	493400	228900	722300	2024-12-03
65	2023	482500	228900	711400	2024-12-03
65	2022	436100	228900	665000	2024-12-03
66	2025	235300	230900	466200	2024-12-03
66	2023	218800	230900	449700	2024-12-03
66	2022	218800	230900	449700	2024-12-03
67	2025	0	103200	103200	2024-12-03
67	2023	0	103200	103200	2024-12-03
67	2022	0	103200	103200	2024-12-03
68	2025	127000	157100	284100	2024-12-03
68	2023	127000	157100	284100	2024-12-03
68	2022	127000	157100	284100	2024-12-03
69	2025	0	8600	8600	2024-12-03
69	2023	0	8600	8600	2024-12-03
69	2022	0	8600	8600	2024-12-03
76	2025	568500	234400	802900	2024-12-03
76	2023	519800	234400	754200	2024-12-03
76	2022	519800	234400	754200	2024-12-03
77	2025	343500	234900	578400	2024-12-03
77	2023	343500	234900	578400	2024-12-03
77	2022	343500	234900	578400	2024-12-03
78	2025	173800	216500	390300	2024-12-03
78	2023	173800	216500	390300	2024-12-03
78	2022	173800	216500	390300	2024-12-03
79	2025	116800	216500	333300	2024-12-03
79	2023	116800	216500	333300	2024-12-03
79	2022	116800	216500	333300	2024-12-03
80	2025	352100	317200	669300	2024-12-03
80	2023	301600	317200	618800	2024-12-03
80	2022	301600	317200	618800	2024-12-03
81	2025	92200	233300	325500	2024-12-03
81	2023	92200	233300	325500	2024-12-03
81	2022	92200	233300	325500	2024-12-03
82	2025	217700	199300	417000	2024-12-03
82	2023	217700	199300	417000	2024-12-03
82	2022	217700	199300	417000	2024-12-03
83	2025	190300	161800	352100	2024-12-03
83	2023	190300	161800	352100	2024-12-03
83	2022	190300	161800	352100	2024-12-03
84	2025	3187200	2000100	5187300	2024-12-03
84	2023	3187200	2000100	5187300	2024-12-03
84	2022	3187200	2000100	5187300	2024-12-03
85	2025	0	16900	16900	2024-12-03
85	2023	0	16900	16900	2024-12-03
85	2022	0	16900	16900	2024-12-03
86	2025	471700	228900	700600	2024-12-03
86	2023	471700	228900	700600	2024-12-03
86	2022	471700	228900	700600	2024-12-03
87	2025	379700	256000	635700	2024-12-03
87	2023	379700	256000	635700	2024-12-03
87	2022	379700	256000	635700	2024-12-03
88	2025	43200	113400	156600	2024-12-03
88	2023	43200	113400	156600	2024-12-03
88	2022	43200	113400	156600	2024-12-03
89	2025	269500	238500	508000	2024-12-03
89	2023	269500	238900	508400	2024-12-03
89	2022	252300	239000	491300	2024-12-03
91	2025	526300	277000	803300	2024-12-03
91	2023	526300	277000	803300	2024-12-03
91	2022	526300	277000	803300	2024-12-03
92	2025	77800	179500	257300	2024-12-03
92	2023	77800	179500	257300	2024-12-03
92	2022	77800	179500	257300	2024-12-03
93	2025	548900	204300	753200	2024-12-03
93	2023	548900	204300	753200	2024-12-03
93	2022	548900	204300	753200	2024-12-03
94	2025	385500	179200	564700	2024-12-03
94	2023	385500	179200	564700	2024-12-03
94	2022	385500	179200	564700	2024-12-03
95	2025	410100	207600	617700	2024-12-03
95	2023	410100	207600	617700	2024-12-03
95	2022	410100	207600	617700	2024-12-03
99	2025	328500	0	328500	2024-12-03
99	2023	328500	0	328500	2024-12-03
99	2022	328500	0	328500	2024-12-03
101	2025	543900	0	543900	2024-12-03
101	2023	543900	0	543900	2024-12-03
101	2022	543900	0	543900	2024-12-03
102	2025	7500	104000	111500	2024-12-03
102	2023	7500	104000	111500	2024-12-03
102	2022	7500	104000	111500	2024-12-03
103	2025	121800	185100	306900	2024-12-03
103	2023	121800	185100	306900	2024-12-03
103	2022	121800	185100	306900	2024-12-03
104	2025	1055000	394300	1449300	2024-12-03
104	2023	1055000	394300	1449300	2024-12-03
104	2022	1055000	394300	1449300	2024-12-03
105	2025	236100	274300	510400	2024-12-03
105	2023	236100	274300	510400	2024-12-03
105	2022	236100	274300	510400	2024-12-03
106	2025	1421000	488300	1909300	2024-12-03
106	2023	1421000	488300	1909300	2024-12-03
106	2022	1421000	488300	1909300	2024-12-03
107	2025	359500	263700	623200	2024-12-03
107	2023	359500	263700	623200	2024-12-03
107	2022	359500	263700	623200	2024-12-03
111	2025	4400	424700	429100	2024-12-03
111	2023	4400	424700	429100	2024-12-03
111	2022	4400	424700	429100	2024-12-03
115	2025	148600	123500	272100	2024-12-03
115	2023	89200	123500	212700	2024-12-03
115	2022	51000	123500	174500	2024-12-03
116	2025	249500	148200	397700	2024-12-03
116	2023	249500	148200	397700	2024-12-03
116	2022	249500	148200	397700	2024-12-03
117	2025	435400	0	435400	2024-12-03
117	2023	435400	0	435400	2024-12-03
117	2022	426300	0	426300	2024-12-03
118	2025	155800	405100	560900	2024-12-03
118	2023	155800	405100	560900	2024-12-03
118	2022	155800	405100	560900	2024-12-03
120	2025	462100	360800	822900	2024-12-03
120	2023	462100	360800	822900	2024-12-03
120	2022	462100	360800	822900	2024-12-03
121	2025	187800	143700	331500	2024-12-03
121	2023	124500	143700	268200	2024-12-03
121	2022	2900	143700	146600	2024-12-03
122	2025	273000	133300	406300	2024-12-03
122	2023	273000	133300	406300	2024-12-03
122	2022	273000	133300	406300	2024-12-03
123	2025	151900	132200	284100	2024-12-03
123	2023	151900	132200	284100	2024-12-03
123	2022	151900	132200	284100	2024-12-03
124	2025	354900	223000	577900	2024-12-03
124	2023	354900	223000	577900	2024-12-03
124	2022	354900	223000	577900	2024-12-03
125	2025	272000	155700	427700	2024-12-03
125	2023	272000	155700	427700	2024-12-03
125	2022	272000	155700	427700	2024-12-03
127	2025	240200	153300	393500	2024-12-03
127	2023	240200	153300	393500	2024-12-03
127	2022	240200	153300	393500	2024-12-03
128	2025	395000	188500	583500	2024-12-03
128	2023	395000	188500	583500	2024-12-03
128	2022	395000	188500	583500	2024-12-03
129	2025	182300	157500	339800	2024-12-03
129	2023	182300	157500	339800	2024-12-03
129	2022	182300	157500	339800	2024-12-03
132	2025	0	40300	40300	2024-12-03
132	2023	0	40300	40300	2024-12-03
132	2022	0	40300	40300	2024-12-03
133	2025	42000	0	42000	2024-12-03
133	2023	42000	0	42000	2024-12-03
133	2022	42000	0	42000	2024-12-03
136	2025	15200	12200	27400	2024-12-03
136	2023	15200	12200	27400	2024-12-03
136	2022	15200	12200	27400	2024-12-03
137	2025	46900	189400	236300	2024-12-03
137	2023	46900	189400	236300	2024-12-03
137	2022	46900	189400	236300	2024-12-03
138	2025	1194500	246000	1440500	2024-12-03
138	2023	1194500	246000	1440500	2024-12-03
138	2022	1194500	246000	1440500	2024-12-03
139	2025	84900	166400	251300	2024-12-03
139	2023	81400	166400	247800	2024-12-03
139	2022	81400	166400	247800	2024-12-03
140	2025	595300	151500	746800	2024-12-03
140	2023	595300	151500	746800	2024-12-03
140	2022	575300	151500	726800	2024-12-03
142	2025	183800	209900	393700	2024-12-03
142	2023	183800	209900	393700	2024-12-03
142	2022	183800	209900	393700	2024-12-03
143	2025	334100	206900	541000	2024-12-03
143	2023	334100	206900	541000	2024-12-03
143	2022	334100	206900	541000	2024-12-03
144	2025	143600	133000	276600	2024-12-03
144	2023	145200	133000	278200	2024-12-03
144	2022	145200	133000	278200	2024-12-03
148	2025	163800	142700	306500	2024-12-03
148	2023	163800	142700	306500	2024-12-03
148	2022	163800	142700	306500	2024-12-03
149	2025	385600	171200	556800	2024-12-03
149	2023	385600	171200	556800	2024-12-03
149	2022	385600	171200	556800	2024-12-03
150	2025	402500	170200	572700	2024-12-03
150	2023	402500	170200	572700	2024-12-03
150	2022	410700	170200	580900	2024-12-03
151	2025	0	218500	218500	2024-12-03
151	2023	0	218500	218500	2024-12-03
151	2022	0	218500	218500	2024-12-03
152	2025	176000	84800	260800	2024-12-03
152	2023	176000	84800	260800	2024-12-03
152	2022	176000	84800	260800	2024-12-03
153	2025	149400	111300	260700	2024-12-03
153	2023	149400	111300	260700	2024-12-03
153	2022	149400	111300	260700	2024-12-03
154	2025	82500	82400	164900	2024-12-03
154	2023	82500	82400	164900	2024-12-03
154	2022	82500	82400	164900	2024-12-03
159	2025	23700	166100	189800	2024-12-03
159	2023	23700	166100	189800	2024-12-03
159	2022	21200	166100	187300	2024-12-03
161	2025	562100	219600	781700	2024-12-03
161	2023	562100	219600	781700	2024-12-03
161	2022	562100	219600	781700	2024-12-03
162	2025	172300	126800	299100	2024-12-03
162	2023	172300	126800	299100	2024-12-03
162	2022	165400	126800	292200	2024-12-03
163	2025	269600	158900	428500	2024-12-03
163	2023	269600	158900	428500	2024-12-03
163	2022	269600	158900	428500	2024-12-03
164	2025	46200	98300	144500	2024-12-03
164	2023	46200	98300	144500	2024-12-03
164	2022	46200	98300	144500	2024-12-03
167	2025	289300	224000	513300	2024-12-03
167	2023	289300	224000	513300	2024-12-03
167	2022	289300	224000	513300	2024-12-03
168	2025	174500	129600	304100	2024-12-03
168	2023	174500	129600	304100	2024-12-03
168	2022	174500	129600	304100	2024-12-03
169	2025	154200	111100	265300	2024-12-03
169	2023	154200	111100	265300	2024-12-03
169	2022	154200	111100	265300	2024-12-03
170	2025	1225500	266800	1492300	2024-12-03
170	2023	1225500	266800	1492300	2024-12-03
170	2022	1225500	266800	1492300	2024-12-03
171	2025	0	200	200	2024-12-03
171	2023	0	200	200	2024-12-03
171	2022	0	200	200	2024-12-03
172	2025	230600	177800	408400	2024-12-03
172	2023	0	300	300	2024-12-03
172	2022	0	300	300	2024-12-03
173	2025	465200	146600	611800	2024-12-03
173	2023	465200	146600	611800	2024-12-03
173	2022	465200	146600	611800	2024-12-03
174	2025	152300	132200	284500	2024-12-03
174	2023	152300	132200	284500	2024-12-03
174	2022	152300	132200	284500	2024-12-03
176	2025	156600	137900	294500	2024-12-03
176	2023	156600	137900	294500	2024-12-03
176	2022	156600	137900	294500	2024-12-03
177	2025	87900	129800	217700	2024-12-03
177	2023	81400	129800	211200	2024-12-03
177	2022	81400	129800	211200	2024-12-03
178	2025	231800	126600	358400	2024-12-03
178	2023	231800	126600	358400	2024-12-03
178	2022	231800	126600	358400	2024-12-03
179	2025	149400	138100	287500	2024-12-03
179	2023	149400	138100	287500	2024-12-03
179	2022	149400	138100	287500	2024-12-03
180	2025	597800	214100	811900	2024-12-03
180	2023	597800	214300	812100	2024-12-03
180	2022	597800	214300	812100	2024-12-03
181	2025	0	2400	2400	2024-12-03
181	2023	0	2500	2500	2024-12-03
181	2022	0	2500	2500	2024-12-03
182	2025	546700	177800	724500	2024-12-03
182	2023	546700	178200	724900	2024-12-03
182	2022	507900	178200	686100	2024-12-03
183	2025	282900	103000	385900	2024-12-03
183	2023	282900	103000	385900	2024-12-03
183	2022	282900	103000	385900	2024-12-03
187	2025	314000	170600	484600	2024-12-03
187	2023	314000	170800	484800	2024-12-03
187	2022	314000	170900	484900	2024-12-03
188	2025	641500	259900	901400	2024-12-03
188	2023	613900	260000	873900	2024-12-03
188	2022	613900	260000	873900	2024-12-03
189	2025	8500	43400	51900	2024-12-03
189	2023	8500	44800	53300	2024-12-03
189	2022	8500	44800	53300	2024-12-03
190	2025	0	800	800	2024-12-03
190	2023	0	1000	1000	2024-12-03
190	2022	0	1000	1000	2024-12-03
191	2025	0	5000	5000	2024-12-03
191	2023	0	5700	5700	2024-12-03
191	2022	0	6000	6000	2024-12-03
192	2025	0	17900	17900	2024-12-03
192	2023	0	24100	24100	2024-12-03
192	2022	0	25500	25500	2024-12-03
194	2025	0	100	100	2024-12-03
194	2023	0	100	100	2024-12-03
194	2022	0	100	100	2024-12-03
195	2025	343500	176200	519700	2024-12-03
195	2023	343500	176200	519700	2024-12-03
195	2022	343500	176200	519700	2024-12-03
197	2025	0	2300	2300	2024-12-03
197	2023	0	2600	2600	2024-12-03
197	2022	0	2500	2500	2024-12-03
201	2025	322700	134200	456900	2024-12-03
201	2023	322700	134700	457400	2024-12-03
201	2022	322700	134800	457500	2024-12-03
202	2025	420600	291100	711700	2024-12-03
202	2023	420600	292700	713300	2024-12-03
202	2022	418600	293300	711900	2024-12-03
203	2025	232400	125100	357500	2024-12-03
203	2023	232400	125100	357500	2024-12-03
203	2022	232400	125100	357500	2024-12-03
204	2025	396000	322800	718800	2024-12-03
204	2023	396000	324500	720500	2024-12-03
204	2022	396000	324800	720800	2024-12-03
206	2025	606800	135500	742300	2024-12-03
206	2023	606800	135700	742500	2024-12-03
206	2022	606800	135800	742600	2024-12-03
207	2025	1700	51500	53200	2024-12-03
207	2023	1700	52300	54000	2024-12-03
207	2022	1700	52700	54400	2024-12-03
208	2025	136600	142400	279000	2024-12-03
208	2023	136600	142400	279000	2024-12-03
208	2022	180600	142400	323000	2024-12-03
209	2025	124500	143300	267800	2024-12-03
209	2023	124500	143300	267800	2024-12-03
209	2022	124500	143300	267800	2024-12-03
210	2025	193800	143300	337100	2024-12-03
210	2023	193800	143300	337100	2024-12-03
210	2022	193800	143300	337100	2024-12-03
217	2025	0	1700	1700	2024-12-03
217	2023	0	2500	2500	2024-12-03
217	2022	0	2600	2600	2024-12-03
219	2025	176100	164500	340600	2024-12-03
219	2023	176100	164500	340600	2024-12-03
219	2022	176100	164500	340600	2024-12-03
220	2025	180400	108100	288500	2024-12-03
220	2023	180400	108100	288500	2024-12-03
220	2022	180400	108100	288500	2024-12-03
221	2025	221900	95600	317500	2024-12-03
221	2023	221900	95600	317500	2024-12-03
221	2022	221900	95600	317500	2024-12-03
222	2025	269100	168700	437800	2024-12-03
222	2023	269100	168700	437800	2024-12-03
222	2022	269100	168700	437800	2024-12-03
223	2025	346400	125800	472200	2024-12-03
223	2023	334100	125900	460000	2024-12-03
223	2022	334100	125900	460000	2024-12-03
224	2025	234300	215300	449600	2024-12-03
224	2023	234300	215300	449600	2024-12-03
224	2022	234300	215300	449600	2024-12-03
225	2025	69400	176600	246000	2024-12-03
225	2023	86100	176600	262700	2024-12-03
225	2022	86100	176600	262700	2024-12-03
229	2025	344200	179600	523800	2024-12-03
229	2023	312700	179600	492300	2024-12-03
229	2022	312700	179600	492300	2024-12-03
230	2025	0	1800	1800	2024-12-03
230	2023	0	2500	2500	2024-12-03
230	2022	0	2800	2800	2024-12-03
231	2025	0	91300	91300	2024-12-03
231	2023	0	91300	91300	2024-12-03
231	2022	82800	91300	174100	2024-12-03
232	2025	72200	57800	130000	2024-12-03
232	2023	72200	57800	130000	2024-12-03
232	2022	72200	57800	130000	2024-12-03
233	2025	81500	65100	146600	2024-12-03
233	2023	81500	65100	146600	2024-12-03
233	2022	81500	65100	146600	2024-12-03
234	2025	228500	134400	362900	2024-12-03
234	2023	228500	134400	362900	2024-12-03
234	2022	228500	134400	362900	2024-12-03
235	2025	455900	169300	625200	2024-12-03
235	2023	455900	169300	625200	2024-12-03
235	2022	455900	169300	625200	2024-12-03
236	2025	184400	119700	304100	2024-12-03
236	2023	184400	119700	304100	2024-12-03
236	2022	184400	119700	304100	2024-12-03
237	2025	45100	88200	133300	2024-12-03
237	2023	45100	88200	133300	2024-12-03
237	2022	45100	88200	133300	2024-12-03
238	2025	149100	133300	282400	2024-12-03
238	2023	149100	133300	282400	2024-12-03
238	2022	149100	133300	282400	2024-12-03
241	2025	62700	160900	223600	2024-12-03
241	2023	62700	163000	225700	2024-12-03
241	2022	143900	163300	307200	2024-12-03
243	2025	0	900	900	2024-12-03
243	2023	0	900	900	2024-12-03
243	2022	0	900	900	2024-12-03
244	2025	0	800	800	2024-12-03
244	2023	0	800	800	2024-12-03
244	2022	0	800	800	2024-12-03
245	2025	193200	115700	308900	2024-12-03
245	2023	193200	115700	308900	2024-12-03
245	2022	193200	115700	308900	2024-12-03
246	2025	0	6100	6100	2024-12-03
246	2023	0	6100	6100	2024-12-03
246	2022	0	6200	6200	2024-12-03
247	2025	13400	149200	162600	2024-12-03
247	2023	13400	149200	162600	2024-12-03
247	2022	13400	149200	162600	2024-12-03
248	2025	126300	137700	264000	2024-12-03
248	2023	126300	137700	264000	2024-12-03
248	2022	126300	137700	264000	2024-12-03
249	2025	155900	144300	300200	2024-12-03
249	2023	155900	144300	300200	2024-12-03
249	2022	155900	144300	300200	2024-12-03
250	2025	0	2500	2500	2024-12-03
250	2023	0	2700	2700	2024-12-03
250	2022	0	2700	2700	2024-12-03
251	2025	397000	231700	628700	2024-12-03
251	2023	367000	232100	599100	2024-12-03
251	2022	367000	232200	599200	2024-12-03
252	2025	176700	143800	320500	2024-12-03
252	2023	176700	144200	320900	2024-12-03
252	2022	176700	144300	321000	2024-12-03
253	2025	227100	150400	377500	2024-12-03
253	2023	212100	150400	362500	2024-12-03
253	2022	212100	150400	362500	2024-12-03
254	2025	416800	150700	567500	2024-12-03
254	2023	356800	150700	507500	2024-12-03
254	2022	356800	150800	507600	2024-12-03
255	2025	575400	129400	704800	2024-12-03
255	2023	523800	129400	653200	2024-12-03
255	2022	471100	129400	600500	2024-12-03
256	2025	1367900	364300	1732200	2024-12-03
256	2023	1367900	364300	1732200	2024-12-03
256	2022	1367900	364300	1732200	2024-12-03
257	2025	56900	130700	187600	2024-12-03
257	2023	56900	130700	187600	2024-12-03
257	2022	56900	130700	187600	2024-12-03
258	2025	378800	0	378800	2024-12-03
258	2023	378800	0	378800	2024-12-03
258	2022	378800	0	378800	2024-12-03
259	2025	2454700	592700	3047400	2024-12-03
259	2023	2454700	592700	3047400	2024-12-03
259	2022	2454700	592700	3047400	2024-12-03
260	2025	70800	164500	235300	2024-12-03
260	2023	82600	164500	247100	2024-12-03
260	2022	82600	164500	247100	2024-12-03
267	2025	72400	122600	195000	2024-12-03
267	2023	66900	122600	189500	2024-12-03
267	2022	66900	122600	189500	2024-12-03
270	2025	54400	117800	172200	2024-12-03
270	2023	54400	117800	172200	2024-12-03
270	2022	54400	117800	172200	2024-12-03
271	2025	293800	127600	421400	2024-12-03
271	2023	293800	127600	421400	2024-12-03
271	2022	293800	127600	421400	2024-12-03
272	2025	0	11300	11300	2024-12-03
272	2023	0	11300	11300	2024-12-03
272	2022	0	11300	11300	2024-12-03
273	2025	32800	100700	133500	2024-12-03
273	2023	32800	100700	133500	2024-12-03
273	2022	32800	100700	133500	2024-12-03
274	2025	230700	139000	369700	2024-12-03
274	2023	230700	139000	369700	2024-12-03
274	2022	230700	139000	369700	2024-12-03
275	2025	15500	109800	125300	2024-12-03
275	2023	15500	109800	125300	2024-12-03
275	2022	15500	109800	125300	2024-12-03
276	2025	133100	173400	306500	2024-12-03
276	2023	133100	173400	306500	2024-12-03
276	2022	133100	173400	306500	2024-12-03
277	2025	0	1500	1500	2024-12-03
277	2023	0	1500	1500	2024-12-03
277	2022	0	1500	1500	2024-12-03
278	2025	147100	178900	326000	2024-12-03
278	2023	147100	180100	327200	2024-12-03
278	2022	147100	180500	327600	2024-12-03
279	2025	161300	176800	338100	2024-12-03
279	2023	161300	176800	338100	2024-12-03
279	2022	161300	176800	338100	2024-12-03
280	2025	0	7500	7500	2024-12-03
280	2023	0	8200	8200	2024-12-03
280	2022	0	8400	8400	2024-12-03
283	2025	25500	171600	197100	2024-12-03
283	2023	25500	171600	197100	2024-12-03
283	2022	25500	171600	197100	2024-12-03
287	2025	566500	297100	863600	2024-12-03
287	2023	566500	297100	863600	2024-12-03
287	2022	566500	297100	863600	2024-12-03
288	2025	245600	328100	573700	2024-12-03
288	2023	245600	328100	573700	2024-12-03
288	2022	245600	328100	573700	2024-12-03
290	2025	618200	290500	908700	2024-12-03
290	2023	618200	290500	908700	2024-12-03
290	2022	618200	290500	908700	2024-12-03
291	2025	0	6400	6400	2024-12-03
291	2023	0	6400	6400	2024-12-03
291	2022	0	6400	6400	2024-12-03
292	2025	376400	173300	549700	2024-12-03
292	2023	376400	174300	550700	2024-12-03
292	2022	376500	174000	550500	2024-12-03
294	2025	411100	179900	591000	2024-12-03
294	2023	411100	180700	591800	2024-12-03
294	2022	411100	180800	591900	2024-12-03
295	2025	132400	104100	236500	2024-12-03
295	2023	132400	104100	236500	2024-12-03
295	2022	132400	104100	236500	2024-12-03
296	2025	131100	0	131100	2024-12-03
296	2023	131100	0	131100	2024-12-03
296	2022	131100	0	131100	2024-12-03
297	2025	40800	88400	129200	2024-12-03
297	2023	40800	88400	129200	2024-12-03
297	2022	40800	88400	129200	2024-12-03
298	2025	168100	118200	286300	2024-12-03
298	2023	168100	118200	286300	2024-12-03
298	2022	168100	118200	286300	2024-12-03
299	2025	108200	133400	241600	2024-12-03
299	2023	108200	133400	241600	2024-12-03
299	2022	108200	133400	241600	2024-12-03
300	2025	116500	93400	209900	2024-12-03
300	2023	116500	93400	209900	2024-12-03
300	2022	116500	93400	209900	2024-12-03
301	2025	197200	148700	345900	2024-12-03
301	2023	197200	148800	346000	2024-12-03
301	2022	197200	148800	346000	2024-12-03
303	2025	398500	179200	577700	2024-12-03
303	2023	392100	179200	571300	2024-12-03
303	2022	392100	179200	571300	2024-12-03
306	2025	252100	220000	472100	2024-12-03
306	2023	252100	220000	472100	2024-12-03
306	2022	252100	220000	472100	2024-12-03
307	2025	520400	260000	780400	2024-12-03
307	2023	498100	260400	758500	2024-12-03
307	2022	498100	260400	758500	2024-12-03
308	2025	280100	196600	476700	2024-12-03
308	2023	280100	196600	476700	2024-12-03
308	2022	280100	196600	476700	2024-12-03
309	2025	283000	304300	587300	2024-12-03
309	2023	283000	306100	589100	2024-12-03
309	2022	283000	306800	589800	2024-12-03
310	2025	511300	182400	693700	2024-12-03
310	2023	511300	183100	694400	2024-12-03
310	2022	511300	183400	694700	2024-12-03
311	2025	0	10500	10500	2024-12-03
311	2023	0	14500	14500	2024-12-03
311	2022	0	15600	15600	2024-12-03
313	2025	675600	428300	1103900	2024-12-03
313	2023	675600	429800	1105400	2024-12-03
313	2022	675600	430100	1105700	2024-12-03
315	2025	484200	174900	659100	2024-12-03
315	2023	484200	174900	659100	2024-12-03
315	2022	484200	174900	659100	2024-12-03
316	2025	229500	180700	410200	2024-12-03
316	2023	229500	180700	410200	2024-12-03
316	2022	229500	180700	410200	2024-12-03
317	2025	361800	152900	514700	2024-12-03
317	2023	361800	152900	514700	2024-12-03
317	2022	361800	152900	514700	2024-12-03
319	2025	381800	222900	604700	2024-12-03
319	2023	381800	222900	604700	2024-12-03
319	2022	381800	222900	604700	2024-12-03
320	2025	0	8500	8500	2024-12-03
320	2023	0	9500	9500	2024-12-03
320	2022	0	9700	9700	2024-12-03
321	2025	74900	140500	215400	2024-12-03
321	2023	74900	140500	215400	2024-12-03
321	2022	74900	140500	215400	2024-12-03
322	2025	0	150900	150900	2024-12-03
322	2023	0	151200	151200	2024-12-03
322	2022	0	151200	151200	2024-12-03
323	2025	156200	143800	300000	2024-12-03
323	2023	150100	143800	293900	2024-12-03
323	2022	150100	143800	293900	2024-12-03
324	2025	319900	137800	457700	2024-12-03
324	2023	319900	137800	457700	2024-12-03
324	2022	319900	137800	457700	2024-12-03
325	2025	750700	251100	1001800	2024-12-03
325	2023	750700	251100	1001800	2024-12-03
325	2022	750700	251100	1001800	2024-12-03
326	2025	327800	180100	507900	2024-12-03
326	2023	327800	180100	507900	2024-12-03
326	2022	327800	180100	507900	2024-12-03
327	2025	266500	153200	419700	2024-12-03
327	2023	266500	153200	419700	2024-12-03
327	2022	252500	153200	405700	2024-12-03
328	2025	178800	161000	339800	2024-12-03
328	2023	178800	161000	339800	2024-12-03
328	2022	178800	161000	339800	2024-12-03
329	2025	113100	93200	206300	2024-12-03
329	2023	113100	93200	206300	2024-12-03
329	2022	110800	93200	204000	2024-12-03
330	2025	216200	133800	350000	2024-12-03
330	2023	216200	134000	350200	2024-12-03
330	2022	216200	134000	350200	2024-12-03
331	2025	62500	131800	194300	2024-12-03
331	2023	62500	131800	194300	2024-12-03
331	2022	62500	131800	194300	2024-12-03
333	2025	0	15700	15700	2024-12-03
333	2023	0	15700	15700	2024-12-03
333	2022	0	15700	15700	2024-12-03
334	2025	459600	174300	633900	2024-12-03
334	2023	459600	175400	635000	2024-12-03
334	2022	459600	175600	635200	2024-12-03
335	2025	130700	157100	287800	2024-12-03
335	2023	130700	157100	287800	2024-12-03
335	2022	103500	157100	260600	2024-12-03
336	2025	210700	158300	369000	2024-12-03
336	2023	210700	158300	369000	2024-12-03
336	2022	210700	158300	369000	2024-12-03
337	2025	630400	197400	827800	2024-12-03
337	2023	630400	197400	827800	2024-12-03
337	2022	630400	197400	827800	2024-12-03
339	2025	153000	140300	293300	2024-12-03
339	2023	153000	140300	293300	2024-12-03
339	2022	153000	140300	293300	2024-12-03
340	2025	382600	176700	559300	2024-12-03
340	2023	382600	176700	559300	2024-12-03
340	2022	382600	176700	559300	2024-12-03
341	2025	228100	123800	351900	2024-12-03
341	2023	198000	123800	321800	2024-12-03
341	2022	191600	123800	315400	2024-12-03
343	2025	238400	197200	435600	2024-12-03
343	2023	238400	197200	435600	2024-12-03
343	2022	238400	197200	435600	2024-12-03
344	2025	265500	107800	373300	2024-12-03
344	2023	265500	109500	375000	2024-12-03
344	2022	265500	109500	375000	2024-12-03
345	2025	298800	153300	452100	2024-12-03
345	2023	288300	153300	441600	2024-12-03
345	2022	288300	153300	441600	2024-12-03
346	2025	256900	159200	416100	2024-12-03
346	2023	256900	159200	416100	2024-12-03
346	2022	256900	159200	416100	2024-12-03
347	2025	8800	18500	27300	2024-12-03
347	2023	8800	18600	27400	2024-12-03
347	2022	8800	18600	27400	2024-12-03
348	2025	295100	149400	444500	2024-12-03
348	2023	287400	149400	436800	2024-12-03
348	2022	287400	149400	436800	2024-12-03
349	2025	0	102600	102600	2024-12-03
349	2023	0	102600	102600	2024-12-03
349	2022	0	102600	102600	2024-12-03
350	2025	0	52200	52200	2024-12-03
350	2023	0	52200	52200	2024-12-03
350	2022	0	52200	52200	2024-12-03
351	2025	275300	148900	424200	2024-12-03
351	2023	284700	148900	433600	2024-12-03
351	2022	284700	148900	433600	2024-12-03
355	2025	0	330300	330300	2024-12-03
355	2023	0	330300	330300	2024-12-03
355	2022	0	330300	330300	2024-12-03
357	2025	0	159000	159000	2024-12-03
357	2023	0	159000	159000	2024-12-03
357	2022	0	159000	159000	2024-12-03
358	2025	0	9300	9300	2024-12-03
358	2023	0	9300	9300	2024-12-03
358	2022	0	9300	9300	2024-12-03
359	2025	92400	135100	227500	2024-12-03
359	2023	92400	135100	227500	2024-12-03
359	2022	92400	135100	227500	2024-12-03
360	2025	126800	101800	228600	2024-12-03
360	2023	128100	101800	229900	2024-12-03
360	2022	128100	101800	229900	2024-12-03
361	2025	344600	155900	500500	2024-12-03
361	2023	344600	156400	501000	2024-12-03
361	2022	344600	156600	501200	2024-12-03
363	2025	392400	128100	520500	2024-12-03
363	2023	392400	128100	520500	2024-12-03
363	2022	392400	128100	520500	2024-12-03
364	2025	114400	98300	212700	2024-12-03
364	2023	114400	98300	212700	2024-12-03
364	2022	114400	98300	212700	2024-12-03
365	2025	544900	255700	800600	2024-12-03
365	2023	544900	257000	801900	2024-12-03
365	2022	544900	257400	802300	2024-12-03
368	2025	242900	111700	354600	2024-12-03
368	2023	242900	111700	354600	2024-12-03
368	2022	242900	111700	354600	2024-12-03
369	2025	477100	240600	717700	2024-12-03
369	2023	477100	240900	718000	2024-12-03
369	2022	477100	240900	718000	2024-12-03
370	2025	0	312000	312000	2024-12-03
370	2023	0	312000	312000	2024-12-03
370	2022	0	312000	312000	2024-12-03
371	2025	357300	166800	524100	2024-12-03
371	2023	342300	166800	509100	2024-12-03
371	2022	342300	166800	509100	2024-12-03
372	2025	219900	208700	428600	2024-12-03
372	2023	219900	208700	428600	2024-12-03
372	2022	219900	208700	428600	2024-12-03
375	2025	0	244100	244100	2024-12-03
375	2023	0	244100	244100	2024-12-03
375	2022	0	244100	244100	2024-12-03
376	2025	387900	162700	550600	2024-12-03
376	2023	387900	163100	551000	2024-12-03
376	2022	387900	163300	551200	2024-12-03
377	2025	34900	146600	181500	2024-12-03
377	2023	34900	148600	183500	2024-12-03
377	2022	34900	148800	183700	2024-12-03
378	2025	345600	142700	488300	2024-12-03
378	2023	345600	142700	488300	2024-12-03
378	2022	345600	142700	488300	2024-12-03
379	2025	65300	118000	183300	2024-12-03
379	2023	65300	118000	183300	2024-12-03
379	2022	65300	118000	183300	2024-12-03
380	2025	184800	157400	342200	2024-12-03
380	2023	184800	157400	342200	2024-12-03
380	2022	184800	157400	342200	2024-12-03
381	2025	73000	107800	180800	2024-12-03
381	2023	73000	107800	180800	2024-12-03
381	2022	73000	107800	180800	2024-12-03
382	2025	150900	158900	309800	2024-12-03
382	2023	150900	158900	309800	2024-12-03
382	2022	150900	158900	309800	2024-12-03
383	2025	0	3300	3300	2024-12-03
383	2023	0	4800	4800	2024-12-03
383	2022	0	5000	5000	2024-12-03
384	2025	115100	241800	356900	2024-12-03
384	2023	115100	241800	356900	2024-12-03
384	2022	115100	241800	356900	2024-12-03
385	2025	285900	172600	458500	2024-12-03
385	2023	285900	172600	458500	2024-12-03
385	2022	285900	172600	458500	2024-12-03
387	2025	0	32300	32300	2024-12-03
387	2023	0	32300	32300	2024-12-03
387	2022	0	32300	32300	2024-12-03
388	2025	0	73500	73500	2024-12-03
388	2023	0	73500	73500	2024-12-03
388	2022	0	73500	73500	2024-12-03
389	2025	267800	112600	380400	2024-12-03
389	2023	267800	112600	380400	2024-12-03
389	2022	267800	112600	380400	2024-12-03
390	2025	0	454600	454600	2024-12-03
390	2023	0	454600	454600	2024-12-03
390	2022	0	454600	454600	2024-12-03
391	2025	113000	321300	434300	2024-12-03
391	2023	113000	321300	434300	2024-12-03
391	2022	147800	321300	469100	2024-12-03
392	2025	490000	360400	850400	2024-12-03
392	2023	490000	360400	850400	2024-12-03
392	2022	490000	360400	850400	2024-12-03
394	2025	371100	355400	726500	2024-12-03
394	2023	371100	355400	726500	2024-12-03
394	2022	371100	355400	726500	2024-12-03
395	2025	332100	335700	667800	2024-12-03
395	2023	332100	335700	667800	2024-12-03
395	2022	332100	335700	667800	2024-12-03
398	2025	777200	1621300	2398500	2024-12-03
398	2023	777200	1621300	2398500	2024-12-03
398	2022	777200	1621300	2398500	2024-12-03
399	2025	354400	297700	652100	2024-12-03
399	2023	354400	297700	652100	2024-12-03
399	2022	354400	297700	652100	2024-12-03
400	2025	339100	163100	502200	2024-12-03
400	2023	339100	163100	502200	2024-12-03
400	2022	339100	163100	502200	2024-12-03
401	2025	0	1188900	1188900	2024-12-03
401	2023	0	1188900	1188900	2024-12-03
401	2022	0	1188900	1188900	2024-12-03
402	2025	1367100	1205000	2572100	2024-12-03
402	2023	1367100	1205000	2572100	2024-12-03
402	2022	1367100	1205000	2572100	2024-12-03
405	2025	146300	143300	289600	2024-12-03
405	2023	146300	143300	289600	2024-12-03
405	2022	146300	143300	289600	2024-12-03
407	2025	0	13800	13800	2024-12-03
407	2023	0	13800	13800	2024-12-03
407	2022	0	13900	13900	2024-12-03
408	2025	182100	148500	330600	2024-12-03
408	2023	171500	148500	320000	2024-12-03
408	2022	171500	148500	320000	2024-12-03
415	2025	242800	212800	455600	2024-12-03
415	2023	242800	212800	455600	2024-12-03
415	2022	242800	212800	455600	2024-12-03
417	2025	34800	20500	55300	2024-12-03
417	2023	34800	20800	55600	2024-12-03
417	2022	34800	20900	55700	2024-12-03
418	2025	432100	205700	637800	2024-12-03
418	2023	432100	205700	637800	2024-12-03
418	2022	432100	205700	637800	2024-12-03
427	2025	317000	162800	479800	2024-12-03
427	2023	317000	162800	479800	2024-12-03
427	2022	317000	162800	479800	2024-12-03
429	2025	555500	172400	727900	2024-12-03
429	2023	555500	172400	727900	2024-12-03
429	2022	553700	172400	726100	2024-12-03
432	2025	0	23700	23700	2024-12-03
432	2023	0	23700	23700	2024-12-03
432	2022	0	23700	23700	2024-12-03
433	2025	38200	104500	142700	2024-12-03
433	2023	37700	104500	142200	2024-12-03
433	2022	37700	104500	142200	2024-12-03
434	2025	58600	184300	242900	2024-12-03
434	2023	58600	184300	242900	2024-12-03
434	2022	58600	184300	242900	2024-12-03
435	2025	104100	221200	325300	2024-12-03
435	2023	104100	221200	325300	2024-12-03
435	2022	104100	221200	325300	2024-12-03
436	2025	57700	187000	244700	2024-12-03
436	2023	57700	187000	244700	2024-12-03
436	2022	57700	187000	244700	2024-12-03
437	2025	684600	378100	1062700	2024-12-03
437	2023	682800	378100	1060900	2024-12-03
437	2022	682800	378100	1060900	2024-12-03
438	2025	310300	261700	572000	2024-12-03
438	2023	308800	261700	570500	2024-12-03
438	2022	308800	261700	570500	2024-12-03
439	2025	0	6400	6400	2024-12-03
439	2023	0	6400	6400	2024-12-03
439	2022	0	6400	6400	2024-12-03
440	2025	53000	228900	281900	2024-12-03
440	2023	53000	228900	281900	2024-12-03
440	2022	53000	228900	281900	2024-12-03
441	2025	406800	455200	862000	2024-12-03
441	2023	404100	455200	859300	2024-12-03
441	2022	404100	455200	859300	2024-12-03
442	2025	232400	196700	429100	2024-12-03
442	2023	229500	196700	426200	2024-12-03
442	2022	229500	196700	426200	2024-12-03
446	2025	426500	213900	640400	2024-12-03
446	2023	421000	215800	636800	2024-12-03
446	2022	417800	216600	634400	2024-12-03
447	2025	191900	228500	420400	2024-12-03
447	2023	191200	228500	419700	2024-12-03
447	2022	191200	228500	419700	2024-12-03
448	2025	403800	254500	658300	2024-12-03
448	2023	396900	255200	652100	2024-12-03
448	2022	396900	255400	652300	2024-12-03
450	2025	561400	398500	959900	2024-12-03
450	2023	561400	402800	964200	2024-12-03
450	2022	561400	403400	964800	2024-12-03
454	2025	563300	241600	804900	2024-12-03
454	2023	586600	243900	830500	2024-12-03
454	2022	586600	243800	830400	2024-12-03
457	2025	824300	224600	1048900	2024-12-03
457	2023	818800	225400	1044200	2024-12-03
457	2022	818800	225700	1044500	2024-12-03
458	2025	234900	272600	507500	2024-12-03
458	2023	234800	272600	507400	2024-12-03
458	2022	234800	272600	507400	2024-12-03
459	2025	293400	192000	485400	2024-12-03
459	2023	293400	192000	485400	2024-12-03
459	2022	293400	192000	485400	2024-12-03
460	2025	512600	200300	712900	2024-12-03
460	2023	479100	201400	680500	2024-12-03
460	2022	479100	201800	680900	2024-12-03
461	2025	714600	232700	947300	2024-12-03
461	2023	714600	233000	947600	2024-12-03
461	2022	714600	233100	947700	2024-12-03
462	2025	545200	192300	737500	2024-12-03
462	2023	544600	192600	737200	2024-12-03
462	2022	544600	192700	737300	2024-12-03
463	2025	0	3800	3800	2024-12-03
463	2023	0	4100	4100	2024-12-03
463	2022	0	4200	4200	2024-12-03
465	2025	0	12300	12300	2024-12-03
465	2023	0	12300	12300	2024-12-03
465	2022	0	12300	12300	2024-12-03
469	2025	739700	271500	1011200	2024-12-03
469	2023	725500	271500	997000	2024-12-03
469	2022	725500	271500	997000	2024-12-03
472	2025	715000	175000	890000	2024-12-03
472	2023	715000	175300	890300	2024-12-03
472	2022	715000	175300	890300	2024-12-03
473	2025	535100	210400	745500	2024-12-03
473	2023	535100	210400	745500	2024-12-03
473	2022	535100	210400	745500	2024-12-03
474	2025	358800	200000	558800	2024-12-03
474	2023	358800	200000	558800	2024-12-03
474	2022	358800	200000	558800	2024-12-03
475	2025	472000	214600	686600	2024-12-03
475	2023	472000	214600	686600	2024-12-03
475	2022	472000	214600	686600	2024-12-03
476	2025	1286400	304400	1590800	2024-12-03
476	2023	1080000	234400	1314400	2024-12-03
476	2022	285600	192300	477900	2024-12-03
478	2025	270800	188200	459000	2024-12-03
478	2023	270800	190700	461500	2024-12-03
478	2022	270800	190600	461400	2024-12-03
479	2025	790200	305500	1095700	2024-12-03
479	2023	750500	307300	1057800	2024-12-03
479	2022	750500	307800	1058300	2024-12-03
480	2025	233500	162100	395600	2024-12-03
480	2023	233500	162200	395700	2024-12-03
480	2022	233500	162300	395800	2024-12-03
482	2025	309900	154000	463900	2024-12-03
482	2023	308300	154500	462800	2024-12-03
482	2022	308300	154600	462900	2024-12-03
483	2025	0	700	700	2024-12-03
483	2023	0	700	700	2024-12-03
483	2022	0	700	700	2024-12-03
484	2025	419600	182200	601800	2024-12-03
484	2023	431700	182200	613900	2024-12-03
484	2022	431700	182200	613900	2024-12-03
486	2025	367300	218100	585400	2024-12-03
486	2023	367800	218100	585900	2024-12-03
486	2022	367800	218100	585900	2024-12-03
487	2025	170400	180000	350400	2024-12-03
487	2023	170800	180000	350800	2024-12-03
487	2022	165100	180000	345100	2024-12-03
488	2025	314900	248800	563700	2024-12-03
488	2023	314900	248800	563700	2024-12-03
488	2022	309400	248800	558200	2024-12-03
489	2025	231000	253700	484700	2024-12-03
489	2023	225500	253700	479200	2024-12-03
489	2022	225500	253700	479200	2024-12-03
490	2025	290700	211700	502400	2024-12-03
490	2023	289700	211700	501400	2024-12-03
490	2022	289700	211700	501400	2024-12-03
491	2025	323400	221400	544800	2024-12-03
491	2023	311300	221900	533200	2024-12-03
491	2022	311300	222200	533500	2024-12-03
492	2025	146800	198600	345400	2024-12-03
492	2023	146800	198600	345400	2024-12-03
492	2022	146800	198600	345400	2024-12-03
493	2025	457000	256800	713800	2024-12-03
493	2023	442700	257800	700500	2024-12-03
493	2022	442700	257900	700600	2024-12-03
494	2025	978200	288000	1266200	2024-12-03
494	2023	978200	289400	1267600	2024-12-03
494	2022	978200	289400	1267600	2024-12-03
495	2025	308000	314900	622900	2024-12-03
495	2023	308000	314900	622900	2024-12-03
495	2022	308000	333700	641700	2024-12-03
501	2025	60200	199300	259500	2024-12-03
501	2023	63500	199300	262800	2024-12-03
501	2022	63500	199300	262800	2024-12-03
505	2025	706600	441000	1147600	2024-12-03
505	2023	704800	441000	1145800	2024-12-03
505	2022	704800	441000	1145800	2024-12-03
506	2025	581800	356800	938600	2024-12-03
506	2023	580400	356800	937200	2024-12-03
506	2022	580400	356800	937200	2024-12-03
507	2025	321300	289200	610500	2024-12-03
507	2023	321300	289200	610500	2024-12-03
507	2022	321300	289200	610500	2024-12-03
509	2025	339600	260800	600400	2024-12-03
509	2023	339400	260800	600200	2024-12-03
509	2022	339400	260800	600200	2024-12-03
510	2025	406200	253600	659800	2024-12-03
510	2023	406200	253700	659900	2024-12-03
510	2022	406200	253700	659900	2024-12-03
511	2025	196500	212500	409000	2024-12-03
511	2023	196100	212500	408600	2024-12-03
511	2022	196100	212500	408600	2024-12-03
512	2025	0	9900	9900	2024-12-03
512	2023	0	10200	10200	2024-12-03
512	2022	0	10200	10200	2024-12-03
513	2025	277700	214600	492300	2024-12-03
513	2023	275900	214600	490500	2024-12-03
513	2022	275900	214600	490500	2024-12-03
514	2025	351500	278300	629800	2024-12-03
514	2023	365300	278300	643600	2024-12-03
514	2022	365300	278300	643600	2024-12-03
515	2025	173500	187700	361200	2024-12-03
515	2023	173600	187700	361300	2024-12-03
515	2022	173600	187700	361300	2024-12-03
517	2025	387100	181300	568400	2024-12-03
517	2023	387600	181300	568900	2024-12-03
517	2022	331700	181300	513000	2024-12-03
518	2025	290800	217800	508600	2024-12-03
518	2023	290800	217800	508600	2024-12-03
518	2022	290800	217800	508600	2024-12-03
519	2025	142100	156900	299000	2024-12-03
519	2023	142100	156900	299000	2024-12-03
519	2022	142100	156900	299000	2024-12-03
520	2025	512800	204900	717700	2024-12-03
520	2023	512800	204900	717700	2024-12-03
520	2022	482800	204900	687700	2024-12-03
522	2025	167900	162100	330000	2024-12-03
522	2023	133200	162100	295300	2024-12-03
522	2022	133200	162100	295300	2024-12-03
526	2025	134800	217300	352100	2024-12-03
526	2023	133300	217300	350600	2024-12-03
526	2022	133300	217300	350600	2024-12-03
527	2025	312700	207400	520100	2024-12-03
527	2023	312700	207400	520100	2024-12-03
527	2022	312700	207400	520100	2024-12-03
529	2025	161200	181700	342900	2024-12-03
529	2023	159300	181700	341000	2024-12-03
529	2022	159300	181700	341000	2024-12-03
530	2025	484000	287600	771600	2024-12-03
530	2023	458500	287600	746100	2024-12-03
530	2022	458500	287600	746100	2024-12-03
532	2025	58700	182400	241100	2024-12-03
532	2023	58700	182400	241100	2024-12-03
532	2022	58700	182400	241100	2024-12-03
533	2025	561200	195900	757100	2024-12-03
533	2023	561200	195900	757100	2024-12-03
533	2022	561200	195900	757100	2024-12-03
537	2025	544100	312100	856200	2024-12-03
537	2023	544100	312100	856200	2024-12-03
537	2022	544100	312100	856200	2024-12-03
538	2025	380100	175200	555300	2024-12-03
538	2023	379300	175600	554900	2024-12-03
538	2022	379300	175600	554900	2024-12-03
540	2025	305400	183500	488900	2024-12-03
540	2023	296800	184500	481300	2024-12-03
540	2022	296800	184500	481300	2024-12-03
542	2025	185000	147700	332700	2024-12-03
542	2023	184300	147700	332000	2024-12-03
542	2022	184300	147700	332000	2024-12-03
543	2025	0	1200	1200	2024-12-03
543	2023	0	1500	1500	2024-12-03
543	2022	0	1500	1500	2024-12-03
544	2025	62300	171200	233500	2024-12-03
544	2023	62700	171200	233900	2024-12-03
544	2022	62700	171200	233900	2024-12-03
545	2025	119600	168200	287800	2024-12-03
545	2023	119600	168200	287800	2024-12-03
545	2022	109800	168200	278000	2024-12-03
546	2025	115400	166700	282100	2024-12-03
546	2023	115400	167200	282600	2024-12-03
546	2022	115400	167300	282700	2024-12-03
547	2025	173300	185500	358800	2024-12-03
547	2023	175800	185500	361300	2024-12-03
547	2022	175800	185500	361300	2024-12-03
552	2025	4600	130900	135500	2024-12-03
552	2023	3600	132900	136500	2024-12-03
552	2022	3600	133400	137000	2024-12-03
557	2025	125900	203800	329700	2024-12-03
557	2023	114900	203800	318700	2024-12-03
557	2022	114900	203800	318700	2024-12-03
558	2025	78500	161200	239700	2024-12-03
558	2023	45800	161200	207000	2024-12-03
558	2022	45800	161200	207000	2024-12-03
559	2025	300300	147500	447800	2024-12-03
559	2023	300300	147500	447800	2024-12-03
559	2022	300300	147500	447800	2024-12-03
560	2025	123500	162900	286400	2024-12-03
560	2023	123400	162900	286300	2024-12-03
560	2022	123400	162900	286300	2024-12-03
561	2025	0	12200	12200	2024-12-03
561	2023	0	12200	12200	2024-12-03
561	2022	0	12200	12200	2024-12-03
563	2025	357900	236700	594600	2024-12-03
563	2023	344200	236700	580900	2024-12-03
563	2022	344200	236700	580900	2024-12-03
564	2025	550000	361600	911600	2024-12-03
564	2023	544200	361900	906100	2024-12-03
564	2022	497800	361900	859700	2024-12-03
565	2025	249100	263400	512500	2024-12-03
565	2023	247800	263700	511500	2024-12-03
565	2022	247800	263700	511500	2024-12-03
569	2025	728700	395600	1124300	2024-12-03
569	2023	728700	396000	1124700	2024-12-03
569	2022	730600	396100	1126700	2024-12-03
570	2025	184400	343600	528000	2024-12-03
570	2023	184400	343600	528000	2024-12-03
570	2022	184400	343600	528000	2024-12-03
571	2025	169100	180000	349100	2024-12-03
571	2023	169100	180000	349100	2024-12-03
571	2022	169100	180000	349100	2024-12-03
572	2025	155200	183900	339100	2024-12-03
572	2023	155200	183900	339100	2024-12-03
572	2022	155200	183900	339100	2024-12-03
575	2025	668000	769400	1437400	2024-12-03
575	2023	796700	777600	1574300	2024-12-03
575	2022	862000	884300	1746300	2024-12-03
576	2025	2084100	1274800	3358900	2024-12-03
576	2023	2084100	1274800	3358900	2024-12-03
576	2022	2084100	1274800	3358900	2024-12-03
578	2025	881300	673600	1554900	2024-12-03
578	2023	881300	673600	1554900	2024-12-03
578	2022	881300	673600	1554900	2024-12-03
579	2025	469900	211800	681700	2024-12-03
579	2023	443300	211900	655200	2024-12-03
579	2022	443300	212000	655300	2024-12-03
580	2025	0	19300	19300	2024-12-03
580	2023	0	19300	19300	2024-12-03
580	2022	0	19300	19300	2024-12-03
581	2025	186900	245700	432600	2024-12-03
581	2023	174700	246100	420800	2024-12-03
581	2022	174700	246300	421000	2024-12-03
582	2025	1808200	404400	2212600	2024-12-03
582	2023	1765300	406900	2172200	2024-12-03
582	2022	1700400	406900	2107300	2024-12-03
584	2025	574900	226700	801600	2024-12-03
584	2023	561900	227200	789100	2024-12-03
584	2022	561900	227200	789100	2024-12-03
591	2025	0	10400	10400	2024-12-03
591	2023	0	11100	11100	2024-12-03
591	2022	0	11200	11200	2024-12-03
592	2025	0	600	600	2024-12-03
592	2023	0	900	900	2024-12-03
592	2022	0	1000	1000	2024-12-03
593	2025	234800	289700	524500	2024-12-03
593	2023	234800	290500	525300	2024-12-03
593	2022	234800	290800	525600	2024-12-03
594	2025	541800	220900	762700	2024-12-03
594	2023	541800	221100	762900	2024-12-03
594	2022	541800	221200	763000	2024-12-03
597	2025	673200	302100	975300	2024-12-03
597	2023	689900	302100	992000	2024-12-03
597	2022	689900	302100	992000	2024-12-03
598	2025	0	35000	35000	2024-12-03
598	2023	0	35000	35000	2024-12-03
598	2022	0	35000	35000	2024-12-03
600	2025	133000	128800	261800	2024-12-03
600	2023	133000	128800	261800	2024-12-03
600	2022	133000	128800	261800	2024-12-03
603	2025	0	19000	19000	2024-12-03
603	2023	0	19000	19000	2024-12-03
603	2022	0	20600	20600	2024-12-03
605	2025	189700	133300	323000	2024-12-03
605	2023	189700	133300	323000	2024-12-03
605	2022	189700	133300	323000	2024-12-03
607	2025	242700	191800	434500	2024-12-03
607	2023	243800	191800	435600	2024-12-03
607	2022	243800	191800	435600	2024-12-03
611	2025	672000	165500	837500	2024-12-03
611	2023	672000	166600	838600	2024-12-03
611	2022	672000	166800	838800	2024-12-03
616	2025	403700	153200	556900	2024-12-03
616	2023	403700	153200	556900	2024-12-03
616	2022	403700	153200	556900	2024-12-03
617	2025	175400	155200	330600	2024-12-03
617	2023	175400	155200	330600	2024-12-03
617	2022	175400	155200	330600	2024-12-03
618	2025	87000	240500	327500	2024-12-03
618	2023	111400	241100	352500	2024-12-03
618	2022	83100	184500	267600	2024-12-03
620	2025	0	5000	5000	2024-12-03
620	2023	0	6900	6900	2024-12-03
620	2022	0	6900	6900	2024-12-03
621	2025	147500	141900	289400	2024-12-03
621	2023	147500	142200	289700	2024-12-03
621	2022	147500	142200	289700	2024-12-03
622	2025	97700	138300	236000	2024-12-03
622	2023	97700	138300	236000	2024-12-03
622	2022	97700	138300	236000	2024-12-03
623	2025	89500	147700	237200	2024-12-03
623	2023	89500	147700	237200	2024-12-03
623	2022	89500	147700	237200	2024-12-03
624	2025	330700	146400	477100	2024-12-03
624	2023	301300	147500	448800	2024-12-03
624	2022	301300	147600	448900	2024-12-03
625	2025	556600	220500	777100	2024-12-03
625	2023	553700	220500	774200	2024-12-03
625	2022	553700	220500	774200	2024-12-03
626	2025	434300	198700	633000	2024-12-03
626	2023	428100	199000	627100	2024-12-03
626	2022	428100	199300	627400	2024-12-03
627	2025	0	1000	1000	2024-12-03
627	2023	0	1200	1200	2024-12-03
627	2022	0	1100	1100	2024-12-03
633	2025	0	585800	585800	2024-12-03
633	2023	0	585800	585800	2024-12-03
633	2022	0	585800	585800	2024-12-03
634	2025	0	6300	6300	2024-12-03
634	2023	0	7400	7400	2024-12-03
634	2022	0	7700	7700	2024-12-03
635	2025	0	4200	4200	2024-12-03
635	2023	0	4200	4200	2024-12-03
635	2022	0	4200	4200	2024-12-03
636	2025	0	4200	4200	2024-12-03
636	2023	0	4200	4200	2024-12-03
636	2022	0	4200	4200	2024-12-03
637	2025	229100	81000	310100	2024-12-03
637	2023	228800	81000	309800	2024-12-03
637	2022	228800	81000	309800	2024-12-03
638	2025	279300	124000	403300	2024-12-03
638	2023	279300	124400	403700	2024-12-03
638	2022	279300	124600	403900	2024-12-03
639	2025	1622100	339300	1961400	2024-12-03
639	2023	1610400	340800	1951200	2024-12-03
639	2022	1610400	341100	1951500	2024-12-03
643	2025	0	40400	40400	2024-12-03
643	2023	0	40400	40400	2024-12-03
643	2022	0	40400	40400	2024-12-03
645	2025	243400	133300	376700	2024-12-03
645	2023	243400	133300	376700	2024-12-03
645	2022	243400	133300	376700	2024-12-03
647	2025	30000	258600	288600	2024-12-03
647	2023	30000	258800	288800	2024-12-03
647	2022	30000	258800	288800	2024-12-03
648	2025	838300	492700	1331000	2024-12-03
648	2023	838300	492700	1331000	2024-12-03
648	2022	838300	492700	1331000	2024-12-03
649	2025	318500	254900	573400	2024-12-03
649	2023	318500	254900	573400	2024-12-03
649	2022	318500	254900	573400	2024-12-03
650	2025	183500	235400	418900	2024-12-03
650	2023	183500	235400	418900	2024-12-03
650	2022	183500	235400	418900	2024-12-03
651	2025	183300	278100	461400	2024-12-03
651	2023	183300	278100	461400	2024-12-03
651	2022	183300	278100	461400	2024-12-03
652	2025	23900	208300	232200	2024-12-03
652	2023	23900	208300	232200	2024-12-03
652	2022	23900	208300	232200	2024-12-03
653	2025	68500	262400	330900	2024-12-03
653	2023	68500	262400	330900	2024-12-03
653	2022	68500	262400	330900	2024-12-03
654	2025	107000	268100	375100	2024-12-03
654	2023	107000	268900	375900	2024-12-03
654	2022	107000	269200	376200	2024-12-03
655	2025	480400	433200	913600	2024-12-03
655	2023	480400	433200	913600	2024-12-03
655	2022	480400	433200	913600	2024-12-03
659	2025	0	13900	13900	2024-12-03
659	2023	0	13900	13900	2024-12-03
659	2022	0	13900	13900	2024-12-03
664	2025	55700	128400	184100	2024-12-03
664	2023	55700	128400	184100	2024-12-03
664	2022	55700	128400	184100	2024-12-03
667	2025	18200	100700	118900	2024-12-03
667	2023	18200	100700	118900	2024-12-03
667	2022	18200	100700	118900	2024-12-03
673	2025	44600	194800	239400	2024-12-03
673	2023	44600	194900	239500	2024-12-03
673	2022	44600	194900	239500	2024-12-03
675	2025	0	11000	11000	2024-12-03
675	2023	0	11200	11200	2024-12-03
675	2022	0	11300	11300	2024-12-03
686	2025	0	11600	11600	2024-12-03
686	2023	0	11600	11600	2024-12-03
686	2022	0	11600	11600	2024-12-03
688	2025	2600	47600	50200	2024-12-03
688	2023	2600	47600	50200	2024-12-03
688	2022	2600	47600	50200	2024-12-03
689	2025	281400	161500	442900	2024-12-03
689	2023	281400	161600	443000	2024-12-03
689	2022	309800	161700	471500	2024-12-03
690	2025	726400	200500	926900	2024-12-03
690	2023	726400	200500	926900	2024-12-03
690	2022	726400	200500	926900	2024-12-03
691	2025	400600	212900	613500	2024-12-03
691	2023	400600	212900	613500	2024-12-03
691	2022	400600	212900	613500	2024-12-03
692	2025	578500	227500	806000	2024-12-03
692	2023	578500	227500	806000	2024-12-03
692	2022	578500	227500	806000	2024-12-03
694	2025	192900	152200	345100	2024-12-03
694	2023	192900	152200	345100	2024-12-03
694	2022	192900	152200	345100	2024-12-03
695	2025	179300	193800	373100	2024-12-03
695	2023	179300	193800	373100	2024-12-03
695	2022	179300	193800	373100	2024-12-03
696	2025	324100	191200	515300	2024-12-03
696	2023	324100	191200	515300	2024-12-03
696	2022	324100	191200	515300	2024-12-03
697	2025	227900	135800	363700	2024-12-03
697	2023	227900	136000	363900	2024-12-03
697	2022	227900	136100	364000	2024-12-03
698	2025	501500	179200	680700	2024-12-03
698	2023	486500	179200	665700	2024-12-03
698	2022	486500	179200	665700	2024-12-03
700	2025	48900	77600	126500	2024-12-03
700	2023	48900	77600	126500	2024-12-03
700	2022	48900	77600	126500	2024-12-03
701	2025	211800	176600	388400	2024-12-03
701	2023	211800	176600	388400	2024-12-03
701	2022	208100	176600	384700	2024-12-03
702	2025	216000	149500	365500	2024-12-03
702	2023	216000	149500	365500	2024-12-03
702	2022	216000	149500	365500	2024-12-03
703	2025	66400	191800	258200	2024-12-03
703	2023	66400	191800	258200	2024-12-03
703	2022	66400	191800	258200	2024-12-03
704	2025	146600	149000	295600	2024-12-03
704	2023	146600	149000	295600	2024-12-03
704	2022	146600	149000	295600	2024-12-03
705	2025	2000	8800	10800	2024-12-03
705	2023	2000	8800	10800	2024-12-03
705	2022	2000	8800	10800	2024-12-03
706	2025	213600	196500	410100	2024-12-03
706	2023	213600	196500	410100	2024-12-03
706	2022	213600	196500	410100	2024-12-03
707	2025	210800	170800	381600	2024-12-03
707	2023	210800	170800	381600	2024-12-03
707	2022	210800	170800	381600	2024-12-03
708	2025	144900	157600	302500	2024-12-03
708	2023	144900	157600	302500	2024-12-03
708	2022	144900	157600	302500	2024-12-03
711	2025	162700	125900	288600	2024-12-03
711	2023	162700	125900	288600	2024-12-03
711	2022	162700	125900	288600	2024-12-03
717	2025	0	9000	9000	2024-12-03
717	2023	0	9400	9400	2024-12-03
717	2022	0	9600	9600	2024-12-03
719	2025	347200	157200	504400	2024-12-03
719	2023	347200	157300	504500	2024-12-03
719	2022	347200	157400	504600	2024-12-03
720	2025	228000	175200	403200	2024-12-03
720	2023	213000	175200	388200	2024-12-03
720	2022	213000	175200	388200	2024-12-03
723	2025	263100	145600	408700	2024-12-03
723	2023	262400	145600	408000	2024-12-03
723	2022	249500	145600	395100	2024-12-03
724	2025	716900	175900	892800	2024-12-03
724	2023	0	142400	142400	2024-12-03
724	2022	0	21900	21900	2024-12-03
725	2025	446600	217700	664300	2024-12-03
725	2023	446600	217700	664300	2024-12-03
725	2022	446600	217700	664300	2024-12-03
734	2025	559500	267700	827200	2024-12-03
734	2023	559500	267700	827200	2024-12-03
734	2022	559500	267700	827200	2024-12-03
735	2025	0	258100	258100	2024-12-03
735	2023	0	258100	258100	2024-12-03
735	2022	0	258100	258100	2024-12-03
736	2025	1054700	284700	1339400	2024-12-03
736	2023	1054700	284700	1339400	2024-12-03
736	2022	1054700	284700	1339400	2024-12-03
737	2025	854300	274700	1129000	2024-12-03
737	2023	854300	275100	1129400	2024-12-03
737	2022	854300	275100	1129400	2024-12-03
738	2025	375400	271100	646500	2024-12-03
738	2023	375400	271100	646500	2024-12-03
738	2022	375400	271100	646500	2024-12-03
739	2025	420500	329500	750000	2024-12-03
739	2023	420500	329500	750000	2024-12-03
739	2022	471700	329500	801200	2024-12-03
740	2025	668000	334400	1002400	2024-12-03
740	2023	668000	334400	1002400	2024-12-03
740	2022	668000	334400	1002400	2024-12-03
741	2025	136000	199200	335200	2024-12-03
741	2023	136000	199700	335700	2024-12-03
741	2022	136000	199900	335900	2024-12-03
742	2025	602000	273800	875800	2024-12-03
742	2023	602000	274100	876100	2024-12-03
742	2022	602000	274100	876100	2024-12-03
743	2025	254600	268600	523200	2024-12-03
743	2023	254600	268600	523200	2024-12-03
743	2022	258000	268600	526600	2024-12-03
744	2025	428200	222300	650500	2024-12-03
744	2023	330000	222500	552500	2024-12-03
744	2022	525500	222500	748000	2024-12-03
745	2025	0	7000	7000	2024-12-03
745	2023	0	7000	7000	2024-12-03
745	2022	0	7000	7000	2024-12-03
746	2025	657300	297600	954900	2024-12-03
746	2023	657300	297600	954900	2024-12-03
746	2022	657300	297600	954900	2024-12-03
747	2025	456000	330800	786800	2024-12-03
747	2023	456000	330800	786800	2024-12-03
747	2022	454400	330800	785200	2024-12-03
748	2025	424400	311100	735500	2024-12-03
748	2023	424400	311300	735700	2024-12-03
748	2022	424400	311400	735800	2024-12-03
749	2025	1062400	477100	1539500	2024-12-03
749	2023	1062400	477700	1540100	2024-12-03
749	2022	1062400	477700	1540100	2024-12-03
750	2025	1014500	272500	1287000	2024-12-03
750	2023	1008100	272500	1280600	2024-12-03
750	2022	1008100	272500	1280600	2024-12-03
751	2025	311800	169700	481500	2024-12-03
751	2023	311800	169900	481700	2024-12-03
751	2022	311800	169900	481700	2024-12-03
752	2025	335600	184300	519900	2024-12-03
752	2023	335600	184900	520500	2024-12-03
752	2022	335600	185000	520600	2024-12-03
753	2025	475900	352900	828800	2024-12-03
753	2023	475900	353400	829300	2024-12-03
753	2022	475900	353400	829300	2024-12-03
754	2025	506500	177800	684300	2024-12-03
754	2023	506500	179200	685700	2024-12-03
754	2022	506500	179500	686000	2024-12-03
755	2025	173500	173400	346900	2024-12-03
755	2023	173500	173400	346900	2024-12-03
755	2022	173500	173400	346900	2024-12-03
756	2025	363200	293600	656800	2024-12-03
756	2023	363200	293900	657100	2024-12-03
756	2022	363200	293900	657100	2024-12-03
757	2025	0	251800	251800	2024-12-03
757	2023	0	251800	251800	2024-12-03
757	2022	0	251800	251800	2024-12-03
758	2025	122500	165200	287700	2024-12-03
758	2023	122500	165700	288200	2024-12-03
758	2022	122500	165700	288200	2024-12-03
759	2025	103400	177900	281300	2024-12-03
759	2023	103400	177900	281300	2024-12-03
759	2022	103400	177900	281300	2024-12-03
760	2025	0	135800	135800	2024-12-03
760	2023	0	136300	136300	2024-12-03
760	2022	0	136500	136500	2024-12-03
762	2025	0	400	400	2024-12-03
762	2023	0	500	500	2024-12-03
762	2022	0	500	500	2024-12-03
764	2025	53400	141100	194500	2024-12-03
764	2023	53400	141100	194500	2024-12-03
764	2022	53400	141100	194500	2024-12-03
765	2025	313700	148700	462400	2024-12-03
765	2023	313700	148700	462400	2024-12-03
765	2022	313700	150400	464100	2024-12-03
767	2025	73900	27500	101400	2024-12-03
767	2023	8700	29600	38300	2024-12-03
767	2022	8700	29100	37800	2024-12-03
768	2025	639200	215800	855000	2024-12-03
768	2023	639200	215800	855000	2024-12-03
768	2022	639200	215800	855000	2024-12-03
769	2025	195800	149200	345000	2024-12-03
769	2023	195800	149200	345000	2024-12-03
769	2022	195800	149200	345000	2024-12-03
770	2025	0	5700	5700	2024-12-03
770	2023	0	6300	6300	2024-12-03
770	2022	0	6400	6400	2024-12-03
771	2025	283000	205900	488900	2024-12-03
771	2023	283000	205900	488900	2024-12-03
771	2022	283000	205900	488900	2024-12-03
772	2025	256700	176600	433300	2024-12-03
772	2023	256700	176600	433300	2024-12-03
772	2022	256700	176600	433300	2024-12-03
773	2025	0	142900	142900	2024-12-03
773	2023	0	142900	142900	2024-12-03
773	2022	0	142900	142900	2024-12-03
774	2025	161200	147700	308900	2024-12-03
774	2023	161200	147700	308900	2024-12-03
774	2022	161200	147700	308900	2024-12-03
775	2025	127300	164800	292100	2024-12-03
775	2023	127300	164800	292100	2024-12-03
775	2022	127300	164800	292100	2024-12-03
776	2025	404000	206900	610900	2024-12-03
776	2023	404000	206900	610900	2024-12-03
776	2022	404000	206900	610900	2024-12-03
782	2025	831100	284100	1115200	2024-12-03
782	2023	831100	285700	1116800	2024-12-03
782	2022	831100	285700	1116800	2024-12-03
783	2025	94200	152700	246900	2024-12-03
783	2023	94200	152700	246900	2024-12-03
783	2022	94200	152700	246900	2024-12-03
784	2025	11200	149400	160600	2024-12-03
784	2023	11200	149400	160600	2024-12-03
784	2022	11200	149400	160600	2024-12-03
785	2025	857100	313500	1170600	2024-12-03
785	2023	857100	314000	1171100	2024-12-03
785	2022	857100	314100	1171200	2024-12-03
786	2025	484200	239300	723500	2024-12-03
786	2023	484200	240000	724200	2024-12-03
786	2022	484200	240000	724200	2024-12-03
787	2025	238800	166500	405300	2024-12-03
787	2023	238800	166500	405300	2024-12-03
787	2022	238800	166500	405300	2024-12-03
788	2025	146600	156300	302900	2024-12-03
788	2023	136300	156300	292600	2024-12-03
788	2022	136300	156300	292600	2024-12-03
789	2025	308700	130500	439200	2024-12-03
789	2023	288700	130600	419300	2024-12-03
789	2022	288700	130600	419300	2024-12-03
792	2025	413000	181300	594300	2024-12-03
792	2023	413000	181300	594300	2024-12-03
792	2022	413000	181300	594300	2024-12-03
793	2025	0	2300	2300	2024-12-03
793	2023	0	2700	2700	2024-12-03
793	2022	0	2800	2800	2024-12-03
795	2025	236000	161200	397200	2024-12-03
795	2023	236000	161200	397200	2024-12-03
795	2022	236000	161200	397200	2024-12-03
796	2025	55500	94000	149500	2024-12-03
796	2023	55500	94000	149500	2024-12-03
796	2022	55500	94000	149500	2024-12-03
797	2025	535400	214900	750300	2024-12-03
797	2023	535400	214900	750300	2024-12-03
797	2022	535400	214900	750300	2024-12-03
798	2025	5400	142200	147600	2024-12-03
798	2023	5400	147600	153000	2024-12-03
798	2022	5400	148600	154000	2024-12-03
799	2025	375900	182900	558800	2024-12-03
799	2023	375900	182900	558800	2024-12-03
799	2022	375900	182900	558800	2024-12-03
800	2025	1185500	328400	1513900	2024-12-03
800	2023	1185500	328400	1513900	2024-12-03
800	2022	1185500	328400	1513900	2024-12-03
801	2025	395700	214700	610400	2024-12-03
801	2023	395700	215700	611400	2024-12-03
801	2022	395700	216100	611800	2024-12-03
804	2025	453900	234100	688000	2024-12-03
804	2023	453900	235000	688900	2024-12-03
804	2022	453900	235100	689000	2024-12-03
806	2025	715100	206000	921100	2024-12-03
806	2023	715100	206300	921400	2024-12-03
806	2022	715100	206400	921500	2024-12-03
807	2025	0	11800	11800	2024-12-03
807	2023	0	13700	13700	2024-12-03
807	2022	0	14500	14500	2024-12-03
808	2025	268500	184100	452600	2024-12-03
808	2023	268500	184100	452600	2024-12-03
808	2022	268500	184100	452600	2024-12-03
809	2025	194900	182800	377700	2024-12-03
809	2023	194900	182800	377700	2024-12-03
809	2022	194900	182800	377700	2024-12-03
810	2025	747800	259600	1007400	2024-12-03
810	2023	747800	259700	1007500	2024-12-03
810	2022	747800	259700	1007500	2024-12-03
811	2025	17300	214500	231800	2024-12-03
811	2023	17300	214800	232100	2024-12-03
811	2022	17300	214900	232200	2024-12-03
812	2025	225800	136400	362200	2024-12-03
812	2023	225800	136500	362300	2024-12-03
812	2022	261500	139900	401400	2024-12-03
814	2025	494100	176200	670300	2024-12-03
814	2023	494100	176200	670300	2024-12-03
814	2022	494100	176200	670300	2024-12-03
815	2025	378600	252100	630700	2024-12-03
815	2023	378600	252100	630700	2024-12-03
815	2022	378600	252100	630700	2024-12-03
816	2025	654900	222000	876900	2024-12-03
816	2023	641800	222100	863900	2024-12-03
816	2022	611800	222200	834000	2024-12-03
820	2025	954300	195000	1149300	2024-12-03
820	2023	954300	195200	1149500	2024-12-03
820	2022	954300	195200	1149500	2024-12-03
821	2025	0	1000	1000	2024-12-03
821	2023	0	1300	1300	2024-12-03
821	2022	0	1300	1300	2024-12-03
824	2025	38200	190600	228800	2024-12-03
824	2023	38200	190600	228800	2024-12-03
824	2022	38200	190600	228800	2024-12-03
826	2025	301900	206800	508700	2024-12-03
826	2023	301900	207100	509000	2024-12-03
826	2022	301900	207100	509000	2024-12-03
827	2025	749700	565300	1315000	2024-12-03
827	2023	749700	565900	1315600	2024-12-03
827	2022	749700	566000	1315700	2024-12-03
829	2025	393900	294900	688800	2024-12-03
829	2023	393900	294900	688800	2024-12-03
829	2022	393900	294900	688800	2024-12-03
830	2025	159900	138800	298700	2024-12-03
830	2023	159900	138800	298700	2024-12-03
830	2022	159900	138800	298700	2024-12-03
831	2025	1136400	699600	1836000	2024-12-03
831	2023	1136400	699600	1836000	2024-12-03
831	2022	1136400	699600	1836000	2024-12-03
832	2025	0	100800	100800	2024-12-03
832	2023	0	100800	100800	2024-12-03
832	2022	0	100800	100800	2024-12-03
833	2025	342900	180000	522900	2024-12-03
833	2023	342900	180000	522900	2024-12-03
833	2022	342900	180000	522900	2024-12-03
834	2025	156300	120200	276500	2024-12-03
834	2023	156300	120200	276500	2024-12-03
834	2022	156300	120200	276500	2024-12-03
835	2025	342000	236200	578200	2024-12-03
835	2023	342000	236200	578200	2024-12-03
835	2022	342000	236200	578200	2024-12-03
836	2025	0	18800	18800	2024-12-03
836	2023	0	18800	18800	2024-12-03
836	2022	0	18800	18800	2024-12-03
837	2025	499700	244700	744400	2024-12-03
837	2023	499700	244700	744400	2024-12-03
837	2022	498200	244700	742900	2024-12-03
838	2025	258600	142000	400600	2024-12-03
838	2023	258600	142000	400600	2024-12-03
838	2022	258600	142000	400600	2024-12-03
839	2025	534600	179500	714100	2024-12-03
839	2023	534600	179900	714500	2024-12-03
839	2022	534600	180000	714600	2024-12-03
840	2025	202100	137200	339300	2024-12-03
840	2023	127400	137200	264600	2024-12-03
840	2022	107300	130700	238000	2024-12-03
841	2025	543500	205900	749400	2024-12-03
841	2023	543500	205900	749400	2024-12-03
841	2022	543500	205900	749400	2024-12-03
842	2025	127100	93200	220300	2024-12-03
842	2023	127100	93200	220300	2024-12-03
842	2022	127100	93200	220300	2024-12-03
843	2025	83600	152200	235800	2024-12-03
843	2023	83600	152200	235800	2024-12-03
843	2022	83600	152200	235800	2024-12-03
844	2025	4300	87600	91900	2024-12-03
844	2023	4300	88700	93000	2024-12-03
844	2022	4300	88900	93200	2024-12-03
845	2025	211500	141600	353100	2024-12-03
845	2023	211500	141600	353100	2024-12-03
845	2022	211500	141600	353100	2024-12-03
846	2025	0	113800	113800	2024-12-03
846	2023	0	113800	113800	2024-12-03
846	2022	0	113800	113800	2024-12-03
849	2025	0	117700	117700	2024-12-03
849	2023	0	117700	117700	2024-12-03
849	2022	0	117700	117700	2024-12-03
850	2025	33500	152200	185700	2024-12-03
850	2023	33500	152200	185700	2024-12-03
850	2022	33500	152200	185700	2024-12-03
851	2025	1500	46200	47700	2024-12-03
851	2023	1500	46500	48000	2024-12-03
851	2022	1500	46500	48000	2024-12-03
852	2025	35100	139500	174600	2024-12-03
852	2023	35100	139500	174600	2024-12-03
852	2022	35100	139500	174600	2024-12-03
853	2025	79000	125500	204500	2024-12-03
853	2023	79000	125500	204500	2024-12-03
853	2022	79000	125500	204500	2024-12-03
855	2025	42800	128800	171600	2024-12-03
855	2023	42800	128800	171600	2024-12-03
855	2022	42800	128800	171600	2024-12-03
858	2025	0	8000	8000	2024-12-03
858	2023	0	8500	8500	2024-12-03
858	2022	0	8700	8700	2024-12-03
860	2025	0	4700	4700	2024-12-03
860	2023	0	7000	7000	2024-12-03
860	2022	0	7000	7000	2024-12-03
861	2025	203600	139000	342600	2024-12-03
861	2023	203600	139000	342600	2024-12-03
861	2022	203600	139000	342600	2024-12-03
862	2025	714100	334100	1048200	2024-12-03
862	2023	714100	334100	1048200	2024-12-03
862	2022	714100	334100	1048200	2024-12-03
863	2025	0	200	200	2024-12-03
863	2023	0	300	300	2024-12-03
863	2022	0	300	300	2024-12-03
864	2025	0	200	200	2024-12-03
864	2023	0	300	300	2024-12-03
864	2022	0	300	300	2024-12-03
865	2025	913800	227700	1141500	2024-12-03
865	2023	913800	228300	1142100	2024-12-03
865	2022	913800	228200	1142000	2024-12-03
867	2025	1064900	631700	1696600	2024-12-03
867	2023	1064900	632100	1697000	2024-12-03
867	2022	1064900	632100	1697000	2024-12-03
868	2025	314000	177100	491100	2024-12-03
868	2023	314000	177700	491700	2024-12-03
868	2022	314000	177800	491800	2024-12-03
869	2025	209700	155600	365300	2024-12-03
869	2023	209700	155600	365300	2024-12-03
869	2022	209700	155600	365300	2024-12-03
871	2025	367100	181500	548600	2024-12-03
871	2023	367100	181500	548600	2024-12-03
871	2022	367100	181500	548600	2024-12-03
872	2025	397900	202500	600400	2024-12-03
872	2023	397900	202600	600500	2024-12-03
872	2022	397900	202700	600600	2024-12-03
873	2025	522300	315900	838200	2024-12-03
873	2023	522300	318300	840600	2024-12-03
873	2022	522300	318800	841100	2024-12-03
874	2025	146500	300200	446700	2024-12-03
874	2023	146500	300200	446700	2024-12-03
874	2022	146500	300200	446700	2024-12-03
875	2025	434800	228300	663100	2024-12-03
875	2023	434800	228300	663100	2024-12-03
875	2022	434800	228300	663100	2024-12-03
876	2025	187900	263100	451000	2024-12-03
876	2023	187900	263400	451300	2024-12-03
876	2022	187900	263400	451300	2024-12-03
877	2025	468400	315800	784200	2024-12-03
877	2023	468400	315800	784200	2024-12-03
877	2022	468400	315800	784200	2024-12-03
878	2025	336300	335200	671500	2024-12-03
878	2023	326300	335900	662200	2024-12-03
878	2022	325900	336100	662000	2024-12-03
879	2025	183200	163900	347100	2024-12-03
879	2023	183200	164500	347700	2024-12-03
879	2022	183200	164700	347900	2024-12-03
880	2025	384400	181200	565600	2024-12-03
880	2023	384400	181600	566000	2024-12-03
880	2022	384400	181600	566000	2024-12-03
881	2025	1268800	289300	1558100	2024-12-03
881	2023	1268800	289500	1558300	2024-12-03
881	2022	1268800	289500	1558300	2024-12-03
883	2025	21300	51700	73000	2024-12-03
883	2023	21300	51700	73000	2024-12-03
883	2022	21300	51700	73000	2024-12-03
884	2025	191000	161200	352200	2024-12-03
884	2023	191000	161600	352600	2024-12-03
884	2022	191000	161500	352500	2024-12-03
887	2025	998100	361800	1359900	2024-12-03
887	2023	998100	362200	1360300	2024-12-03
887	2022	998100	362200	1360300	2024-12-03
888	2025	0	600	600	2024-12-03
888	2023	0	800	800	2024-12-03
888	2022	0	800	800	2024-12-03
891	2025	405300	113000	518300	2024-12-03
891	2023	405300	113200	518500	2024-12-03
891	2022	403600	113200	516800	2024-12-03
892	2025	0	4200	4200	2024-12-03
892	2023	0	5000	5000	2024-12-03
892	2022	0	155100	155100	2024-12-03
895	2025	786900	198200	985100	2024-12-03
895	2023	786900	198200	985100	2024-12-03
895	2022	786900	198200	985100	2024-12-03
896	2025	1117300	270000	1387300	2024-12-03
896	2023	1117300	270000	1387300	2024-12-03
896	2022	1117300	270000	1387300	2024-12-03
897	2025	0	6100	6100	2024-12-03
897	2023	0	6100	6100	2024-12-03
897	2022	0	6100	6100	2024-12-03
898	2025	0	900	900	2024-12-03
898	2023	0	1200	1200	2024-12-03
898	2022	0	1200	1200	2024-12-03
899	2025	597700	265500	863200	2024-12-03
899	2023	581100	266100	847200	2024-12-03
899	2022	581100	266100	847200	2024-12-03
900	2025	563900	440200	1004100	2024-12-03
900	2023	563900	440300	1004200	2024-12-03
900	2022	563900	440300	1004200	2024-12-03
901	2025	114200	178100	292300	2024-12-03
901	2023	114200	178100	292300	2024-12-03
901	2022	114200	178100	292300	2024-12-03
907	2025	0	400	400	2024-12-03
907	2023	0	700	700	2024-12-03
907	2022	0	700	700	2024-12-03
908	2025	0	3200	3200	2024-12-03
908	2023	0	3300	3300	2024-12-03
908	2022	0	3300	3300	2024-12-03
909	2025	1491200	636000	2127200	2024-12-03
909	2023	1264700	637200	1901900	2024-12-03
909	2022	1264700	637700	1902400	2024-12-03
910	2025	487700	250900	738600	2024-12-03
910	2023	487700	250900	738600	2024-12-03
910	2022	487700	250900	738600	2024-12-03
911	2025	420600	314800	735400	2024-12-03
911	2023	420600	317400	738000	2024-12-03
911	2022	420600	317400	738000	2024-12-03
912	2025	0	3700	3700	2024-12-03
912	2023	0	3700	3700	2024-12-03
912	2022	0	3700	3700	2024-12-03
913	2025	462100	149300	611400	2024-12-03
913	2023	277400	149300	426700	2024-12-03
913	2022	25900	149300	175200	2024-12-03
915	2025	133700	155800	289500	2024-12-03
915	2023	133700	155800	289500	2024-12-03
915	2022	133700	155800	289500	2024-12-03
916	2025	171000	178500	349500	2024-12-03
916	2023	171000	178500	349500	2024-12-03
916	2022	171000	178500	349500	2024-12-03
917	2025	250500	235300	485800	2024-12-03
917	2023	250500	235300	485800	2024-12-03
917	2022	250500	235300	485800	2024-12-03
920	2025	441800	268600	710400	2024-12-03
920	2023	441800	269200	711000	2024-12-03
920	2022	403900	269300	673200	2024-12-03
921	2025	302400	204800	507200	2024-12-03
921	2023	302400	205200	507600	2024-12-03
921	2022	302400	205200	507600	2024-12-03
923	2025	29900	171500	201400	2024-12-03
923	2023	29900	171500	201400	2024-12-03
923	2022	29900	171500	201400	2024-12-03
924	2025	0	3000	3000	2024-12-03
924	2023	0	3700	3700	2024-12-03
924	2022	0	6500	6500	2024-12-03
925	2025	0	400	400	2024-12-03
925	2023	0	400	400	2024-12-03
925	2022	0	400	400	2024-12-03
934	2025	0	1000	1000	2024-12-03
934	2023	0	1200	1200	2024-12-03
934	2022	0	1200	1200	2024-12-03
935	2025	458600	263000	721600	2024-12-03
935	2023	458600	263000	721600	2024-12-03
935	2022	458600	263000	721600	2024-12-03
939	2025	596300	244200	840500	2024-12-03
939	2023	596300	244800	841100	2024-12-03
939	2022	596300	245000	841300	2024-12-03
940	2025	442600	151900	594500	2024-12-03
940	2023	442600	152100	594700	2024-12-03
940	2022	432600	152100	584700	2024-12-03
941	2025	397900	168600	566500	2024-12-03
941	2023	397900	168600	566500	2024-12-03
941	2022	397900	168600	566500	2024-12-03
942	2025	402700	227300	630000	2024-12-03
942	2023	402700	227300	630000	2024-12-03
942	2022	402700	227300	630000	2024-12-03
943	2025	324200	261900	586100	2024-12-03
943	2023	324200	261900	586100	2024-12-03
943	2022	324200	261900	586100	2024-12-03
944	2025	331800	215900	547700	2024-12-03
944	2023	331800	216000	547800	2024-12-03
944	2022	331800	216000	547800	2024-12-03
947	2025	334800	143600	478400	2024-12-03
947	2023	334800	143600	478400	2024-12-03
947	2022	334800	143600	478400	2024-12-03
949	2025	425800	198800	624600	2024-12-03
949	2023	425800	200600	626400	2024-12-03
949	2022	423400	201100	624500	2024-12-03
951	2025	161600	106600	268200	2024-12-03
951	2023	161600	106600	268200	2024-12-03
951	2022	161600	106600	268200	2024-12-03
952	2025	122200	125500	247700	2024-12-03
952	2023	122200	125500	247700	2024-12-03
952	2022	122200	125500	247700	2024-12-03
953	2025	183800	126300	310100	2024-12-03
953	2023	183800	126300	310100	2024-12-03
953	2022	183800	126300	310100	2024-12-03
954	2025	134700	156100	290800	2024-12-03
954	2023	134700	156100	290800	2024-12-03
954	2022	134700	156100	290800	2024-12-03
955	2025	91100	124900	216000	2024-12-03
955	2023	91100	124900	216000	2024-12-03
955	2022	91100	124900	216000	2024-12-03
958	2025	311600	108600	420200	2024-12-03
958	2023	311600	108600	420200	2024-12-03
958	2022	311600	108600	420200	2024-12-03
959	2025	229100	112600	341700	2024-12-03
959	2023	229100	112600	341700	2024-12-03
959	2022	229100	112600	341700	2024-12-03
960	2025	209600	115100	324700	2024-12-03
960	2023	209600	115100	324700	2024-12-03
960	2022	209600	115100	324700	2024-12-03
961	2025	383800	243800	627600	2024-12-03
961	2023	383800	243800	627600	2024-12-03
961	2022	383800	243800	627600	2024-12-03
962	2025	371900	112400	484300	2024-12-03
962	2023	371900	112400	484300	2024-12-03
962	2022	371900	112400	484300	2024-12-03
963	2025	245600	239300	484900	2024-12-03
963	2023	245600	239300	484900	2024-12-03
963	2022	245600	239300	484900	2024-12-03
964	2025	0	211200	211200	2024-12-03
964	2023	0	211200	211200	2024-12-03
964	2022	0	211200	211200	2024-12-03
965	2025	528500	231100	759600	2024-12-03
965	2023	528500	231100	759600	2024-12-03
965	2022	528500	231100	759600	2024-12-03
966	2025	376200	166000	542200	2024-12-03
966	2023	376200	166000	542200	2024-12-03
966	2022	376200	166000	542200	2024-12-03
967	2025	467700	172900	640600	2024-12-03
967	2023	467700	172900	640600	2024-12-03
967	2022	467700	172900	640600	2024-12-03
968	2025	222600	161300	383900	2024-12-03
968	2023	234500	162300	396800	2024-12-03
968	2022	215000	162500	377500	2024-12-03
969	2025	143300	156100	299400	2024-12-03
969	2023	143300	156100	299400	2024-12-03
969	2022	143300	156100	299400	2024-12-03
971	2025	207900	172600	380500	2024-12-03
971	2023	207900	172600	380500	2024-12-03
971	2022	207900	172600	380500	2024-12-03
972	2025	0	1100	1100	2024-12-03
972	2023	0	1500	1500	2024-12-03
972	2022	0	1600	1600	2024-12-03
973	2025	253200	151600	404800	2024-12-03
973	2023	253200	151600	404800	2024-12-03
973	2022	253200	151600	404800	2024-12-03
974	2025	466700	181100	647800	2024-12-03
974	2023	466700	181400	648100	2024-12-03
974	2022	463100	181400	644500	2024-12-03
975	2025	0	600	600	2024-12-03
975	2023	0	800	800	2024-12-03
975	2022	0	900	900	2024-12-03
976	2025	261400	211800	473200	2024-12-03
976	2023	261400	211800	473200	2024-12-03
976	2022	261400	211800	473200	2024-12-03
977	2025	603500	192500	796000	2024-12-03
977	2023	603500	192500	796000	2024-12-03
977	2022	584200	192500	776700	2024-12-03
978	2025	26100	134100	160200	2024-12-03
978	2023	26100	134100	160200	2024-12-03
978	2022	26100	134100	160200	2024-12-03
979	2025	94700	130300	225000	2024-12-03
979	2023	94700	130300	225000	2024-12-03
979	2022	94700	130300	225000	2024-12-03
981	2025	270900	128900	399800	2024-12-03
981	2023	270900	128900	399800	2024-12-03
981	2022	270900	128900	399800	2024-12-03
982	2025	112400	137000	249400	2024-12-03
982	2023	112400	137000	249400	2024-12-03
982	2022	112400	137000	249400	2024-12-03
983	2025	12100	137300	149400	2024-12-03
983	2023	12100	137300	149400	2024-12-03
983	2022	12100	137300	149400	2024-12-03
984	2025	90800	118300	209100	2024-12-03
984	2023	90800	118300	209100	2024-12-03
984	2022	90800	118300	209100	2024-12-03
986	2025	107000	139600	246600	2024-12-03
986	2023	107000	139600	246600	2024-12-03
986	2022	107000	139600	246600	2024-12-03
987	2025	258800	161700	420500	2024-12-03
987	2023	258800	163600	422400	2024-12-03
987	2022	258800	164100	422900	2024-12-03
990	2025	4100	900	5000	2024-12-03
990	2023	4100	1100	5200	2024-12-03
990	2022	4100	1100	5200	2024-12-03
991	2025	77800	131000	208800	2024-12-03
991	2023	77800	131000	208800	2024-12-03
991	2022	77800	131000	208800	2024-12-03
992	2025	0	9200	9200	2024-12-03
992	2023	0	12800	12800	2024-12-03
992	2022	0	13500	13500	2024-12-03
993	2025	226300	135900	362200	2024-12-03
993	2023	226300	135900	362200	2024-12-03
993	2022	226300	135900	362200	2024-12-03
994	2025	145200	171100	316300	2024-12-03
994	2023	145200	171100	316300	2024-12-03
994	2022	145200	171100	316300	2024-12-03
995	2025	165900	84200	250100	2024-12-03
995	2023	165900	84200	250100	2024-12-03
995	2022	165900	84200	250100	2024-12-03
996	2025	336100	186700	522800	2024-12-03
996	2023	336100	186700	522800	2024-12-03
996	2022	336100	186700	522800	2024-12-03
997	2025	212500	160700	373200	2024-12-03
997	2023	212500	160700	373200	2024-12-03
997	2022	212500	160700	373200	2024-12-03
998	2025	442600	211600	654200	2024-12-03
998	2023	442600	212100	654700	2024-12-03
998	2022	442600	212200	654800	2024-12-03
1002	2025	0	3600	3600	2024-12-03
1002	2023	0	4700	4700	2024-12-03
1002	2022	0	4800	4800	2024-12-03
1003	2025	291800	166200	458000	2024-12-03
1003	2023	178600	166900	345500	2024-12-03
1003	2022	167600	166900	334500	2024-12-03
1004	2025	370900	175200	546100	2024-12-03
1004	2023	370900	175200	546100	2024-12-03
1004	2022	370900	175200	546100	2024-12-03
1005	2025	348300	184800	533100	2024-12-03
1005	2023	348300	184800	533100	2024-12-03
1005	2022	348300	184800	533100	2024-12-03
1006	2025	131500	140300	271800	2024-12-03
1006	2023	131500	140300	271800	2024-12-03
1006	2022	131500	140300	271800	2024-12-03
1009	2025	0	9800	9800	2024-12-03
1009	2023	0	10700	10700	2024-12-03
1009	2022	0	10800	10800	2024-12-03
1015	2025	56500	122100	178600	2024-12-03
1015	2023	56500	122100	178600	2024-12-03
1015	2022	56500	122100	178600	2024-12-03
1016	2025	122600	155100	277700	2024-12-03
1016	2023	122600	155100	277700	2024-12-03
1016	2022	122600	155100	277700	2024-12-03
1018	2025	43400	94400	137800	2024-12-03
1018	2023	43400	94500	137900	2024-12-03
1018	2022	43400	94600	138000	2024-12-03
1019	2025	265300	163000	428300	2024-12-03
1019	2023	265300	163000	428300	2024-12-03
1019	2022	265300	163000	428300	2024-12-03
1020	2025	81200	169000	250200	2024-12-03
1020	2023	81200	169000	250200	2024-12-03
1020	2022	81200	169000	250200	2024-12-03
1022	2025	370500	181800	552300	2024-12-03
1022	2023	370500	182300	552800	2024-12-03
1022	2022	370500	182300	552800	2024-12-03
1023	2025	160500	195700	356200	2024-12-03
1023	2023	160500	195700	356200	2024-12-03
1023	2022	160500	195700	356200	2024-12-03
1024	2025	142900	148400	291300	2024-12-03
1024	2023	142900	148400	291300	2024-12-03
1024	2022	142900	148400	291300	2024-12-03
1025	2025	296500	202000	498500	2024-12-03
1025	2023	296500	202000	498500	2024-12-03
1025	2022	296500	202000	498500	2024-12-03
1026	2025	261400	176100	437500	2024-12-03
1026	2023	261400	176100	437500	2024-12-03
1026	2022	261400	176100	437500	2024-12-03
1027	2025	0	14000	14000	2024-12-03
1027	2023	0	19900	19900	2024-12-03
1027	2022	0	19100	19100	2024-12-03
1028	2025	0	12200	12200	2024-12-03
1028	2023	0	12200	12200	2024-12-03
1028	2022	0	12200	12200	2024-12-03
1030	2025	368900	264300	633200	2024-12-03
1030	2023	368900	264300	633200	2024-12-03
1030	2022	368900	264300	633200	2024-12-03
1031	2025	145000	141500	286500	2024-12-03
1031	2023	145000	141600	286600	2024-12-03
1031	2022	145000	141700	286700	2024-12-03
1033	2025	313200	178300	491500	2024-12-03
1033	2023	298200	179500	477700	2024-12-03
1033	2022	298200	179500	477700	2024-12-03
1034	2025	17100	16200	33300	2024-12-03
1034	2023	17100	16600	33700	2024-12-03
1034	2022	17100	16600	33700	2024-12-03
1035	2025	162400	251800	414200	2024-12-03
1035	2023	162400	251800	414200	2024-12-03
1035	2022	162400	251800	414200	2024-12-03
1037	2025	53700	226100	279800	2024-12-03
1037	2023	53700	226100	279800	2024-12-03
1037	2022	53700	226100	279800	2024-12-03
1038	2025	114400	97000	211400	2024-12-03
1038	2023	114400	97000	211400	2024-12-03
1038	2022	114400	97000	211400	2024-12-03
1039	2025	0	4500	4500	2024-12-03
1039	2023	0	6400	6400	2024-12-03
1039	2022	0	6000	6000	2024-12-03
1040	2025	404300	143100	547400	2024-12-03
1040	2023	404300	143100	547400	2024-12-03
1040	2022	391100	143100	534200	2024-12-03
1041	2025	348600	147700	496300	2024-12-03
1041	2023	348600	147700	496300	2024-12-03
1041	2022	348600	147700	496300	2024-12-03
1042	2025	245800	152800	398600	2024-12-03
1042	2023	245800	152800	398600	2024-12-03
1042	2022	245800	152800	398600	2024-12-03
1043	2025	125600	100500	226100	2024-12-03
1043	2023	125600	100500	226100	2024-12-03
1043	2022	125600	100500	226100	2024-12-03
1045	2025	68200	105400	173600	2024-12-03
1045	2023	68200	105400	173600	2024-12-03
1045	2022	68200	105400	173600	2024-12-03
1046	2025	128000	131300	259300	2024-12-03
1046	2023	128000	131300	259300	2024-12-03
1046	2022	128000	131300	259300	2024-12-03
1048	2025	0	4400	4400	2024-12-03
1048	2023	0	4400	4400	2024-12-03
1048	2022	0	4400	4400	2024-12-03
1049	2025	31100	161400	192500	2024-12-03
1049	2023	31100	161400	192500	2024-12-03
1049	2022	31100	161400	192500	2024-12-03
1051	2025	90000	147200	237200	2024-12-03
1051	2023	73600	147200	220800	2024-12-03
1051	2022	73600	147200	220800	2024-12-03
1052	2025	118300	135600	253900	2024-12-03
1052	2023	118300	136100	254400	2024-12-03
1052	2022	118300	136000	254300	2024-12-03
1053	2025	859100	326200	1185300	2024-12-03
1053	2023	859100	327700	1186800	2024-12-03
1053	2022	859100	328400	1187500	2024-12-03
1054	2025	1622000	407400	2029400	2024-12-03
1054	2023	1622000	407500	2029500	2024-12-03
1054	2022	1622000	407700	2029700	2024-12-03
1055	2025	0	11400	11400	2024-12-03
1055	2023	0	16800	16800	2024-12-03
1055	2022	0	16900	16900	2024-12-03
1057	2025	0	1300	1300	2024-12-03
1057	2023	0	1800	1800	2024-12-03
1057	2022	0	1700	1700	2024-12-03
1058	2025	9400	16400	25800	2024-12-03
1058	2023	9400	16900	26300	2024-12-03
1058	2022	9400	17000	26400	2024-12-03
1060	2025	956300	192500	1148800	2024-12-03
1060	2023	952200	193100	1145300	2024-12-03
1060	2022	952200	193100	1145300	2024-12-03
1061	2025	132200	194200	326400	2024-12-03
1061	2023	132200	194200	326400	2024-12-03
1061	2022	132200	194200	326400	2024-12-03
1064	2025	536700	154300	691000	2024-12-03
1064	2023	536700	155400	692100	2024-12-03
1064	2022	536700	155500	692200	2024-12-03
1068	2025	620900	192800	813700	2024-12-03
1068	2023	620900	193300	814200	2024-12-03
1068	2022	620900	192600	813500	2024-12-03
1069	2025	0	1500	1500	2024-12-03
1069	2023	0	1600	1600	2024-12-03
1069	2022	0	1600	1600	2024-12-03
1070	2025	62100	169800	231900	2024-12-03
1070	2023	62100	169800	231900	2024-12-03
1070	2022	62100	169800	231900	2024-12-03
1071	2025	496200	139200	635400	2024-12-03
1071	2023	496200	139200	635400	2024-12-03
1071	2022	496200	139200	635400	2024-12-03
1076	2025	0	4000	4000	2024-12-03
1076	2023	0	5100	5100	2024-12-03
1076	2022	0	5300	5300	2024-12-03
1077	2025	0	23400	23400	2024-12-03
1077	2023	0	29800	29800	2024-12-03
1077	2022	0	30700	30700	2024-12-03
1078	2025	200900	103900	304800	2024-12-03
1078	2023	200900	103900	304800	2024-12-03
1078	2022	200900	103900	304800	2024-12-03
1079	2025	0	100	100	2024-12-03
1079	2023	0	100	100	2024-12-03
1079	2022	0	100	100	2024-12-03
1081	2025	0	100	100	2024-12-03
1081	2023	0	100	100	2024-12-03
1081	2022	0	100	100	2024-12-03
1082	2025	33700	95900	129600	2024-12-03
1082	2023	33700	95900	129600	2024-12-03
1082	2022	33700	95900	129600	2024-12-03
1083	2025	0	3000	3000	2024-12-03
1083	2023	0	4000	4000	2024-12-03
1083	2022	0	3900	3900	2024-12-03
1084	2025	0	100	100	2024-12-03
1084	2023	0	100	100	2024-12-03
1084	2022	0	100	100	2024-12-03
1085	2025	0	1000	1000	2024-12-03
1085	2023	0	1400	1400	2024-12-03
1085	2022	0	1300	1300	2024-12-03
1087	2025	0	83500	83500	2024-12-03
1087	2023	0	83500	83500	2024-12-03
1087	2022	0	83500	83500	2024-12-03
1091	2025	80800	145200	226000	2024-12-03
1091	2023	80800	145200	226000	2024-12-03
1091	2022	80800	145200	226000	2024-12-03
1092	2025	309500	161300	470800	2024-12-03
1092	2023	309500	161300	470800	2024-12-03
1092	2022	309500	161300	470800	2024-12-03
1093	2025	0	139200	139200	2024-12-03
1093	2023	0	139200	139200	2024-12-03
1093	2022	0	139200	139200	2024-12-03
1094	2025	179900	240600	420500	2024-12-03
1094	2023	179900	240600	420500	2024-12-03
1094	2022	179900	240600	420500	2024-12-03
1096	2025	1589900	318000	1907900	2024-12-03
1096	2023	1589900	318800	1908700	2024-12-03
1096	2022	1589900	319000	1908900	2024-12-03
1097	2025	0	4800	4800	2024-12-03
1097	2023	0	900	900	2024-12-03
1097	2022	0	900	900	2024-12-03
1099	2025	269700	194800	464500	2024-12-03
1099	2023	269700	194800	464500	2024-12-03
1099	2022	257600	194800	452400	2024-12-03
1101	2025	176500	127400	303900	2024-12-03
1101	2023	176500	127400	303900	2024-12-03
1101	2022	176500	127400	303900	2024-12-03
1102	2025	94200	134800	229000	2024-12-03
1102	2023	94200	134800	229000	2024-12-03
1102	2022	94200	134800	229000	2024-12-03
1103	2025	0	2100	2100	2024-12-03
1103	2023	0	2900	2900	2024-12-03
1103	2022	0	3100	3100	2024-12-03
1104	2025	535000	189400	724400	2024-12-03
1104	2023	535000	189900	724900	2024-12-03
1104	2022	535000	189900	724900	2024-12-03
1105	2025	538000	187300	725300	2024-12-03
1105	2023	538000	187500	725500	2024-12-03
1105	2022	538000	187500	725500	2024-12-03
1109	2025	653900	214100	868000	2024-12-03
1109	2023	653900	214500	868400	2024-12-03
1109	2022	653900	214600	868500	2024-12-03
1111	2025	0	128800	128800	2024-12-03
1111	2023	0	128800	128800	2024-12-03
1111	2022	0	128800	128800	2024-12-03
1112	2025	196600	168700	365300	2024-12-03
1112	2023	196600	168700	365300	2024-12-03
1112	2022	196600	168700	365300	2024-12-03
1113	2025	73200	221300	294500	2024-12-03
1113	2023	73200	222800	296000	2024-12-03
1113	2022	73200	222800	296000	2024-12-03
1118	2025	204900	130200	335100	2024-12-03
1118	2023	204900	130200	335100	2024-12-03
1118	2022	204900	130200	335100	2024-12-03
1120	2025	370500	163600	534100	2024-12-03
1120	2023	370500	163700	534200	2024-12-03
1120	2022	370500	163700	534200	2024-12-03
1121	2025	233400	148900	382300	2024-12-03
1121	2023	221000	148900	369900	2024-12-03
1121	2022	221000	148900	369900	2024-12-03
1122	2025	27800	97300	125100	2024-12-03
1122	2023	27800	97300	125100	2024-12-03
1122	2022	27800	97300	125100	2024-12-03
1123	2025	37100	140400	177500	2024-12-03
1123	2023	37100	140400	177500	2024-12-03
1123	2022	37100	140400	177500	2024-12-03
1124	2025	39500	95000	134500	2024-12-03
1124	2023	39500	95000	134500	2024-12-03
1124	2022	39500	95000	134500	2024-12-03
1125	2025	27000	50400	77400	2024-12-03
1125	2023	27000	50400	77400	2024-12-03
1125	2022	27000	50400	77400	2024-12-03
1126	2025	194300	103600	297900	2024-12-03
1126	2023	194300	103600	297900	2024-12-03
1126	2022	194300	103600	297900	2024-12-03
1127	2025	50200	120100	170300	2024-12-03
1127	2023	50200	120200	170400	2024-12-03
1127	2022	50200	120200	170400	2024-12-03
1129	2025	0	100	100	2024-12-03
1129	2023	0	100	100	2024-12-03
1129	2022	0	100	100	2024-12-03
1131	2025	54200	117800	172000	2024-12-03
1131	2023	54200	119000	173200	2024-12-03
1131	2022	54200	119100	173300	2024-12-03
1132	2025	605600	162700	768300	2024-12-03
1132	2023	605600	164700	770300	2024-12-03
1132	2022	605600	163900	769500	2024-12-03
1133	2025	121200	111300	232500	2024-12-03
1133	2023	121200	111300	232500	2024-12-03
1133	2022	121200	111300	232500	2024-12-03
1136	2025	82700	92300	175000	2024-12-03
1136	2023	82700	92300	175000	2024-12-03
1136	2022	82700	92300	175000	2024-12-03
1137	2025	26500	75000	101500	2024-12-03
1137	2023	26500	75000	101500	2024-12-03
1137	2022	26500	75000	101500	2024-12-03
1138	2025	40000	46500	86500	2024-12-03
1138	2023	40000	46500	86500	2024-12-03
1138	2022	40000	46500	86500	2024-12-03
1140	2025	258000	150300	408300	2024-12-03
1140	2023	233000	150300	383300	2024-12-03
1140	2022	233000	150300	383300	2024-12-03
1141	2025	0	3300	3300	2024-12-03
1141	2023	0	3300	3300	2024-12-03
1141	2022	0	3300	3300	2024-12-03
1142	2025	298500	151900	450400	2024-12-03
1142	2023	298500	151900	450400	2024-12-03
1142	2022	252600	151900	404500	2024-12-03
1144	2025	380000	145300	525300	2024-12-03
1144	2023	380000	145700	525700	2024-12-03
1144	2022	380000	145800	525800	2024-12-03
1149	2025	164600	169800	334400	2024-12-03
1149	2023	164600	169900	334500	2024-12-03
1149	2022	164600	169900	334500	2024-12-03
1150	2025	195100	190700	385800	2024-12-03
1150	2023	195100	190700	385800	2024-12-03
1150	2022	195100	190700	385800	2024-12-03
1151	2025	0	347500	347500	2024-12-03
1151	2023	0	347500	347500	2024-12-03
1151	2022	0	347500	347500	2024-12-03
1152	2025	0	3200	3200	2024-12-03
1152	2023	0	4700	4700	2024-12-03
1152	2022	0	4800	4800	2024-12-03
1154	2025	0	100400	100400	2024-12-03
1154	2023	0	100400	100400	2024-12-03
1154	2022	0	100400	100400	2024-12-03
1155	2025	0	700	700	2024-12-03
1155	2023	0	1100	1100	2024-12-03
1155	2022	0	1100	1100	2024-12-03
1156	2025	343100	149500	492600	2024-12-03
1156	2023	343100	149800	492900	2024-12-03
1156	2022	343100	149700	492800	2024-12-03
1157	2025	77200	124800	202000	2024-12-03
1157	2023	77200	125100	202300	2024-12-03
1157	2022	77200	125100	202300	2024-12-03
1158	2025	0	3000	3000	2024-12-03
1158	2023	0	4100	4100	2024-12-03
1158	2022	0	4400	4400	2024-12-03
1163	2025	0	2400	2400	2024-12-03
1163	2023	0	3500	3500	2024-12-03
1163	2022	0	3600	3600	2024-12-03
1164	2025	0	69700	69700	2024-12-03
1164	2023	0	95100	95100	2024-12-03
1164	2022	0	102500	102500	2024-12-03
1165	2025	70600	85100	155700	2024-12-03
1165	2023	70600	85100	155700	2024-12-03
1165	2022	70500	85100	155600	2024-12-03
1166	2025	185000	154900	339900	2024-12-03
1166	2023	185000	154900	339900	2024-12-03
1166	2022	182400	154900	337300	2024-12-03
1167	2025	156100	142600	298700	2024-12-03
1167	2023	156100	142600	298700	2024-12-03
1167	2022	154000	142600	296600	2024-12-03
1169	2025	527000	191000	718000	2024-12-03
1169	2023	527000	191300	718300	2024-12-03
1169	2022	527000	191300	718300	2024-12-03
1170	2025	267100	171200	438300	2024-12-03
1170	2023	267100	171700	438800	2024-12-03
1170	2022	261600	171800	433400	2024-12-03
1171	2025	0	900	900	2024-12-03
1171	2023	0	1200	1200	2024-12-03
1171	2022	0	1200	1200	2024-12-03
1173	2025	58600	122700	181300	2024-12-03
1173	2023	58600	124100	182700	2024-12-03
1173	2022	58600	123700	182300	2024-12-03
1177	2025	0	10500	10500	2024-12-03
1177	2023	0	13300	13300	2024-12-03
1177	2022	0	13700	13700	2024-12-03
1186	2025	0	900	900	2024-12-03
1186	2023	0	1200	1200	2024-12-03
1186	2022	0	1200	1200	2024-12-03
1187	2025	0	400	400	2024-12-03
1187	2023	0	500	500	2024-12-03
1187	2022	0	500	500	2024-12-03
1188	2025	520600	166100	686700	2024-12-03
1188	2023	500600	167300	667900	2024-12-03
1188	2022	477000	167100	644100	2024-12-03
1189	2025	0	4600	4600	2024-12-03
1189	2023	0	6500	6500	2024-12-03
1189	2022	0	6800	6800	2024-12-03
1190	2025	1200	113100	114300	2024-12-03
1190	2023	1200	113100	114300	2024-12-03
1190	2022	1200	113100	114300	2024-12-03
1191	2025	0	110100	110100	2024-12-03
1191	2023	0	110100	110100	2024-12-03
1191	2022	0	110100	110100	2024-12-03
1192	2025	0	22300	22300	2024-12-03
1192	2023	0	22300	22300	2024-12-03
1192	2022	0	22300	22300	2024-12-03
1193	2025	0	77500	77500	2024-12-03
1193	2023	0	77500	77500	2024-12-03
1193	2022	0	77500	77500	2024-12-03
1195	2025	318700	160200	478900	2024-12-03
1195	2023	318700	160200	478900	2024-12-03
1195	2022	318700	160200	478900	2024-12-03
1196	2025	328700	168700	497400	2024-12-03
1196	2023	328700	168700	497400	2024-12-03
1196	2022	325600	168700	494300	2024-12-03
1197	2025	4300	63600	67900	2024-12-03
1197	2023	4300	63600	67900	2024-12-03
1197	2022	4300	63600	67900	2024-12-03
1198	2025	0	0	0	2024-12-03
1198	2023	0	0	0	2024-12-03
1198	2022	0	0	0	2024-12-03
1199	2025	119900	138500	258400	2024-12-03
1199	2023	119900	138500	258400	2024-12-03
1199	2022	119800	138500	258300	2024-12-03
1200	2025	168200	130700	298900	2024-12-03
1200	2023	168200	130700	298900	2024-12-03
1200	2022	165800	130700	296500	2024-12-03
1201	2025	272000	138100	410100	2024-12-03
1201	2023	272000	138100	410100	2024-12-03
1201	2022	284500	138100	422600	2024-12-03
1202	2025	296000	138100	434100	2024-12-03
1202	2023	296000	138100	434100	2024-12-03
1202	2022	294100	138100	432200	2024-12-03
1203	2025	201400	138100	339500	2024-12-03
1203	2023	189600	138100	327700	2024-12-03
1203	2022	189100	138100	327200	2024-12-03
1204	2025	190600	145500	336100	2024-12-03
1204	2023	190600	145500	336100	2024-12-03
1204	2022	187600	145500	333100	2024-12-03
1206	2025	0	625400	625400	2024-12-03
1206	2023	0	625400	625400	2024-12-03
1206	2022	0	625400	625400	2024-12-03
1207	2025	0	16100	16100	2024-12-03
1207	2023	0	16100	16100	2024-12-03
1207	2022	0	16100	16100	2024-12-03
1208	2025	299400	162800	462200	2024-12-03
1208	2023	299400	162800	462200	2024-12-03
1208	2022	293700	162800	456500	2024-12-03
1209	2025	300400	199500	499900	2024-12-03
1209	2023	300400	199500	499900	2024-12-03
1209	2022	294100	199500	493600	2024-12-03
1211	2025	118500	167700	286200	2024-12-03
1211	2023	118500	167700	286200	2024-12-03
1211	2022	116300	167700	284000	2024-12-03
1212	2025	474700	190000	664700	2024-12-03
1212	2023	474700	190000	664700	2024-12-03
1212	2022	474700	190000	664700	2024-12-03
1213	2025	400100	189300	589400	2024-12-03
1213	2023	400100	189300	589400	2024-12-03
1213	2022	390400	189300	579700	2024-12-03
1214	2025	0	100	100	2024-12-03
1214	2023	0	200	200	2024-12-03
1214	2022	0	200	200	2024-12-03
1215	2025	0	3400	3400	2024-12-03
1215	2023	0	5000	5000	2024-12-03
1215	2022	0	5000	5000	2024-12-03
1222	2025	537800	195300	733100	2024-12-03
1222	2023	479600	195700	675300	2024-12-03
1222	2022	428200	195800	624000	2024-12-03
1223	2025	0	5800	5800	2024-12-03
1223	2023	0	7300	7300	2024-12-03
1223	2022	0	7600	7600	2024-12-03
1225	2025	345500	210900	556400	2024-12-03
1225	2023	224600	171400	396000	2024-12-03
1225	2022	222900	171500	394400	2024-12-03
1226	2025	857800	457500	1315300	2024-12-03
1226	2023	857800	458500	1316300	2024-12-03
1226	2022	831300	458400	1289700	2024-12-03
1227	2025	425300	148400	573700	2024-12-03
1227	2023	425300	148800	574100	2024-12-03
1227	2022	425300	149000	574300	2024-12-03
1228	2025	161900	167500	329400	2024-12-03
1228	2023	161900	168600	330500	2024-12-03
1228	2022	162200	168600	330800	2024-12-03
1229	2025	34700	33100	67800	2024-12-03
1229	2023	34700	33200	67900	2024-12-03
1229	2022	34700	33200	67900	2024-12-03
1230	2025	358300	134500	492800	2024-12-03
1230	2023	358300	135100	493400	2024-12-03
1230	2022	358200	135200	493400	2024-12-03
1232	2025	155200	147100	302300	2024-12-03
1232	2023	155200	147100	302300	2024-12-03
1232	2022	156500	147100	303600	2024-12-03
1233	2025	304300	176600	480900	2024-12-03
1233	2023	304300	176600	480900	2024-12-03
1233	2022	304300	176600	480900	2024-12-03
1234	2025	132600	136700	269300	2024-12-03
1234	2023	132600	136700	269300	2024-12-03
1234	2022	129400	136700	266100	2024-12-03
1235	2025	114400	120800	235200	2024-12-03
1235	2023	114400	120800	235200	2024-12-03
1235	2022	114800	120800	235600	2024-12-03
1236	2025	65700	143200	208900	2024-12-03
1236	2023	65700	143200	208900	2024-12-03
1236	2022	66500	143200	209700	2024-12-03
1243	2025	0	2900	2900	2024-12-03
1243	2023	0	3300	3300	2024-12-03
1243	2022	0	3400	3400	2024-12-03
1247	2025	520900	281300	802200	2024-12-03
1247	2023	520900	281700	802600	2024-12-03
1247	2022	510900	281800	792700	2024-12-03
1248	2025	521400	235100	756500	2024-12-03
1248	2023	521400	235400	756800	2024-12-03
1248	2022	455900	235400	691300	2024-12-03
1249	2025	176800	414100	590900	2024-12-03
1249	2023	176800	414100	590900	2024-12-03
1249	2022	176600	414100	590700	2024-12-03
1250	2025	281200	168700	449900	2024-12-03
1250	2023	281200	168700	449900	2024-12-03
1250	2022	278300	168700	447000	2024-12-03
1251	2025	457700	129900	587600	2024-12-03
1251	2023	457700	129900	587600	2024-12-03
1251	2022	457500	129900	587400	2024-12-03
1255	2025	368200	157800	526000	2024-12-03
1255	2023	368200	157800	526000	2024-12-03
1255	2022	363500	157800	521300	2024-12-03
1256	2025	240200	140300	380500	2024-12-03
1256	2023	240200	140300	380500	2024-12-03
1256	2022	238500	140300	378800	2024-12-03
1257	2025	149800	130700	280500	2024-12-03
1257	2023	149800	130700	280500	2024-12-03
1257	2022	149000	130700	279700	2024-12-03
1263	2025	156000	169800	325800	2024-12-03
1263	2023	156000	170300	326300	2024-12-03
1263	2022	156000	170500	326500	2024-12-03
1265	2025	256800	146600	403400	2024-12-03
1265	2023	256800	146600	403400	2024-12-03
1265	2022	255500	146600	402100	2024-12-03
1266	2025	338200	173300	511500	2024-12-03
1266	2023	338200	173300	511500	2024-12-03
1266	2022	324100	173300	497400	2024-12-03
1267	2025	278700	149300	428000	2024-12-03
1267	2023	278700	149300	428000	2024-12-03
1267	2022	278100	149300	427400	2024-12-03
1268	2025	21400	118300	139700	2024-12-03
1268	2023	21400	118300	139700	2024-12-03
1268	2022	21400	118300	139700	2024-12-03
1269	2025	184700	136600	321300	2024-12-03
1269	2023	184700	136800	321500	2024-12-03
1269	2022	184700	136800	321500	2024-12-03
1270	2025	0	5200	5200	2024-12-03
1270	2023	0	5200	5200	2024-12-03
1270	2022	0	5200	5200	2024-12-03
1271	2025	312500	150800	463300	2024-12-03
1271	2023	312500	150800	463300	2024-12-03
1271	2022	312500	150800	463300	2024-12-03
1272	2025	389400	150500	539900	2024-12-03
1272	2023	389400	151500	540900	2024-12-03
1272	2022	389400	151700	541100	2024-12-03
1274	2025	305400	168100	473500	2024-12-03
1274	2023	305400	168100	473500	2024-12-03
1274	2022	312200	168100	480300	2024-12-03
1277	2025	0	9400	9400	2024-12-03
1277	2023	0	13700	13700	2024-12-03
1277	2022	0	13900	13900	2024-12-03
1282	2025	0	304600	304600	2024-12-03
1282	2023	0	304600	304600	2024-12-03
1282	2022	0	304600	304600	2024-12-03
1289	2025	0	2500	2500	2024-12-03
1289	2023	0	2600	2600	2024-12-03
1289	2022	0	2600	2600	2024-12-03
1291	2025	0	300	300	2024-12-03
1291	2023	0	400	400	2024-12-03
1291	2022	0	400	400	2024-12-03
1292	2025	0	186800	186800	2024-12-03
1292	2023	0	186800	186800	2024-12-03
1292	2022	0	186800	186800	2024-12-03
1298	2025	1015500	171100	1186600	2024-12-03
1298	2023	1015500	171500	1187000	2024-12-03
1298	2022	1014200	171600	1185800	2024-12-03
1299	2025	334900	124400	459300	2024-12-03
1299	2023	334900	124400	459300	2024-12-03
1299	2022	329400	124400	453800	2024-12-03
1302	2025	0	191600	191600	2024-12-03
1302	2023	0	191600	191600	2024-12-03
1302	2022	0	191600	191600	2024-12-03
1304	2025	830300	1097500	1927800	2024-12-03
1304	2023	830300	1101100	1931400	2024-12-03
1304	2022	830300	1101600	1931900	2024-12-03
1305	2025	3697300	337000	4034300	2024-12-03
1305	2023	3697300	337000	4034300	2024-12-03
1305	2022	3697300	337000	4034300	2024-12-03
1309	2025	0	3600	3600	2024-12-03
1309	2023	0	5000	5000	2024-12-03
1309	2022	0	5200	5200	2024-12-03
1311	2025	441600	237500	679100	2024-12-03
1311	2023	441600	237500	679100	2024-12-03
1311	2022	441600	237500	679100	2024-12-03
1312	2025	0	778800	778800	2024-12-03
1312	2023	0	778800	778800	2024-12-03
1312	2022	0	778800	778800	2024-12-03
1313	2025	266300	133400	399700	2024-12-03
1313	2023	266300	133800	400100	2024-12-03
1313	2022	241900	133700	375600	2024-12-03
1319	2025	5700	17000	22700	2024-12-03
1319	2023	5700	17400	23100	2024-12-03
1319	2022	5700	17500	23200	2024-12-03
1323	2025	405400	163300	568700	2024-12-03
1323	2023	405400	163300	568700	2024-12-03
1323	2022	402700	163300	566000	2024-12-03
1325	2025	239400	252600	492000	2024-12-03
1325	2023	224400	252600	477000	2024-12-03
1325	2022	207200	252600	459800	2024-12-03
1326	2025	788400	259700	1048100	2024-12-03
1326	2023	788400	260100	1048500	2024-12-03
1326	2022	780700	260200	1040900	2024-12-03
1327	2025	0	435200	435200	2024-12-03
1327	2023	0	435200	435200	2024-12-03
1327	2022	0	435200	435200	2024-12-03
1332	2025	0	2000	2000	2024-12-03
1332	2023	0	2600	2600	2024-12-03
1332	2022	0	2700	2700	2024-12-03
1333	2025	527300	223600	750900	2024-12-03
1333	2023	527300	223900	751200	2024-12-03
1333	2022	527300	224000	751300	2024-12-03
1335	2025	308200	254700	562900	2024-12-03
1335	2023	308200	254700	562900	2024-12-03
1335	2022	307900	254700	562600	2024-12-03
1336	2025	0	5500	5500	2024-12-03
1336	2023	0	6900	6900	2024-12-03
1336	2022	0	7000	7000	2024-12-03
1337	2025	0	600	600	2024-12-03
1337	2023	0	800	800	2024-12-03
1337	2022	0	800	800	2024-12-03
1338	2025	547800	178300	726100	2024-12-03
1338	2023	547800	178300	726100	2024-12-03
1338	2022	546500	178300	724800	2024-12-03
1340	2025	225000	195500	420500	2024-12-03
1340	2023	225000	195500	420500	2024-12-03
1340	2022	225000	195500	420500	2024-12-03
1341	2025	632100	202500	834600	2024-12-03
1341	2023	632100	202500	834600	2024-12-03
1341	2022	644800	202500	847300	2024-12-03
1342	2025	456000	230800	686800	2024-12-03
1342	2023	456000	230800	686800	2024-12-03
1342	2022	456000	230800	686800	2024-12-03
1343	2025	104100	198500	302600	2024-12-03
1343	2023	104100	198500	302600	2024-12-03
1343	2022	100700	198500	299200	2024-12-03
1344	2025	544800	277500	822300	2024-12-03
1344	2023	544800	278800	823600	2024-12-03
1344	2022	518400	278300	796700	2024-12-03
1352	2025	310500	234700	545200	2024-12-03
1352	2023	310500	235000	545500	2024-12-03
1352	2022	280600	235100	515700	2024-12-03
1353	2025	725400	254800	980200	2024-12-03
1353	2023	725400	255300	980700	2024-12-03
1353	2022	716800	255300	972100	2024-12-03
1354	2025	328100	345100	673200	2024-12-03
1354	2023	328100	345100	673200	2024-12-03
1354	2022	328100	345100	673200	2024-12-03
1355	2025	0	5700	5700	2024-12-03
1355	2023	0	7700	7700	2024-12-03
1355	2022	0	7500	7500	2024-12-03
1356	2025	0	52100	52100	2024-12-03
1356	2023	0	60500	60500	2024-12-03
1356	2022	0	59500	59500	2024-12-03
1358	2025	0	1400	1400	2024-12-03
1358	2023	0	1800	1800	2024-12-03
1358	2022	0	1900	1900	2024-12-03
1360	2025	0	9500	9500	2024-12-03
1360	2023	0	12500	12500	2024-12-03
1360	2022	0	12400	12400	2024-12-03
1361	2025	0	2300	2300	2024-12-03
1361	2023	0	2900	2900	2024-12-03
1361	2022	0	3000	3000	2024-12-03
1362	2025	0	13500	13500	2024-12-03
1362	2023	0	14700	14700	2024-12-03
1362	2022	0	14700	14700	2024-12-03
1363	2025	0	7400	7400	2024-12-03
1363	2023	0	8800	8800	2024-12-03
1363	2022	0	8500	8500	2024-12-03
1364	2025	0	1200	1200	2024-12-03
1364	2023	0	1500	1500	2024-12-03
1364	2022	0	1500	1500	2024-12-03
1365	2025	0	100	100	2024-12-03
1365	2023	0	200	200	2024-12-03
1365	2022	0	200	200	2024-12-03
1366	2025	0	1300	1300	2024-12-03
1366	2023	0	1500	1500	2024-12-03
1366	2022	0	1600	1600	2024-12-03
1367	2025	1900	207700	209600	2024-12-03
1367	2023	1900	207700	209600	2024-12-03
1367	2022	1900	207700	209600	2024-12-03
1373	2025	969500	433500	1403000	2024-12-03
1373	2023	969500	433700	1403200	2024-12-03
1373	2022	970800	433900	1404700	2024-12-03
1374	2025	308300	225400	533700	2024-12-03
1374	2023	271300	225400	496700	2024-12-03
1374	2022	271300	225400	496700	2024-12-03
1375	2025	1454000	355800	1809800	2024-12-03
1375	2023	1454000	365500	1819500	2024-12-03
1375	2022	1454000	363600	1817600	2024-12-03
1379	2025	0	2900	2900	2024-12-03
1379	2023	0	4100	4100	2024-12-03
1379	2022	0	4300	4300	2024-12-03
1382	2025	630500	345400	975900	2024-12-03
1382	2023	630500	345400	975900	2024-12-03
1382	2022	613200	345400	958600	2024-12-03
1384	2025	644500	225400	869900	2024-12-03
1384	2023	644500	226300	870800	2024-12-03
1384	2022	633900	226400	860300	2024-12-03
1385	2025	596100	172400	768500	2024-12-03
1385	2023	596100	172400	768500	2024-12-03
1385	2022	596100	172400	768500	2024-12-03
1386	2025	800900	405800	1206700	2024-12-03
1386	2023	800900	405800	1206700	2024-12-03
1386	2022	800900	405800	1206700	2024-12-03
1387	2025	0	2400	2400	2024-12-03
1387	2023	0	2800	2800	2024-12-03
1387	2022	0	2900	2900	2024-12-03
1388	2025	0	6600	6600	2024-12-03
1388	2023	0	8500	8500	2024-12-03
1388	2022	0	8200	8200	2024-12-03
1389	2025	159400	199100	358500	2024-12-03
1389	2023	159400	177400	336800	2024-12-03
1389	2022	159400	177400	336800	2024-12-03
1394	2025	0	10900	10900	2024-12-03
1394	2023	0	12700	12700	2024-12-03
1394	2022	0	12400	12400	2024-12-03
1399	2025	0	2800	2800	2024-12-03
1399	2023	0	3500	3500	2024-12-03
1399	2022	0	3600	3600	2024-12-03
1400	2025	0	4800	4800	2024-12-03
1400	2023	0	6100	6100	2024-12-03
1400	2022	0	6700	6700	2024-12-03
1401	2025	0	2800	2800	2024-12-03
1401	2023	0	3600	3600	2024-12-03
1401	2022	0	3300	3300	2024-12-03
1402	2025	0	3400	3400	2024-12-03
1402	2023	0	3800	3800	2024-12-03
1402	2022	0	4000	4000	2024-12-03
1403	2025	0	100	100	2024-12-03
1403	2023	0	100	100	2024-12-03
1403	2022	0	100	100	2024-12-03
1406	2025	694100	227400	921500	2024-12-03
1406	2023	694100	229600	923700	2024-12-03
1406	2022	703700	229900	933600	2024-12-03
1410	2025	165400	109100	274500	2024-12-03
1410	2023	165400	109100	274500	2024-12-03
1410	2022	165400	109200	274600	2024-12-03
1412	2025	105000	97000	202000	2024-12-03
1412	2023	105000	97700	202700	2024-12-03
1412	2022	105000	97900	202900	2024-12-03
1413	2025	0	1600	1600	2024-12-03
1413	2023	0	2200	2200	2024-12-03
1413	2022	0	2100	2100	2024-12-03
1417	2025	0	13000	13000	2024-12-03
1417	2023	0	16300	16300	2024-12-03
1417	2022	0	16700	16700	2024-12-03
1423	2025	0	342200	342200	2024-12-03
1423	2023	0	342200	342200	2024-12-03
1423	2022	0	342200	342200	2024-12-03
1435	2025	0	88300	88300	2024-12-03
1435	2023	0	88300	88300	2024-12-03
1435	2022	0	88300	88300	2024-12-03
1436	2025	0	57100	57100	2024-12-03
1436	2023	0	57100	57100	2024-12-03
1436	2022	0	57100	57100	2024-12-03
1437	2025	0	183500	183500	2024-12-03
1437	2023	0	183500	183500	2024-12-03
1437	2022	0	183500	183500	2024-12-03
1438	2025	0	177200	177200	2024-12-03
1438	2023	0	177200	177200	2024-12-03
1438	2022	0	177200	177200	2024-12-03
1439	2025	0	85000	85000	2024-12-03
1439	2023	0	85000	85000	2024-12-03
1439	2022	0	85000	85000	2024-12-03
1440	2025	0	404400	404400	2024-12-03
1440	2023	0	404400	404400	2024-12-03
1440	2022	0	404400	404400	2024-12-03
1441	2025	0	7500	7500	2024-12-03
1441	2023	0	7500	7500	2024-12-03
1441	2022	0	7500	7500	2024-12-03
1442	2025	0	10900	10900	2024-12-03
1442	2023	0	10900	10900	2024-12-03
1442	2022	0	10900	10900	2024-12-03
1443	2025	0	4600	4600	2024-12-03
1443	2023	0	5600	5600	2024-12-03
1443	2022	0	5900	5900	2024-12-03
1446	2025	0	7700	7700	2024-12-03
1446	2023	0	11100	11100	2024-12-03
1446	2022	0	11000	11000	2024-12-03
1447	2025	200	2000	2200	2024-12-03
1447	2023	200	2500	2700	2024-12-03
1447	2022	200	2500	2700	2024-12-03
1448	2025	0	182900	182900	2024-12-03
1448	2023	0	183100	183100	2024-12-03
1448	2022	0	183000	183000	2024-12-03
1449	2025	60900	274900	335800	2024-12-03
1449	2023	60900	274900	335800	2024-12-03
1449	2022	60700	274900	335600	2024-12-03
1450	2025	20000	73200	93200	2024-12-03
1450	2023	20000	73200	93200	2024-12-03
1450	2022	18900	73200	92100	2024-12-03
1451	2025	110600	145500	256100	2024-12-03
1451	2023	110600	145500	256100	2024-12-03
1451	2022	109100	145500	254600	2024-12-03
1455	2025	224900	230900	455800	2024-12-03
1455	2023	224900	230900	455800	2024-12-03
1455	2022	224900	230900	455800	2024-12-03
1456	2025	16800	173700	190500	2024-12-03
1456	2023	16800	173700	190500	2024-12-03
1456	2022	18300	173700	192000	2024-12-03
1457	2025	123900	159100	283000	2024-12-03
1457	2023	123900	159100	283000	2024-12-03
1457	2022	122000	159100	281100	2024-12-03
1462	2025	301600	275500	577100	2024-12-03
1462	2023	301600	276100	577700	2024-12-03
1462	2022	316800	276100	592900	2024-12-03
1464	2025	0	900	900	2024-12-03
1464	2023	0	1300	1300	2024-12-03
1464	2022	0	1300	1300	2024-12-03
1466	2025	0	2400	2400	2024-12-03
1466	2023	0	3300	3300	2024-12-03
1466	2022	0	3600	3600	2024-12-03
1468	2025	281600	257100	538700	2024-12-03
1468	2023	281600	257500	539100	2024-12-03
1468	2022	280800	257600	538400	2024-12-03
1469	2025	0	75600	75600	2024-12-03
1469	2023	0	75600	75600	2024-12-03
1469	2022	0	75600	75600	2024-12-03
1471	2025	12900	165800	178700	2024-12-03
1471	2023	12900	165800	178700	2024-12-03
1471	2022	13000	165800	178800	2024-12-03
1472	2025	59200	236400	295600	2024-12-03
1472	2023	59200	236400	295600	2024-12-03
1472	2022	56000	236400	292400	2024-12-03
1473	2025	167300	276400	443700	2024-12-03
1473	2023	167300	276700	444000	2024-12-03
1473	2022	163200	276700	439900	2024-12-03
1475	2025	72800	240600	313400	2024-12-03
1475	2023	72800	240700	313500	2024-12-03
1475	2022	64200	240800	305000	2024-12-03
1477	2025	94400	139000	233400	2024-12-03
1477	2023	94400	139000	233400	2024-12-03
1477	2022	94400	139000	233400	2024-12-03
1484	2025	114700	166100	280800	2024-12-03
1484	2023	114700	166100	280800	2024-12-03
1484	2022	105200	166100	271300	2024-12-03
1485	2025	152700	201200	353900	2024-12-03
1485	2023	152700	201200	353900	2024-12-03
1485	2022	152700	201200	353900	2024-12-03
1486	2025	276300	118700	395000	2024-12-03
1486	2023	276300	119900	396200	2024-12-03
1486	2022	270400	120200	390600	2024-12-03
1488	2025	0	8400	8400	2024-12-03
1488	2023	0	10900	10900	2024-12-03
1488	2022	0	11200	11200	2024-12-03
1489	2025	0	5900	5900	2024-12-03
1489	2023	0	6900	6900	2024-12-03
1489	2022	0	6400	6400	2024-12-03
100000	2025	765900	166900	932800	2024-12-03
100000	2023	765900	167200	933100	2024-12-03
100000	2022	765900	167200	933100	2024-12-03
100021	2025	1143000	229200	1372200	2024-12-03
100021	2023	1128800	230600	1359400	2024-12-03
100021	2022	1128800	230900	1359700	2024-12-03
100041	2025	0	8300	8300	2024-12-03
100041	2023	0	8800	8800	2024-12-03
100041	2022	0	8800	8800	2024-12-03
100103	2025	234700	110700	345400	2024-12-03
100103	2023	234700	111000	345700	2024-12-03
100103	2022	234700	111100	345800	2024-12-03
100122	2025	386900	159500	546400	2024-12-03
100122	2023	386900	159800	546700	2024-12-03
100122	2022	386900	159800	546700	2024-12-03
100142	2025	217500	0	217500	2024-12-03
100142	2023	217500	0	217500	2024-12-03
100142	2022	217500	0	217500	2024-12-03
100162	2025	217500	0	217500	2024-12-03
100162	2023	217500	0	217500	2024-12-03
100162	2022	217500	0	217500	2024-12-03
100163	2025	251600	0	251600	2024-12-03
100163	2023	251600	0	251600	2024-12-03
100163	2022	251600	0	251600	2024-12-03
100164	2025	244700	0	244700	2024-12-03
100164	2023	244700	0	244700	2024-12-03
100164	2022	244700	0	244700	2024-12-03
100182	2025	377100	0	377100	2024-12-03
100182	2023	377100	0	377100	2024-12-03
100182	2022	377100	0	377100	2024-12-03
100184	2025	349600	0	349600	2024-12-03
100184	2023	349600	0	349600	2024-12-03
100184	2022	349600	0	349600	2024-12-03
100202	2025	0	19900	19900	2024-12-03
100202	2023	0	20700	20700	2024-12-03
100202	2022	0	20600	20600	2024-12-03
100243	2025	478200	158400	636600	2024-12-03
100243	2023	478200	158800	637000	2024-12-03
100243	2022	478200	158900	637100	2024-12-03
100262	2025	841700	181900	1023600	2024-12-03
100262	2023	841700	181900	1023600	2024-12-03
100262	2022	826700	181900	1008600	2024-12-03
100263	2025	629900	202300	832200	2024-12-03
100263	2023	609800	202300	812100	2024-12-03
100263	2022	609800	202300	812100	2024-12-03
100264	2025	0	300	300	2024-12-03
100264	2023	0	400	400	2024-12-03
100264	2022	0	400	400	2024-12-03
100265	2025	431900	203100	635000	2024-12-03
100265	2023	431900	203100	635000	2024-12-03
100265	2022	431900	203100	635000	2024-12-03
100282	2025	599400	190100	789500	2024-12-03
100282	2023	557500	190100	747600	2024-12-03
100282	2022	545900	190100	736000	2024-12-03
100302	2025	263600	206300	469900	2024-12-03
100302	2023	263600	206300	469900	2024-12-03
100302	2022	263600	206300	469900	2024-12-03
100322	2025	0	4300	4300	2024-12-03
100322	2023	0	4300	4300	2024-12-03
100322	2022	0	4300	4300	2024-12-03
100361	2025	0	2800	2800	2024-12-03
100361	2023	0	4500	4500	2024-12-03
100361	2022	0	4200	4200	2024-12-03
100401	2025	0	1900	1900	2024-12-03
100401	2023	0	2500	2500	2024-12-03
100401	2022	0	2500	2500	2024-12-03
100422	2025	451200	0	451200	2024-12-03
100422	2023	451200	0	451200	2024-12-03
100422	2022	451200	0	451200	2024-12-03
100442	2025	387700	0	387700	2024-12-03
100442	2023	387700	0	387700	2024-12-03
100442	2022	387700	0	387700	2024-12-03
100462	2025	204700	0	204700	2024-12-03
100462	2023	204700	0	204700	2024-12-03
100462	2022	204700	0	204700	2024-12-03
100463	2025	398200	0	398200	2024-12-03
100463	2023	398200	0	398200	2024-12-03
100463	2022	398200	0	398200	2024-12-03
100482	2025	212900	0	212900	2024-12-03
100482	2023	212900	0	212900	2024-12-03
100482	2022	212900	0	212900	2024-12-03
100502	2025	421200	0	421200	2024-12-03
100502	2023	421200	0	421200	2024-12-03
100502	2022	421200	0	421200	2024-12-03
100503	2025	261900	0	261900	2024-12-03
100503	2023	261900	0	261900	2024-12-03
100503	2022	261900	0	261900	2024-12-03
100522	2025	184400	0	184400	2024-12-03
100522	2023	184400	0	184400	2024-12-03
100522	2022	184400	0	184400	2024-12-03
100523	2025	332100	0	332100	2024-12-03
100523	2023	332100	0	332100	2024-12-03
100523	2022	332100	0	332100	2024-12-03
100542	2025	473800	0	473800	2024-12-03
100542	2023	473800	0	473800	2024-12-03
100542	2022	473800	0	473800	2024-12-03
100543	2025	543400	0	543400	2024-12-03
100543	2023	543400	0	543400	2024-12-03
100543	2022	543400	0	543400	2024-12-03
100562	2025	427400	0	427400	2024-12-03
100562	2023	427400	0	427400	2024-12-03
100562	2022	427400	0	427400	2024-12-03
100563	2025	340300	0	340300	2024-12-03
100563	2023	340300	0	340300	2024-12-03
100563	2022	340300	0	340300	2024-12-03
100582	2025	385200	0	385200	2024-12-03
100582	2023	385200	0	385200	2024-12-03
100582	2022	385200	0	385200	2024-12-03
100583	2025	3773000	0	3773000	2024-12-03
100583	2023	1848200	0	1848200	2024-12-03
100583	2022	1848200	0	1848200	2024-12-03
100602	2025	0	1300	1300	2024-12-03
100602	2023	0	1900	1900	2024-12-03
100602	2022	0	2100	2100	2024-12-03
100622	2025	0	900	900	2024-12-03
100622	2023	0	1300	1300	2024-12-03
100622	2022	0	1500	1500	2024-12-03
100642	2025	0	33000	33000	2024-12-03
100642	2023	0	33000	33000	2024-12-03
100642	2022	0	33000	33000	2024-12-03
100662	2025	0	1600	1600	2024-12-03
100662	2023	0	2300	2300	2024-12-03
100662	2022	0	2600	2600	2024-12-03
100722	2025	374200	176700	550900	2024-12-03
100722	2023	374200	176700	550900	2024-12-03
100722	2022	374200	176700	550900	2024-12-03
100742	2025	704200	218300	922500	2024-12-03
100742	2023	674200	218900	893100	2024-12-03
100742	2022	674200	219200	893400	2024-12-03
100822	2025	159600	300700	460300	2024-12-03
100822	2023	147600	371300	518900	2024-12-03
100822	2022	147600	290200	437800	2024-12-03
100863	2025	162900	104400	267300	2024-12-03
100863	2023	162900	104400	267300	2024-12-03
100863	2022	162900	104400	267300	2024-12-03
101082	2025	0	179500	179500	2024-12-03
101082	2023	0	179500	179500	2024-12-03
101082	2022	0	179500	179500	2024-12-03
101143	2025	531300	179400	710700	2024-12-03
101143	2023	531300	180100	711400	2024-12-03
101143	2022	531300	180100	711400	2024-12-03
101162	2025	273300	253100	526400	2024-12-03
101162	2023	273300	253100	526400	2024-12-03
101162	2022	273300	253100	526400	2024-12-03
101182	2025	457000	332800	789800	2024-12-03
101182	2023	457000	332800	789800	2024-12-03
101182	2022	457000	332800	789800	2024-12-03
101183	2025	0	300	300	2024-12-03
101183	2023	0	400	400	2024-12-03
101183	2022	0	400	400	2024-12-03
101202	2025	0	2900	2900	2024-12-03
101202	2023	0	3000	3000	2024-12-03
101202	2022	0	3100	3100	2024-12-03
101203	2025	0	6400	6400	2024-12-03
101203	2023	0	6400	6400	2024-12-03
101203	2022	0	6400	6400	2024-12-03
101204	2025	0	2600	2600	2024-12-03
101204	2023	0	2700	2700	2024-12-03
101204	2022	0	2800	2800	2024-12-03
101205	2025	0	2200	2200	2024-12-03
101205	2023	0	2400	2400	2024-12-03
101205	2022	0	2500	2500	2024-12-03
101224	2025	521700	174800	696500	2024-12-03
101224	2023	521700	174800	696500	2024-12-03
101224	2022	521700	174800	696500	2024-12-03
101242	2025	660000	249300	909300	2024-12-03
101242	2023	660000	249300	909300	2024-12-03
101242	2022	660000	249300	909300	2024-12-03
101243	2025	621200	221300	842500	2024-12-03
101243	2023	621200	221300	842500	2024-12-03
101243	2022	621200	221300	842500	2024-12-03
101262	2025	413400	185900	599300	2024-12-03
101262	2023	408800	185900	594700	2024-12-03
101262	2022	408800	185900	594700	2024-12-03
101282	2025	384200	200300	584500	2024-12-03
101282	2023	384200	200600	584800	2024-12-03
101282	2022	384200	200700	584900	2024-12-03
101325	2025	711400	202300	913700	2024-12-03
101325	2023	666300	203300	869600	2024-12-03
101325	2022	628800	203400	832200	2024-12-03
101342	2025	812300	660900	1473200	2024-12-03
101342	2023	812300	660900	1473200	2024-12-03
101342	2022	812300	660900	1473200	2024-12-03
101362	2025	517100	186200	703300	2024-12-03
101362	2023	516900	186400	703300	2024-12-03
101362	2022	516800	186500	703300	2024-12-03
101382	2025	253400	182000	435400	2024-12-03
101382	2023	244600	182100	426700	2024-12-03
101382	2022	244600	182200	426800	2024-12-03
101442	2025	3500	89600	93100	2024-12-03
101442	2023	3500	89700	93200	2024-12-03
101442	2022	3500	89800	93300	2024-12-03
101462	2025	926800	191100	1117900	2024-12-03
101462	2023	926800	191100	1117900	2024-12-03
101462	2022	926800	191100	1117900	2024-12-03
101483	2025	200	144400	144600	2024-12-03
101483	2023	200	144400	144600	2024-12-03
101483	2022	200	144400	144600	2024-12-03
101502	2025	0	13400	13400	2024-12-03
101502	2023	0	13400	13400	2024-12-03
101502	2022	0	13400	13400	2024-12-03
101523	2025	319000	144100	463100	2024-12-03
101523	2023	319000	144300	463300	2024-12-03
101523	2022	319000	144400	463400	2024-12-03
101542	2025	203700	326600	530300	2024-12-03
101542	2023	203700	327200	530900	2024-12-03
101542	2022	203700	327400	531100	2024-12-03
101562	2025	900	12700	13600	2024-12-03
101562	2023	900	15800	16700	2024-12-03
101562	2022	900	15900	16800	2024-12-03
101582	2025	0	2100	2100	2024-12-03
101582	2023	0	2700	2700	2024-12-03
101582	2022	0	2900	2900	2024-12-03
101602	2025	243200	0	243200	2024-12-03
101602	2023	243200	0	243200	2024-12-03
101602	2022	243200	0	243200	2024-12-03
101622	2025	365500	114300	479800	2024-12-03
101622	2023	365500	114500	480000	2024-12-03
101622	2022	344800	114500	459300	2024-12-03
101642	2025	281900	144800	426700	2024-12-03
101642	2023	281900	144800	426700	2024-12-03
101642	2022	281900	144800	426700	2024-12-03
102644	2025	6300	16100	22400	2024-12-03
102644	2023	6300	16400	22700	2024-12-03
102644	2022	6300	16400	22700	2024-12-03
102691	2025	793000	301300	1094300	2024-12-03
102691	2023	793000	301700	1094700	2024-12-03
102691	2022	791100	301800	1092900	2024-12-03
102692	2025	645600	168500	814100	2024-12-03
102692	2023	645600	168900	814500	2024-12-03
102692	2022	645300	168900	814200	2024-12-03
102712	2025	11100	246900	258000	2024-12-03
102712	2023	11100	246900	258000	2024-12-03
102712	2022	11100	246900	258000	2024-12-03
102732	2025	36300	69300	105600	2024-12-03
102732	2023	36300	69300	105600	2024-12-03
102732	2022	36300	69300	105600	2024-12-03
102736	2025	431400	192300	623700	2024-12-03
102736	2023	425900	192300	618200	2024-12-03
102736	2022	425900	192300	618200	2024-12-03
102737	2025	672900	368500	1041400	2024-12-03
102737	2023	672900	368500	1041400	2024-12-03
102737	2022	672900	368500	1041400	2024-12-03
102759	2025	0	600	600	2024-12-03
102759	2023	0	600	600	2024-12-03
102759	2022	0	600	600	2024-12-03
102763	2025	0	2400	2400	2024-12-03
102763	2023	0	3200	3200	2024-12-03
102763	2022	0	3300	3300	2024-12-03
102766	2025	206700	174300	381000	2024-12-03
102766	2023	205000	174300	379300	2024-12-03
102766	2022	171800	174300	346100	2024-12-03
102768	2025	0	109300	109300	2024-12-03
102768	2023	0	109300	109300	2024-12-03
102768	2022	0	109300	109300	2024-12-03
102770	2025	692600	180000	872600	2024-12-03
102770	2023	692600	180600	873200	2024-12-03
102770	2022	632600	180600	813200	2024-12-03
102771	2025	155400	136800	292200	2024-12-03
102771	2023	155400	136800	292200	2024-12-03
102771	2022	155400	136800	292200	2024-12-03
102772	2025	0	11400	11400	2024-12-03
102772	2023	0	14500	14500	2024-12-03
102772	2022	0	14800	14800	2024-12-03
102814	2025	49000	342900	391900	2024-12-03
102814	2023	49000	342900	391900	2024-12-03
102814	2022	49000	342900	391900	2024-12-03
102815	2025	0	126900	126900	2024-12-03
102815	2023	0	126900	126900	2024-12-03
102815	2022	0	126900	126900	2024-12-03
102834	2025	902600	345400	1248000	2024-12-03
102834	2023	892800	346200	1239000	2024-12-03
102834	2022	860200	346200	1206400	2024-12-03
102854	2025	67300	91400	158700	2024-12-03
102854	2023	67300	91400	158700	2024-12-03
102854	2022	67300	91400	158700	2024-12-03
102874	2025	0	2600	2600	2024-12-03
102874	2023	0	3600	3600	2024-12-03
102874	2022	0	3800	3800	2024-12-03
102875	2025	0	11200	11200	2024-12-03
102875	2023	0	13000	13000	2024-12-03
102875	2022	0	13700	13700	2024-12-03
102876	2025	0	600	600	2024-12-03
102876	2023	0	700	700	2024-12-03
102876	2022	0	800	800	2024-12-03
102896	2025	400300	262100	662400	2024-12-03
102896	2023	215600	215000	430600	2024-12-03
102896	2022	0	500	500	2024-12-03
102897	2025	72500	265300	337800	2024-12-03
102897	2023	72500	265300	337800	2024-12-03
102897	2022	72500	265300	337800	2024-12-03
102916	2025	0	25000	25000	2024-12-03
102916	2023	0	25000	25000	2024-12-03
102916	2022	0	25000	25000	2024-12-03
102937	2025	5100	0	5100	2024-12-03
102937	2023	5100	0	5100	2024-12-03
102937	2022	5700	0	5700	2024-12-03
102956	2025	0	237100	237100	2024-12-03
102956	2023	0	237100	237100	2024-12-03
102956	2022	0	237100	237100	2024-12-03
102976	2025	37100	120300	157400	2024-12-03
102976	2023	37100	121800	158900	2024-12-03
102976	2022	37100	121900	159000	2024-12-03
102996	2025	0	6900	6900	2024-12-03
102996	2023	0	9900	9900	2024-12-03
102996	2022	0	10000	10000	2024-12-03
103016	2025	34800	42800	77600	2024-12-03
103016	2023	34800	42800	77600	2024-12-03
103016	2022	34800	42800	77600	2024-12-03
103036	2025	0	1400	1400	2024-12-03
103036	2023	0	1800	1800	2024-12-03
103036	2022	0	2000	2000	2024-12-03
103057	2025	327800	330000	657800	2024-12-03
103057	2023	327800	330000	657800	2024-12-03
103057	2022	327800	330000	657800	2024-12-03
103079	2025	0	1500	1500	2024-12-03
103079	2023	0	2000	2000	2024-12-03
103079	2022	0	2300	2300	2024-12-03
103097	2025	0	2100	2100	2024-12-03
103097	2023	0	3000	3000	2024-12-03
103097	2022	0	3000	3000	2024-12-03
103117	2025	37000	44500	81500	2024-12-03
103117	2023	37000	44500	81500	2024-12-03
103117	2022	37000	44500	81500	2024-12-03
103137	2025	50000	0	50000	2024-12-03
103137	2023	50000	0	50000	2024-12-03
103137	2022	50000	0	50000	2024-12-03
103157	2025	0	4500	4500	2024-12-03
103157	2023	0	4500	4500	2024-12-03
103157	2022	0	4500	4500	2024-12-03
103178	2025	33600	88000	121600	2024-12-03
103178	2023	33600	88000	121600	2024-12-03
103178	2022	33600	88000	121600	2024-12-03
103197	2025	241800	0	241800	2024-12-03
103197	2023	227700	0	227700	2024-12-03
103197	2022	60000	0	60000	2024-12-03
103218	2025	214200	0	214200	2024-12-03
103218	2023	236500	0	236500	2024-12-03
103218	2022	401300	0	401300	2024-12-03
103220	2025	0	1500	1500	2024-12-03
103220	2023	0	1500	1500	2024-12-03
103220	2022	0	1500	1500	2024-12-03
103222	2025	0	1000	1000	2024-12-03
103222	2023	0	1300	1300	2024-12-03
103222	2022	0	1300	1300	2024-12-03
103224	2025	251200	0	251200	2024-12-03
103224	2023	251200	0	251200	2024-12-03
103224	2022	350700	0	350700	2024-12-03
103225	2025	63700	0	63700	2024-12-03
103225	2023	63700	0	63700	2024-12-03
103225	2022	148500	0	148500	2024-12-03
103226	2025	108500	0	108500	2024-12-03
103226	2023	108500	0	108500	2024-12-03
103226	2022	175000	0	175000	2024-12-03
103227	2025	79200	0	79200	2024-12-03
103227	2023	79200	0	79200	2024-12-03
103227	2022	144800	0	144800	2024-12-03
103228	2025	73200	0	73200	2024-12-03
103228	2023	73200	0	73200	2024-12-03
103228	2022	138900	0	138900	2024-12-03
103229	2025	72500	0	72500	2024-12-03
103229	2023	72500	0	72500	2024-12-03
103229	2022	138000	0	138000	2024-12-03
103230	2025	85500	0	85500	2024-12-03
103230	2023	85500	0	85500	2024-12-03
103230	2022	152100	0	152100	2024-12-03
103233	2025	74900	0	74900	2024-12-03
103233	2023	74900	0	74900	2024-12-03
103233	2022	141100	0	141100	2024-12-03
103237	2025	74900	0	74900	2024-12-03
103237	2023	74900	0	74900	2024-12-03
103237	2022	141000	0	141000	2024-12-03
103238	2025	72800	0	72800	2024-12-03
103238	2023	72800	0	72800	2024-12-03
103238	2022	131100	0	131100	2024-12-03
103239	2025	78800	0	78800	2024-12-03
103239	2023	78800	0	78800	2024-12-03
103239	2022	146200	0	146200	2024-12-03
103240	2025	79700	0	79700	2024-12-03
103240	2023	79700	0	79700	2024-12-03
103240	2022	147300	0	147300	2024-12-03
103242	2025	72700	0	72700	2024-12-03
103242	2023	72700	0	72700	2024-12-03
103242	2022	143100	0	143100	2024-12-03
103243	2025	78200	0	78200	2024-12-03
103243	2023	78200	0	78200	2024-12-03
103243	2022	145400	0	145400	2024-12-03
103244	2025	74600	0	74600	2024-12-03
103244	2023	74600	0	74600	2024-12-03
103244	2022	140800	0	140800	2024-12-03
103245	2025	90300	0	90300	2024-12-03
103245	2023	90300	0	90300	2024-12-03
103245	2022	161100	0	161100	2024-12-03
103246	2025	73900	0	73900	2024-12-03
103246	2023	73900	0	73900	2024-12-03
103246	2022	139800	0	139800	2024-12-03
103247	2025	73900	0	73900	2024-12-03
103247	2023	73900	0	73900	2024-12-03
103247	2022	139800	0	139800	2024-12-03
103248	2025	86300	0	86300	2024-12-03
103248	2023	86300	0	86300	2024-12-03
103248	2022	155900	0	155900	2024-12-03
103249	2025	75800	0	75800	2024-12-03
103249	2023	75800	0	75800	2024-12-03
103249	2022	141600	0	141600	2024-12-03
103250	2025	88600	0	88600	2024-12-03
103250	2023	88600	0	88600	2024-12-03
103250	2022	158900	0	158900	2024-12-03
103251	2025	31300	0	31300	2024-12-03
103251	2023	31300	0	31300	2024-12-03
103251	2022	144800	0	144800	2024-12-03
103252	2025	263900	170100	434000	2024-12-03
103252	2023	102100	140400	242500	2024-12-03
103253	2025	0	12400	12400	2024-12-03
103253	2023	0	12400	12400	2024-12-03
103254	2025	33800	111200	145000	2024-12-03
103254	2023	33800	111300	145100	2024-12-03
103255	2025	0	1700	1700	2024-12-03
103255	2023	0	1700	1700	2024-12-03
103257	2025	0	200	200	2024-12-03
103257	2023	0	300	300	2024-12-03
103258	2025	439400	0	439400	2024-12-03
103259	2025	439400	0	439400	2024-12-03
103260	2025	422700	0	422700	2024-12-03
103261	2025	438300	0	438300	2024-12-03
103262	2025	374900	0	374900	2024-12-03
103265	No Data for PID				2024-12-03
