Ass. Year	Improvements	Land	Total	PID	CollectedOn
2022	93700	167600	261300	5	2023-08-17
2021	93700	167600	261300	5	2023-08-17
2020	80700	130200	210900	5	2023-08-17
2022	77200	104600	181800	7	2023-08-17
2021	77200	104600	181800	7	2023-08-17
2020	62000	88200	150200	7	2023-08-17
2022	114000	140400	254400	8	2023-08-17
2021	114000	140400	254400	8	2023-08-17
2020	106600	101200	207800	8	2023-08-17
2022	112100	157900	270000	9	2023-08-17
2021	108900	157900	266800	9	2023-08-17
2020	89500	121300	210800	9	2023-08-17
2022	254100	163000	417100	10	2023-08-17
2021	254100	163000	417100	10	2023-08-17
2020	254100	125900	380000	10	2023-08-17
2022	261800	225200	487000	12	2023-08-17
2021	261800	225200	487000	12	2023-08-17
2020	260800	171900	432700	12	2023-08-17
2022	275700	280700	556400	13	2023-08-17
2021	275700	280700	556400	13	2023-08-17
2020	257200	186800	444000	13	2023-08-17
2022	1016100	385700	1401800	16	2023-08-17
2021	1016100	385700	1401800	16	2023-08-17
2020	913900	292700	1206600	16	2023-08-17
2022	194000	139100	333100	18	2023-08-17
2021	162500	139100	301600	18	2023-08-17
2020	161500	138400	299900	18	2023-08-17
2022	125000	62300	187300	19	2023-08-17
2021	91700	62300	154000	19	2023-08-17
2020	82100	53500	135600	19	2023-08-17
2022	381400	234400	615800	20	2023-08-17
2021	381400	234400	615800	20	2023-08-17
2020	367500	206400	573900	20	2023-08-17
2022	398100	288400	686500	21	2023-08-17
2021	398100	288400	686500	21	2023-08-17
2020	409800	203600	613400	21	2023-08-17
2022	269300	179700	449000	22	2023-08-17
2021	269300	179700	449000	22	2023-08-17
2020	211300	178700	390000	22	2023-08-17
2022	233100	245600	478700	23	2023-08-17
2021	233100	245600	478700	23	2023-08-17
2020	227500	214300	441800	23	2023-08-17
2022	378700	170500	549200	25	2023-08-17
2021	410600	170500	581100	25	2023-08-17
2020	319400	149000	468400	25	2023-08-17
2022	144700	205300	350000	26	2023-08-17
2021	151100	205300	356400	26	2023-08-17
2020	143500	150400	293900	26	2023-08-17
2022	327100	210000	537100	27	2023-08-17
2021	326700	210000	536700	27	2023-08-17
2020	325200	184600	509800	27	2023-08-17
2022	298800	244000	542800	28	2023-08-17
2021	292900	244000	536900	28	2023-08-17
2020	284900	215400	500300	28	2023-08-17
2022	420400	235700	656100	29	2023-08-17
2021	420400	235700	656100	29	2023-08-17
2020	393200	207900	601100	29	2023-08-17
2022	275300	218200	493500	30	2023-08-17
2021	275800	218200	494000	30	2023-08-17
2020	273700	161800	435500	30	2023-08-17
2022	131000	146800	277800	32	2023-08-17
2021	131000	146800	277800	32	2023-08-17
2020	119100	154700	273800	32	2023-08-17
2022	176400	151600	328000	33	2023-08-17
2021	176400	151600	328000	33	2023-08-17
2020	148000	153900	301900	33	2023-08-17
2022	395200	157700	552900	34	2023-08-17
2021	395200	157700	552900	34	2023-08-17
2020	391300	166100	557400	34	2023-08-17
2022	0	29200	29200	35	2023-08-17
2021	0	29200	29200	35	2023-08-17
2020	0	24000	24000	35	2023-08-17
2022	303000	416200	719200	36	2023-08-17
2021	303000	416200	719200	36	2023-08-17
2020	404700	318600	723300	36	2023-08-17
2022	297500	353000	650500	37	2023-08-17
2021	297500	353000	650500	37	2023-08-17
2020	199500	286400	485900	37	2023-08-17
2022	569100	237000	806100	39	2023-08-17
2021	339700	237000	576700	39	2023-08-17
2020	421400	208700	630100	39	2023-08-17
2022	0	43000	43000	40	2023-08-17
2021	0	43000	43000	40	2023-08-17
2020	0	37300	37300	40	2023-08-17
2022	447000	186000	633000	41	2023-08-17
2021	447000	186000	633000	41	2023-08-17
2020	441600	175800	617400	41	2023-08-17
2022	269800	218700	488500	42	2023-08-17
2021	269800	218700	488500	42	2023-08-17
2020	246800	192400	439200	42	2023-08-17
2022	137300	208300	345600	43	2023-08-17
2021	137300	208300	345600	43	2023-08-17
2020	156300	163100	319400	43	2023-08-17
2022	194300	0	194300	50	2023-08-17
2021	194300	0	194300	50	2023-08-17
2020	150100	0	150100	50	2023-08-17
2022	197400	0	197400	51	2023-08-17
2021	197400	0	197400	51	2023-08-17
2020	144300	0	144300	51	2023-08-17
2022	184100	0	184100	52	2023-08-17
2021	184100	0	184100	52	2023-08-17
2020	141100	0	141100	52	2023-08-17
2022	208500	0	208500	53	2023-08-17
2021	208500	0	208500	53	2023-08-17
2020	162700	0	162700	53	2023-08-17
2022	179900	0	179900	54	2023-08-17
2021	179900	0	179900	54	2023-08-17
2020	137400	0	137400	54	2023-08-17
2022	195600	0	195600	55	2023-08-17
2021	195600	0	195600	55	2023-08-17
2020	151200	0	151200	55	2023-08-17
2022	976100	234500	1210600	56	2023-08-17
2021	926400	234500	1160900	56	2023-08-17
2020	908500	186700	1095200	56	2023-08-17
2022	734700	230000	964700	57	2023-08-17
2021	734700	230000	964700	57	2023-08-17
2020	714200	202400	916600	57	2023-08-17
2022	653600	262000	915600	58	2023-08-17
2021	653600	262000	915600	58	2023-08-17
2020	604000	255500	859500	58	2023-08-17
2022	355300	156500	511800	59	2023-08-17
2021	355300	156500	511800	59	2023-08-17
2020	331100	165000	496100	59	2023-08-17
2022	485100	218900	704000	60	2023-08-17
2021	485100	218900	704000	60	2023-08-17
2020	442800	192600	635400	60	2023-08-17
2022	498400	163900	662300	62	2023-08-17
2021	485300	163900	649200	62	2023-08-17
2020	404000	172100	576100	62	2023-08-17
2022	258400	232100	490500	63	2023-08-17
2021	258400	232100	490500	63	2023-08-17
2020	182300	204300	386600	63	2023-08-17
2022	103900	218200	322100	64	2023-08-17
2021	103900	218200	322100	64	2023-08-17
2020	100700	161800	262500	64	2023-08-17
2022	436100	228900	665000	65	2023-08-17
2021	316000	228900	544900	65	2023-08-17
2020	288100	201400	489500	65	2023-08-17
2022	218800	230900	449700	66	2023-08-17
2021	218800	230900	449700	66	2023-08-17
2020	205200	203200	408400	66	2023-08-17
2022	0	103200	103200	67	2023-08-17
2021	0	103200	103200	67	2023-08-17
2020	0	87400	87400	67	2023-08-17
2022	127000	157100	284100	68	2023-08-17
2021	127000	157100	284100	68	2023-08-17
2020	136000	120600	256600	68	2023-08-17
2022	0	8600	8600	69	2023-08-17
2021	0	8600	8600	69	2023-08-17
2020	0	8400	8400	69	2023-08-17
2022	519800	234400	754200	76	2023-08-17
2021	519800	234400	754200	76	2023-08-17
2020	537500	206400	743900	76	2023-08-17
2022	343500	234900	578400	77	2023-08-17
2021	343500	234900	578400	77	2023-08-17
2020	338100	206800	544900	77	2023-08-17
2022	173800	216500	390300	78	2023-08-17
2021	173800	216500	390300	78	2023-08-17
2020	132600	190400	323000	78	2023-08-17
2022	116800	216500	333300	79	2023-08-17
2021	116800	216500	333300	79	2023-08-17
2020	105400	190200	295600	79	2023-08-17
2022	301600	317200	618800	80	2023-08-17
2021	301600	317200	618800	80	2023-08-17
2020	226900	265000	491900	80	2023-08-17
2022	92200	233300	325500	81	2023-08-17
2021	139400	290400	429800	81	2023-08-17
2020	119100	255500	374600	81	2023-08-17
2022	217700	199300	417000	82	2023-08-17
2021	217700	199300	417000	82	2023-08-17
2020	157800	186800	344600	82	2023-08-17
2022	190300	161800	352100	83	2023-08-17
2021	189900	161800	351700	83	2023-08-17
2020	151100	170400	321500	83	2023-08-17
2022	3187200	2000100	5187300	84	2023-08-17
2021	3187200	2000100	5187300	84	2023-08-17
2020	2800400	1387500	4187900	84	2023-08-17
2022	0	16900	16900	85	2023-08-17
2021	0	16900	16900	85	2023-08-17
2020	0	16400	16400	85	2023-08-17
2022	471700	228900	700600	86	2023-08-17
2021	471700	228900	700600	86	2023-08-17
2020	422300	201400	623700	86	2023-08-17
2022	379700	256000	635700	87	2023-08-17
2021	379700	256000	635700	87	2023-08-17
2020	373400	225400	598800	87	2023-08-17
2022	43200	113400	156600	88	2023-08-17
2021	43200	113400	156600	88	2023-08-17
2020	36900	75200	112100	88	2023-08-17
2022	252300	239000	491300	89	2023-08-17
2021	252300	239500	491800	89	2023-08-17
2020	272500	211800	484300	89	2023-08-17
2022	526300	277000	803300	91	2023-08-17
2021	526300	277000	803300	91	2023-08-17
2020	548900	191900	740800	91	2023-08-17
2022	77800	179500	257300	92	2023-08-17
2021	77800	179500	257300	92	2023-08-17
2020	63100	149400	212500	92	2023-08-17
2022	548900	204300	753200	93	2023-08-17
2021	475800	204300	680100	93	2023-08-17
2020	298700	188200	486900	93	2023-08-17
2022	385500	179200	564700	94	2023-08-17
2021	385500	179200	564700	94	2023-08-17
2020	266600	178700	445300	94	2023-08-17
2022	410100	207600	617700	95	2023-08-17
2021	410100	207600	617700	95	2023-08-17
2020	287100	189100	476200	95	2023-08-17
2022	328500	0	328500	99	2023-08-17
2021	328500	0	328500	99	2023-08-17
2020	308800	0	308800	99	2023-08-17
2022	543900	0	543900	101	2023-08-17
2021	543900	0	543900	101	2023-08-17
2020	543200	0	543200	101	2023-08-17
2022	7500	104000	111500	102	2023-08-17
2021	7500	104000	111500	102	2023-08-17
2020	7500	91900	99400	102	2023-08-17
2022	121800	185100	306900	103	2023-08-17
2021	121800	185100	306900	103	2023-08-17
2020	116200	162700	278900	103	2023-08-17
2022	1055000	394300	1449300	104	2023-08-17
2021	1055000	394300	1449300	104	2023-08-17
2020	923900	298600	1222500	104	2023-08-17
2022	236100	274300	510400	105	2023-08-17
2021	236100	274300	510400	105	2023-08-17
2020	219000	249200	468200	105	2023-08-17
2022	1421000	488300	1909300	106	2023-08-17
2021	1421000	488300	1909300	106	2023-08-17
2020	1164400	388300	1552700	106	2023-08-17
2022	359500	263700	623200	107	2023-08-17
2021	359500	263700	623200	107	2023-08-17
2020	340500	233900	574400	107	2023-08-17
2022	4400	424700	429100	111	2023-08-17
2021	4400	424700	429100	111	2023-08-17
2020	4000	337700	341700	111	2023-08-17
2022	51000	123500	174500	115	2023-08-17
2021	221200	137700	358900	115	2023-08-17
2020	168500	105400	273900	115	2023-08-17
2022	249500	148200	397700	116	2023-08-17
2021	249500	148200	397700	116	2023-08-17
2020	222400	119300	341700	116	2023-08-17
2022	426300	0	426300	117	2023-08-17
2021	426300	0	426300	117	2023-08-17
2020	388500	0	388500	117	2023-08-17
2022	155800	405100	560900	118	2023-08-17
2021	155800	405100	560900	118	2023-08-17
2020	143400	287600	431000	118	2023-08-17
2022	462100	360800	822900	120	2023-08-17
2021	462100	360800	822900	120	2023-08-17
2020	461500	277700	739200	120	2023-08-17
2022	2900	143700	146600	121	2023-08-17
2021	2400	143700	146100	121	2023-08-17
2020	73600	115200	188800	121	2023-08-17
2022	273000	133300	406300	122	2023-08-17
2021	273000	133300	406300	122	2023-08-17
2020	223700	105800	329500	122	2023-08-17
2022	151900	132200	284100	123	2023-08-17
2021	151900	132200	284100	123	2023-08-17
2020	120600	105500	226100	123	2023-08-17
2022	354900	223000	577900	124	2023-08-17
2021	354900	223000	577900	124	2023-08-17
2020	326200	140700	466900	124	2023-08-17
2022	272000	155700	427700	125	2023-08-17
2021	272000	155700	427700	125	2023-08-17
2020	227400	119300	346700	125	2023-08-17
2022	240200	153300	393500	127	2023-08-17
2021	240200	153300	393500	127	2023-08-17
2020	263100	114100	377200	127	2023-08-17
2022	395000	188500	583500	128	2023-08-17
2021	395000	188500	583500	128	2023-08-17
2020	416100	111500	527600	128	2023-08-17
2022	182300	157500	339800	129	2023-08-17
2021	182300	157500	339800	129	2023-08-17
2020	170700	124600	295300	129	2023-08-17
2022	0	40300	40300	132	2023-08-17
2021	0	40300	40300	132	2023-08-17
2020	0	33700	33700	132	2023-08-17
2022	42000	0	42000	133	2023-08-17
2021	42000	0	42000	133	2023-08-17
2020	38500	0	38500	133	2023-08-17
2022	15200	12200	27400	136	2023-08-17
2021	15200	12200	27400	136	2023-08-17
2020	13400	9700	23100	136	2023-08-17
2022	46900	189400	236300	137	2023-08-17
2021	46900	189400	236300	137	2023-08-17
2020	42400	154600	197000	137	2023-08-17
2022	1194500	246000	1440500	138	2023-08-17
2021	1194500	246000	1440500	138	2023-08-17
2020	1092000	237600	1329600	138	2023-08-17
2022	81400	166400	247800	139	2023-08-17
2021	81400	166400	247800	139	2023-08-17
2020	73400	132400	205800	139	2023-08-17
2022	575300	151500	726800	140	2023-08-17
2021	575300	151500	726800	140	2023-08-17
2020	531800	156000	687800	140	2023-08-17
2022	183800	209900	393700	142	2023-08-17
2021	183800	209900	393700	142	2023-08-17
2020	190500	184600	375100	142	2023-08-17
2022	334100	206900	541000	143	2023-08-17
2021	334100	206900	541000	143	2023-08-17
2020	289400	181800	471200	143	2023-08-17
2022	145200	133000	278200	144	2023-08-17
2021	144800	133000	277800	144	2023-08-17
2020	138000	111800	249800	144	2023-08-17
2022	163800	142700	306500	148	2023-08-17
2021	163800	142700	306500	148	2023-08-17
2020	138200	108700	246900	148	2023-08-17
2022	385600	171200	556800	149	2023-08-17
2021	385600	171200	556800	149	2023-08-17
2020	290200	130100	420300	149	2023-08-17
2022	410700	170200	580900	150	2023-08-17
2021	410700	170200	580900	150	2023-08-17
2020	124300	129200	253500	150	2023-08-17
2022	0	218500	218500	151	2023-08-17
2021	0	218500	218500	151	2023-08-17
2020	0	137300	137300	151	2023-08-17
2022	176000	84800	260800	152	2023-08-17
2021	175200	84800	260000	152	2023-08-17
2020	130800	70400	201200	152	2023-08-17
2022	149400	111300	260700	153	2023-08-17
2021	149400	111300	260700	153	2023-08-17
2020	138400	90300	228700	153	2023-08-17
2022	82500	82400	164900	154	2023-08-17
2021	82500	82400	164900	154	2023-08-17
2020	66800	72000	138800	154	2023-08-17
2022	21200	166100	187300	159	2023-08-17
2021	21200	166100	187300	159	2023-08-17
2020	17900	127200	145100	159	2023-08-17
2022	562100	219600	781700	161	2023-08-17
2021	562100	219600	781700	161	2023-08-17
2020	592300	158900	751200	161	2023-08-17
2022	165400	126800	292200	162	2023-08-17
2021	165400	126800	292200	162	2023-08-17
2020	165400	97100	262500	162	2023-08-17
2022	269600	158900	428500	163	2023-08-17
2021	269600	158900	428500	163	2023-08-17
2020	298800	97300	396100	163	2023-08-17
2022	46200	98300	144500	164	2023-08-17
2021	46200	98300	144500	164	2023-08-17
2020	38900	83100	122000	164	2023-08-17
2022	289300	224000	513300	167	2023-08-17
2021	289300	224000	513300	167	2023-08-17
2020	279800	110300	390100	167	2023-08-17
2022	174500	129600	304100	168	2023-08-17
2021	174500	129600	304100	168	2023-08-17
2020	146700	98800	245500	168	2023-08-17
2022	154200	111100	265300	169	2023-08-17
2021	154200	111100	265300	169	2023-08-17
2020	130800	92200	223000	169	2023-08-17
2022	1225500	266800	1492300	170	2023-08-17
2021	1225500	266800	1492300	170	2023-08-17
2020	1095300	204200	1299500	170	2023-08-17
2022	0	200	200	171	2023-08-17
2021	0	200	200	171	2023-08-17
2020	0	200	200	171	2023-08-17
2022	0	300	300	172	2023-08-17
2021	0	300	300	172	2023-08-17
2020	0	300	300	172	2023-08-17
2022	465200	146600	611800	173	2023-08-17
2021	465200	154000	619200	173	2023-08-17
2020	361400	117800	479200	173	2023-08-17
2022	152300	132200	284500	174	2023-08-17
2021	152300	132200	284500	174	2023-08-17
2020	136900	100500	237400	174	2023-08-17
2022	156600	137900	294500	176	2023-08-17
2021	156600	137900	294500	176	2023-08-17
2020	116500	105000	221500	176	2023-08-17
2022	81400	129800	211200	177	2023-08-17
2021	85100	129800	214900	177	2023-08-17
2020	92300	88300	180600	177	2023-08-17
2022	231800	126600	358400	178	2023-08-17
2021	231800	126600	358400	178	2023-08-17
2020	205300	97000	302300	178	2023-08-17
2022	149400	138100	287500	179	2023-08-17
2021	149400	138100	287500	179	2023-08-17
2020	140700	105200	245900	179	2023-08-17
2022	597800	214300	812100	180	2023-08-17
2021	597800	214300	812100	180	2023-08-17
2020	557700	225900	783600	180	2023-08-17
2022	0	2500	2500	181	2023-08-17
2021	0	2500	2500	181	2023-08-17
2020	0	2400	2400	181	2023-08-17
2022	507900	178200	686100	182	2023-08-17
2021	507900	178200	686100	182	2023-08-17
2020	520800	227800	748600	182	2023-08-17
2022	282900	103000	385900	183	2023-08-17
2021	10900	103000	113900	183	2023-08-17
2020	12500	67000	79500	183	2023-08-17
2022	314000	170900	484900	187	2023-08-17
2021	351200	193100	544300	187	2023-08-17
2020	259400	131200	390600	187	2023-08-17
2022	613900	260000	873900	188	2023-08-17
2021	329500	218400	547900	188	2023-08-17
2020	234300	161800	396100	188	2023-08-17
2022	8500	44800	53300	189	2023-08-17
2021	8500	44800	53300	189	2023-08-17
2020	7800	35200	43000	189	2023-08-17
2022	0	1000	1000	190	2023-08-17
2021	0	1000	1000	190	2023-08-17
2020	0	1000	1000	190	2023-08-17
2022	0	6000	6000	191	2023-08-17
2021	0	6000	6000	191	2023-08-17
2020	0	6000	6000	191	2023-08-17
2022	0	25500	25500	192	2023-08-17
2021	0	25500	25500	192	2023-08-17
2020	0	25500	25500	192	2023-08-17
2022	0	100	100	194	2023-08-17
2021	0	100	100	194	2023-08-17
2020	0	100	100	194	2023-08-17
2022	343500	176200	519700	195	2023-08-17
2021	343500	176200	519700	195	2023-08-17
2020	328100	138000	466100	195	2023-08-17
2022	0	2500	2500	197	2023-08-17
2021	0	2500	2500	197	2023-08-17
2020	0	2500	2500	197	2023-08-17
2022	322700	134800	457500	201	2023-08-17
2021	322700	134800	457500	201	2023-08-17
2020	350000	101500	451500	201	2023-08-17
2022	418600	293300	711900	202	2023-08-17
2021	392300	293300	685600	202	2023-08-17
2020	377800	227900	605700	202	2023-08-17
2022	232400	125100	357500	203	2023-08-17
2021	232400	125100	357500	203	2023-08-17
2020	195200	93600	288800	203	2023-08-17
2022	396000	324800	720800	204	2023-08-17
2021	396000	324800	720800	204	2023-08-17
2020	256600	173200	429800	204	2023-08-17
2022	606800	135800	742600	206	2023-08-17
2021	606800	135800	742600	206	2023-08-17
2020	566800	103200	670000	206	2023-08-17
2022	1700	52700	54400	207	2023-08-17
2021	1700	52700	54400	207	2023-08-17
2020	1500	52700	54200	207	2023-08-17
2022	180600	142400	323000	208	2023-08-17
2021	180600	142400	323000	208	2023-08-17
2020	172800	98300	271100	208	2023-08-17
2022	124500	143300	267800	209	2023-08-17
2021	119000	143300	262300	209	2023-08-17
2020	102800	99100	201900	209	2023-08-17
2022	193800	143300	337100	210	2023-08-17
2021	193800	143300	337100	210	2023-08-17
2020	186600	99100	285700	210	2023-08-17
2022	0	2600	2600	217	2023-08-17
2021	0	2600	2600	217	2023-08-17
2020	0	2600	2600	217	2023-08-17
2022	176100	164500	340600	219	2023-08-17
2021	176100	164500	340600	219	2023-08-17
2020	189400	99100	288500	219	2023-08-17
2022	180400	108100	288500	220	2023-08-17
2021	180400	108100	288500	220	2023-08-17
2020	140700	82700	223400	220	2023-08-17
2022	221900	95600	317500	221	2023-08-17
2021	221900	95600	317500	221	2023-08-17
2020	173600	73500	247100	221	2023-08-17
2022	269100	168700	437800	222	2023-08-17
2021	269100	168700	437800	222	2023-08-17
2020	232300	126700	359000	222	2023-08-17
2022	334100	125900	460000	223	2023-08-17
2021	322900	125900	448800	223	2023-08-17
2020	288000	113500	401500	223	2023-08-17
2022	234300	215300	449600	224	2023-08-17
2021	234300	215300	449600	224	2023-08-17
2020	222000	167900	389900	224	2023-08-17
2022	86100	176600	262700	225	2023-08-17
2021	86100	176600	262700	225	2023-08-17
2020	73100	113900	187000	225	2023-08-17
2022	312700	179600	492300	229	2023-08-17
2021	312700	179600	492300	229	2023-08-17
2020	290000	105400	395400	229	2023-08-17
2022	0	2800	2800	230	2023-08-17
2021	0	2800	2800	230	2023-08-17
2020	0	2800	2800	230	2023-08-17
2022	82800	91300	174100	231	2023-08-17
2021	82800	91300	174100	231	2023-08-17
2020	57100	69500	126600	231	2023-08-17
2022	72200	57800	130000	232	2023-08-17
2021	72200	57800	130000	232	2023-08-17
2020	54200	52500	106700	232	2023-08-17
2022	81500	65100	146600	233	2023-08-17
2021	81500	65100	146600	233	2023-08-17
2020	59900	59000	118900	233	2023-08-17
2022	228500	134400	362900	234	2023-08-17
2021	228500	134400	362900	234	2023-08-17
2020	234500	78100	312600	234	2023-08-17
2022	455900	169300	625200	235	2023-08-17
2021	455900	169300	625200	235	2023-08-17
2020	403100	107900	511000	235	2023-08-17
2022	184400	119700	304100	236	2023-08-17
2021	184400	119700	304100	236	2023-08-17
2020	152400	67800	220200	236	2023-08-17
2022	45100	88200	133300	237	2023-08-17
2021	45100	88200	133300	237	2023-08-17
2020	39500	53000	92500	237	2023-08-17
2022	149100	133300	282400	238	2023-08-17
2021	149100	133300	282400	238	2023-08-17
2020	108100	93500	201600	238	2023-08-17
2022	143900	163300	307200	241	2023-08-17
2021	143900	163300	307200	241	2023-08-17
2020	120900	116900	237800	241	2023-08-17
2022	0	900	900	243	2023-08-17
2021	0	900	900	243	2023-08-17
2020	0	900	900	243	2023-08-17
2022	0	800	800	244	2023-08-17
2021	0	800	800	244	2023-08-17
2020	0	700	700	244	2023-08-17
2022	193200	115700	308900	245	2023-08-17
2021	193200	115700	308900	245	2023-08-17
2020	98100	86300	184400	245	2023-08-17
2022	0	6200	6200	246	2023-08-17
2021	0	6200	6200	246	2023-08-17
2020	0	6200	6200	246	2023-08-17
2022	13400	149200	162600	247	2023-08-17
2021	13400	149200	162600	247	2023-08-17
2020	10400	92900	103300	247	2023-08-17
2022	126300	137700	264000	248	2023-08-17
2021	126300	137700	264000	248	2023-08-17
2020	144000	105500	249500	248	2023-08-17
2022	155900	144300	300200	249	2023-08-17
2021	155900	144300	300200	249	2023-08-17
2020	167400	122000	289400	249	2023-08-17
2022	0	2700	2700	250	2023-08-17
2021	0	2700	2700	250	2023-08-17
2020	0	2700	2700	250	2023-08-17
2022	367000	232200	599200	251	2023-08-17
2021	367000	232200	599200	251	2023-08-17
2020	163700	182600	346300	251	2023-08-17
2022	176700	144300	321000	252	2023-08-17
2021	176700	144300	321000	252	2023-08-17
2020	155600	94600	250200	252	2023-08-17
2022	212100	150400	362500	253	2023-08-17
2021	212100	150400	362500	253	2023-08-17
2020	187200	116400	303600	253	2023-08-17
2022	356800	150800	507600	254	2023-08-17
2021	356800	150800	507600	254	2023-08-17
2020	243100	117600	360700	254	2023-08-17
2022	471100	129400	600500	255	2023-08-17
2021	435400	129400	564800	255	2023-08-17
2020	188200	99500	287700	255	2023-08-17
2022	1367900	364300	1732200	256	2023-08-17
2021	1367900	364300	1732200	256	2023-08-17
2020	1251500	237700	1489200	256	2023-08-17
2022	56900	130700	187600	257	2023-08-17
2021	56900	130700	187600	257	2023-08-17
2020	67900	100700	168600	257	2023-08-17
2022	378800	0	378800	258	2023-08-17
2021	378800	0	378800	258	2023-08-17
2020	347600	0	347600	258	2023-08-17
2022	2454700	592700	3047400	259	2023-08-17
2021	2454700	592700	3047400	259	2023-08-17
2020	2190400	492700	2683100	259	2023-08-17
2022	82600	164500	247100	260	2023-08-17
2021	82600	164500	247100	260	2023-08-17
2020	61100	157300	218400	260	2023-08-17
2022	66900	122600	189500	267	2023-08-17
2021	66900	122600	189500	267	2023-08-17
2020	36300	96600	132900	267	2023-08-17
2022	54400	117800	172200	270	2023-08-17
2021	54400	117800	172200	270	2023-08-17
2020	33700	92300	126000	270	2023-08-17
2022	293800	127600	421400	271	2023-08-17
2021	293800	127600	421400	271	2023-08-17
2020	313300	78200	391500	271	2023-08-17
2022	0	11300	11300	272	2023-08-17
2021	0	11300	11300	272	2023-08-17
2020	0	9000	9000	272	2023-08-17
2022	32800	100700	133500	273	2023-08-17
2021	32800	100700	133500	273	2023-08-17
2020	25700	69300	95000	273	2023-08-17
2022	230700	139000	369700	274	2023-08-17
2021	230700	139000	369700	274	2023-08-17
2020	197900	101700	299600	274	2023-08-17
2022	15500	109800	125300	275	2023-08-17
2021	30200	109800	140000	275	2023-08-17
2020	14200	84200	98400	275	2023-08-17
2022	133100	173400	306500	276	2023-08-17
2021	133100	173400	306500	276	2023-08-17
2020	122700	167400	290100	276	2023-08-17
2022	0	1500	1500	277	2023-08-17
2021	0	1500	1500	277	2023-08-17
2020	0	1500	1500	277	2023-08-17
2022	147100	180500	327600	278	2023-08-17
2021	159300	191000	350300	278	2023-08-17
2020	72200	168600	240800	278	2023-08-17
2022	161300	176800	338100	279	2023-08-17
2021	161300	176800	338100	279	2023-08-17
2020	123600	148700	272300	279	2023-08-17
2022	0	8400	8400	280	2023-08-17
2021	0	8400	8400	280	2023-08-17
2020	0	8400	8400	280	2023-08-17
2022	25500	171600	197100	283	2023-08-17
2021	25500	171600	197100	283	2023-08-17
2020	32600	130600	163200	283	2023-08-17
2022	566500	297100	863600	287	2023-08-17
2021	566500	297100	863600	287	2023-08-17
2020	518800	278200	797000	287	2023-08-17
2022	245600	328100	573700	288	2023-08-17
2021	245600	328100	573700	288	2023-08-17
2020	204100	307200	511300	288	2023-08-17
2022	618200	290500	908700	290	2023-08-17
2021	618200	290500	908700	290	2023-08-17
2020	269000	281000	550000	290	2023-08-17
2022	0	6400	6400	291	2023-08-17
2021	0	6400	6400	291	2023-08-17
2020	0	6400	6400	291	2023-08-17
2022	376500	174000	550500	292	2023-08-17
2021	376400	174100	550500	292	2023-08-17
2020	317300	137000	454300	292	2023-08-17
2022	411100	180800	591900	294	2023-08-17
2021	411100	180800	591900	294	2023-08-17
2020	378500	138900	517400	294	2023-08-17
2022	132400	104100	236500	295	2023-08-17
2021	132400	104100	236500	295	2023-08-17
2020	130300	90500	220800	295	2023-08-17
2022	131100	0	131100	296	2023-08-17
2021	131100	0	131100	296	2023-08-17
2020	127600	0	127600	296	2023-08-17
2022	40800	88400	129200	297	2023-08-17
2021	40800	88400	129200	297	2023-08-17
2020	31400	70400	101800	297	2023-08-17
2022	168100	118200	286300	298	2023-08-17
2021	168100	118200	286300	298	2023-08-17
2020	130400	95400	225800	298	2023-08-17
2022	108200	133400	241600	299	2023-08-17
2021	108200	133400	241600	299	2023-08-17
2020	100300	95400	195700	299	2023-08-17
2022	116500	93400	209900	300	2023-08-17
2021	116500	93400	209900	300	2023-08-17
2020	105200	84900	190100	300	2023-08-17
2022	197200	148800	346000	301	2023-08-17
2021	197200	148800	346000	301	2023-08-17
2020	150800	112000	262800	301	2023-08-17
2022	392100	179200	571300	303	2023-08-17
2021	392100	179200	571300	303	2023-08-17
2020	310800	142900	453700	303	2023-08-17
2022	252100	220000	472100	306	2023-08-17
2021	254500	220000	474500	306	2023-08-17
2020	173800	201400	375200	306	2023-08-17
2022	498100	260400	758500	307	2023-08-17
2021	498100	260400	758500	307	2023-08-17
2020	498800	229400	728200	307	2023-08-17
2022	280100	196600	476700	308	2023-08-17
2021	280100	196600	476700	308	2023-08-17
2020	274500	150300	424800	308	2023-08-17
2022	283000	306800	589800	309	2023-08-17
2021	283000	306800	589800	309	2023-08-17
2020	264700	232900	497600	309	2023-08-17
2022	511300	183400	694700	310	2023-08-17
2021	511300	183400	694700	310	2023-08-17
2020	475100	178800	653900	310	2023-08-17
2022	0	15600	15600	311	2023-08-17
2021	0	15600	15600	311	2023-08-17
2020	0	15600	15600	311	2023-08-17
2022	675600	430100	1105700	313	2023-08-17
2021	675600	430100	1105700	313	2023-08-17
2020	606600	485300	1091900	313	2023-08-17
2022	484200	174900	659100	315	2023-08-17
2021	484200	174900	659100	315	2023-08-17
2020	437000	136800	573800	315	2023-08-17
2022	229500	180700	410200	316	2023-08-17
2021	229500	180700	410200	316	2023-08-17
2020	228100	143200	371300	316	2023-08-17
2022	361800	152900	514700	317	2023-08-17
2021	361800	152900	514700	317	2023-08-17
2020	361600	127700	489300	317	2023-08-17
2022	381800	222900	604700	319	2023-08-17
2021	381800	222900	604700	319	2023-08-17
2020	351600	172500	524100	319	2023-08-17
2022	0	9700	9700	320	2023-08-17
2021	0	9700	9700	320	2023-08-17
2020	0	9700	9700	320	2023-08-17
2022	74900	140500	215400	321	2023-08-17
2021	74900	140500	215400	321	2023-08-17
2020	67200	99000	166200	321	2023-08-17
2022	0	151200	151200	322	2023-08-17
2021	0	151200	151200	322	2023-08-17
2020	0	115400	115400	322	2023-08-17
2022	150100	143800	293900	323	2023-08-17
2021	149300	143800	293100	323	2023-08-17
2020	119400	110400	229800	323	2023-08-17
2022	319900	137800	457700	324	2023-08-17
2021	319900	137800	457700	324	2023-08-17
2020	303200	99600	402800	324	2023-08-17
2022	750700	251100	1001800	325	2023-08-17
2021	750700	251100	1001800	325	2023-08-17
2020	713100	197900	911000	325	2023-08-17
2022	327800	180100	507900	326	2023-08-17
2021	327800	180100	507900	326	2023-08-17
2020	338700	138200	476900	326	2023-08-17
2022	252500	153200	405700	327	2023-08-17
2021	244400	153200	397600	327	2023-08-17
2020	166900	103600	270500	327	2023-08-17
2022	178800	161000	339800	328	2023-08-17
2021	178800	161000	339800	328	2023-08-17
2020	201300	124200	325500	328	2023-08-17
2022	110800	93200	204000	329	2023-08-17
2021	130800	93200	224000	329	2023-08-17
2020	105000	83900	188900	329	2023-08-17
2022	216200	134000	350200	330	2023-08-17
2021	228000	134000	362000	330	2023-08-17
2020	176300	100700	277000	330	2023-08-17
2022	62500	131800	194300	331	2023-08-17
2021	62500	131800	194300	331	2023-08-17
2020	75800	95300	171100	331	2023-08-17
2022	0	15700	15700	333	2023-08-17
2021	0	15700	15700	333	2023-08-17
2020	0	12100	12100	333	2023-08-17
2022	459600	175600	635200	334	2023-08-17
2021	459600	175600	635200	334	2023-08-17
2020	375400	154800	530200	334	2023-08-17
2022	103500	157100	260600	335	2023-08-17
2021	103500	157100	260600	335	2023-08-17
2020	121500	119100	240600	335	2023-08-17
2022	210700	158300	369000	336	2023-08-17
2021	210700	158300	369000	336	2023-08-17
2020	205600	120200	325800	336	2023-08-17
2022	630400	197400	827800	337	2023-08-17
2021	630400	197400	827800	337	2023-08-17
2020	656400	120600	777000	337	2023-08-17
2022	153000	140300	293300	339	2023-08-17
2021	153000	140300	293300	339	2023-08-17
2020	170300	89400	259700	339	2023-08-17
2022	382600	176700	559300	340	2023-08-17
2021	389200	199000	588200	340	2023-08-17
2020	350400	132800	483200	340	2023-08-17
2022	191600	123800	315400	341	2023-08-17
2021	191600	123800	315400	341	2023-08-17
2020	149100	80700	229800	341	2023-08-17
2022	238400	197200	435600	343	2023-08-17
2021	238400	197200	435600	343	2023-08-17
2020	220700	159000	379700	343	2023-08-17
2022	265500	109500	375000	344	2023-08-17
2021	265500	109500	375000	344	2023-08-17
2020	178700	100400	279100	344	2023-08-17
2022	288300	153300	441600	345	2023-08-17
2021	288300	153300	441600	345	2023-08-17
2020	248600	119100	367700	345	2023-08-17
2022	256900	159200	416100	346	2023-08-17
2021	256900	159200	416100	346	2023-08-17
2020	195900	119000	314900	346	2023-08-17
2022	8800	18600	27400	347	2023-08-17
2021	8800	18600	27400	347	2023-08-17
2020	8200	16000	24200	347	2023-08-17
2022	287400	149400	436800	348	2023-08-17
2021	287400	149400	436800	348	2023-08-17
2020	301800	115500	417300	348	2023-08-17
2022	0	102600	102600	349	2023-08-17
2021	0	102600	102600	349	2023-08-17
2020	0	93300	93300	349	2023-08-17
2022	0	52200	52200	350	2023-08-17
2021	0	52200	52200	350	2023-08-17
2020	0	45700	45700	350	2023-08-17
2022	284700	148900	433600	351	2023-08-17
2021	284700	148900	433600	351	2023-08-17
2020	276100	115000	391100	351	2023-08-17
2022	0	330300	330300	355	2023-08-17
2021	0	330300	330300	355	2023-08-17
2020	0	279100	279100	355	2023-08-17
2022	0	159000	159000	357	2023-08-17
2021	0	159000	159000	357	2023-08-17
2020	0	124500	124500	357	2023-08-17
2022	0	9300	9300	358	2023-08-17
2021	0	9300	9300	358	2023-08-17
2020	0	8400	8400	358	2023-08-17
2022	92400	135100	227500	359	2023-08-17
2021	92400	135100	227500	359	2023-08-17
2020	71900	97200	169100	359	2023-08-17
2022	128100	101800	229900	360	2023-08-17
2021	128100	101800	229900	360	2023-08-17
2020	93600	84300	177900	360	2023-08-17
2022	344600	156600	501200	361	2023-08-17
2021	344600	156600	501200	361	2023-08-17
2020	315000	120400	435400	361	2023-08-17
2022	392400	128100	520500	363	2023-08-17
2021	391000	128100	519100	363	2023-08-17
2020	314800	108300	423100	363	2023-08-17
2022	114400	98300	212700	364	2023-08-17
2021	114400	98300	212700	364	2023-08-17
2020	83300	72900	156200	364	2023-08-17
2022	544900	257400	802300	365	2023-08-17
2021	544900	257400	802300	365	2023-08-17
2020	538500	204500	743000	365	2023-08-17
2022	242900	111700	354600	368	2023-08-17
2021	242900	111700	354600	368	2023-08-17
2020	238100	102400	340500	368	2023-08-17
2022	477100	240900	718000	369	2023-08-17
2021	477100	240900	718000	369	2023-08-17
2020	450900	244500	695400	369	2023-08-17
2022	0	312000	312000	370	2023-08-17
2021	0	312000	312000	370	2023-08-17
2020	0	255600	255600	370	2023-08-17
2022	342300	166800	509100	371	2023-08-17
2021	342300	166800	509100	371	2023-08-17
2020	323100	154400	477500	371	2023-08-17
2022	219900	208700	428600	372	2023-08-17
2021	219900	208700	428600	372	2023-08-17
2020	209400	199900	409300	372	2023-08-17
2022	0	244100	244100	375	2023-08-17
2021	0	303100	303100	375	2023-08-17
2020	0	156600	156600	375	2023-08-17
2022	387900	163300	551200	376	2023-08-17
2021	387900	163300	551200	376	2023-08-17
2020	330500	144100	474600	376	2023-08-17
2022	34900	148800	183700	377	2023-08-17
2021	34900	148800	183700	377	2023-08-17
2020	42400	102100	144500	377	2023-08-17
2022	345600	142700	488300	378	2023-08-17
2021	345600	142700	488300	378	2023-08-17
2020	266300	122400	388700	378	2023-08-17
2022	65300	118000	183300	379	2023-08-17
2021	60600	118000	178600	379	2023-08-17
2020	39200	104100	143300	379	2023-08-17
2022	184800	157400	342200	380	2023-08-17
2021	184800	157400	342200	380	2023-08-17
2020	156000	125500	281500	380	2023-08-17
2022	73000	107800	180800	381	2023-08-17
2021	73000	107800	180800	381	2023-08-17
2020	61200	86800	148000	381	2023-08-17
2022	150900	158900	309800	382	2023-08-17
2021	150900	158900	309800	382	2023-08-17
2020	131200	139200	270400	382	2023-08-17
2022	0	5000	5000	383	2023-08-17
2021	0	5000	5000	383	2023-08-17
2020	0	5000	5000	383	2023-08-17
2022	115100	241800	356900	384	2023-08-17
2021	115100	241800	356900	384	2023-08-17
2020	34500	226600	261100	384	2023-08-17
2022	285900	172600	458500	385	2023-08-17
2021	285900	172600	458500	385	2023-08-17
2020	248400	188900	437300	385	2023-08-17
2022	0	32300	32300	387	2023-08-17
2021	0	32300	32300	387	2023-08-17
2020	0	23100	23100	387	2023-08-17
2022	0	73500	73500	388	2023-08-17
2021	0	73500	73500	388	2023-08-17
2020	0	60800	60800	388	2023-08-17
2022	267800	112600	380400	389	2023-08-17
2021	267800	112600	380400	389	2023-08-17
2020	266600	100400	367000	389	2023-08-17
2022	0	454600	454600	390	2023-08-17
2021	0	454600	454600	390	2023-08-17
2020	0	397500	397500	390	2023-08-17
2022	147800	321300	469100	391	2023-08-17
2021	147800	321300	469100	391	2023-08-17
2020	78600	252200	330800	391	2023-08-17
2022	490000	360400	850400	392	2023-08-17
2021	490100	360300	850400	392	2023-08-17
2020	439200	285600	724800	392	2023-08-17
2022	371100	355400	726500	394	2023-08-17
2021	371100	355400	726500	394	2023-08-17
2020	366000	281200	647200	394	2023-08-17
2022	332100	335700	667800	395	2023-08-17
2021	319100	335700	654800	395	2023-08-17
2020	289500	314100	603600	395	2023-08-17
2022	777200	1621300	2398500	398	2023-08-17
2021	777200	1621300	2398500	398	2023-08-17
2020	601100	327800	928900	398	2023-08-17
2022	354400	297700	652100	399	2023-08-17
2021	352100	297700	649800	399	2023-08-17
2020	312000	312000	624000	399	2023-08-17
2022	339100	163100	502200	400	2023-08-17
2021	339100	163100	502200	400	2023-08-17
2020	312500	136600	449100	400	2023-08-17
2022	0	1188900	1188900	401	2023-08-17
2021	0	1188900	1188900	401	2023-08-17
2020	0	1058500	1058500	401	2023-08-17
2022	1367100	1205000	2572100	402	2023-08-17
2021	1367100	1205000	2572100	402	2023-08-17
2020	1353500	950900	2304400	402	2023-08-17
2022	146300	143300	289600	405	2023-08-17
2021	147800	143300	291100	405	2023-08-17
2020	109200	109200	218400	405	2023-08-17
2022	0	13900	13900	407	2023-08-17
2021	0	13900	13900	407	2023-08-17
2020	0	13900	13900	407	2023-08-17
2022	171500	148500	320000	408	2023-08-17
2021	171500	148500	320000	408	2023-08-17
2020	139800	163400	303200	408	2023-08-17
2022	242800	212800	455600	415	2023-08-17
2021	242800	212800	455600	415	2023-08-17
2020	184700	163900	348600	415	2023-08-17
2022	34800	20900	55700	417	2023-08-17
2021	34800	20900	55700	417	2023-08-17
2020	34200	17400	51600	417	2023-08-17
2022	432100	205700	637800	418	2023-08-17
2021	442900	205700	648600	418	2023-08-17
2020	404000	207500	611500	418	2023-08-17
2022	317000	162800	479800	427	2023-08-17
2021	317000	162800	479800	427	2023-08-17
2020	260700	131000	391700	427	2023-08-17
2022	553700	172400	726100	429	2023-08-17
2021	553700	172400	726100	429	2023-08-17
2020	474700	240800	715500	429	2023-08-17
2022	0	23700	23700	432	2023-08-17
2021	0	23700	23700	432	2023-08-17
2020	0	19200	19200	432	2023-08-17
2022	37700	104500	142200	433	2023-08-17
2021	37700	104500	142200	433	2023-08-17
2020	53300	76500	129800	433	2023-08-17
2022	58600	184300	242900	434	2023-08-17
2021	58600	184300	242900	434	2023-08-17
2020	50400	122300	172700	434	2023-08-17
2022	104100	221200	325300	435	2023-08-17
2021	104100	221200	325300	435	2023-08-17
2020	112300	164300	276600	435	2023-08-17
2022	57700	187000	244700	436	2023-08-17
2021	60300	205800	266100	436	2023-08-17
2020	37300	165200	202500	436	2023-08-17
2022	682800	378100	1060900	437	2023-08-17
2021	674600	378100	1052700	437	2023-08-17
2020	475100	298400	773500	437	2023-08-17
2022	308800	261700	570500	438	2023-08-17
2021	308800	261700	570500	438	2023-08-17
2020	254000	232800	486800	438	2023-08-17
2022	0	6400	6400	439	2023-08-17
2021	0	6400	6400	439	2023-08-17
2020	0	5000	5000	439	2023-08-17
2022	53000	228900	281900	440	2023-08-17
2021	53000	228900	281900	440	2023-08-17
2020	43900	179000	222900	440	2023-08-17
2022	404100	455200	859300	441	2023-08-17
2021	393000	455200	848200	441	2023-08-17
2020	382300	346700	729000	441	2023-08-17
2022	229500	196700	426200	442	2023-08-17
2021	229500	196700	426200	442	2023-08-17
2020	240600	162200	402800	442	2023-08-17
2022	417800	216600	634400	446	2023-08-17
2021	417800	216600	634400	446	2023-08-17
2020	433400	302800	736200	446	2023-08-17
2022	191200	228500	419700	447	2023-08-17
2021	191200	228500	419700	447	2023-08-17
2020	151800	246200	398000	447	2023-08-17
2022	396900	255400	652300	448	2023-08-17
2021	396900	255400	652300	448	2023-08-17
2020	379100	188000	567100	448	2023-08-17
2022	561400	403400	964800	450	2023-08-17
2021	561400	397300	958700	450	2023-08-17
2020	483000	396900	879900	450	2023-08-17
2022	586600	243800	830400	454	2023-08-17
2021	586400	243800	830200	454	2023-08-17
2020	471100	216400	687500	454	2023-08-17
2022	818800	225700	1044500	457	2023-08-17
2021	818800	225700	1044500	457	2023-08-17
2020	666000	293700	959700	457	2023-08-17
2022	234800	272600	507400	458	2023-08-17
2021	234800	272600	507400	458	2023-08-17
2020	239700	235400	475100	458	2023-08-17
2022	293400	192000	485400	459	2023-08-17
2021	293400	192000	485400	459	2023-08-17
2020	235200	206500	441700	459	2023-08-17
2022	479100	201800	680900	460	2023-08-17
2021	479100	201800	680900	460	2023-08-17
2020	391500	167100	558600	460	2023-08-17
2022	714600	233100	947700	461	2023-08-17
2021	673400	233000	906400	461	2023-08-17
2020	299300	178200	477500	461	2023-08-17
2022	544600	192700	737300	462	2023-08-17
2021	544600	192700	737300	462	2023-08-17
2020	438100	119400	557500	462	2023-08-17
2022	0	4200	4200	463	2023-08-17
2021	0	4200	4200	463	2023-08-17
2020	0	4200	4200	463	2023-08-17
2022	0	12300	12300	465	2023-08-17
2021	0	12300	12300	465	2023-08-17
2020	0	12300	12300	465	2023-08-17
2022	725500	271500	997000	469	2023-08-17
2021	725500	271500	997000	469	2023-08-17
2020	598800	240800	839600	469	2023-08-17
2022	715000	175300	890300	472	2023-08-17
2021	715000	175300	890300	472	2023-08-17
2020	586900	154400	741300	472	2023-08-17
2022	535100	210400	745500	473	2023-08-17
2021	535100	210400	745500	473	2023-08-17
2020	427400	186100	613500	473	2023-08-17
2022	358800	200000	558800	474	2023-08-17
2021	358800	200000	558800	474	2023-08-17
2020	322500	176700	499200	474	2023-08-17
2022	472000	214600	686600	475	2023-08-17
2021	472000	214600	686600	475	2023-08-17
2020	492300	168200	660500	475	2023-08-17
2022	285600	192300	477900	476	2023-08-17
2021	285600	192300	477900	476	2023-08-17
2020	261600	155100	416700	476	2023-08-17
2022	270800	190600	461400	478	2023-08-17
2021	270800	190500	461300	478	2023-08-17
2020	218200	207000	425200	478	2023-08-17
2022	750500	307800	1058300	479	2023-08-17
2021	750500	307800	1058300	479	2023-08-17
2020	724800	309400	1034200	479	2023-08-17
2022	233500	162300	395800	480	2023-08-17
2021	247100	162300	409400	480	2023-08-17
2020	182700	129000	311700	480	2023-08-17
2022	308300	154600	462900	482	2023-08-17
2021	308300	154600	462900	482	2023-08-17
2020	302700	122100	424800	482	2023-08-17
2022	0	700	700	483	2023-08-17
2021	0	700	700	483	2023-08-17
2020	0	600	600	483	2023-08-17
2022	431700	182200	613900	484	2023-08-17
2021	431700	182200	613900	484	2023-08-17
2020	387300	164200	551500	484	2023-08-17
2022	367800	218100	585900	486	2023-08-17
2021	367800	218100	585900	486	2023-08-17
2020	269200	196800	466000	486	2023-08-17
2022	165100	180000	345100	487	2023-08-17
2021	165100	180000	345100	487	2023-08-17
2020	163300	162200	325500	487	2023-08-17
2022	309400	248800	558200	488	2023-08-17
2021	309400	248800	558200	488	2023-08-17
2020	228000	265200	493200	488	2023-08-17
2022	225500	253700	479200	489	2023-08-17
2021	225500	253700	479200	489	2023-08-17
2020	306000	244300	550300	489	2023-08-17
2022	289700	211700	501400	490	2023-08-17
2021	289700	211700	501400	490	2023-08-17
2020	195900	249200	445100	490	2023-08-17
2022	311300	222200	533500	491	2023-08-17
2021	311300	222100	533400	491	2023-08-17
2020	439800	259200	699000	491	2023-08-17
2022	146800	198600	345400	492	2023-08-17
2021	124500	198600	323100	492	2023-08-17
2020	112200	145600	257800	492	2023-08-17
2022	442700	257900	700600	493	2023-08-17
2021	442700	257900	700600	493	2023-08-17
2020	367000	295900	662900	493	2023-08-17
2022	978200	289400	1267600	494	2023-08-17
2021	978200	289300	1267500	494	2023-08-17
2020	888400	273600	1162000	494	2023-08-17
2022	308000	333700	641700	495	2023-08-17
2021	308000	333700	641700	495	2023-08-17
2020	240400	323400	563800	495	2023-08-17
2022	63500	199300	262800	501	2023-08-17
2021	63500	199300	262800	501	2023-08-17
2020	65000	159200	224200	501	2023-08-17
2022	704800	441000	1145800	505	2023-08-17
2021	704800	441000	1145800	505	2023-08-17
2020	615900	361700	977600	505	2023-08-17
2022	580400	356800	937200	506	2023-08-17
2021	580400	356800	937200	506	2023-08-17
2020	490100	315000	805100	506	2023-08-17
2022	321300	289200	610500	507	2023-08-17
2021	326000	284500	610500	507	2023-08-17
2020	283000	230900	513900	507	2023-08-17
2022	339400	260800	600200	509	2023-08-17
2021	339400	260800	600200	509	2023-08-17
2020	346600	229600	576200	509	2023-08-17
2022	406200	253700	659900	510	2023-08-17
2021	406200	253700	659900	510	2023-08-17
2020	383700	267900	651600	510	2023-08-17
2022	196100	212500	408600	511	2023-08-17
2021	196100	212500	408600	511	2023-08-17
2020	190500	202000	392500	511	2023-08-17
2022	0	10200	10200	512	2023-08-17
2021	0	10200	10200	512	2023-08-17
2020	0	10200	10200	512	2023-08-17
2022	275900	214600	490500	513	2023-08-17
2021	275900	214600	490500	513	2023-08-17
2020	233800	249000	482800	513	2023-08-17
2022	365300	278300	643600	514	2023-08-17
2021	365300	278300	643600	514	2023-08-17
2020	330700	302200	632900	514	2023-08-17
2022	173600	187700	361300	515	2023-08-17
2021	173600	187700	361300	515	2023-08-17
2020	156900	180400	337300	515	2023-08-17
2022	331700	181300	513000	517	2023-08-17
2021	331700	181300	513000	517	2023-08-17
2020	279200	171100	450300	517	2023-08-17
2022	290800	217800	508600	518	2023-08-17
2021	290800	217800	508600	518	2023-08-17
2020	275100	177700	452800	518	2023-08-17
2022	142100	156900	299000	519	2023-08-17
2021	142100	156900	299000	519	2023-08-17
2020	124600	125100	249700	519	2023-08-17
2022	482800	204900	687700	520	2023-08-17
2021	482800	204900	687700	520	2023-08-17
2020	392700	164000	556700	520	2023-08-17
2022	133200	162100	295300	522	2023-08-17
2021	133200	162100	295300	522	2023-08-17
2020	118100	116600	234700	522	2023-08-17
2022	133300	217300	350600	526	2023-08-17
2021	133300	217300	350600	526	2023-08-17
2020	112300	155900	268200	526	2023-08-17
2022	312700	207400	520100	527	2023-08-17
2021	312700	207400	520100	527	2023-08-17
2020	342300	166300	508600	527	2023-08-17
2022	159300	181700	341000	529	2023-08-17
2021	159300	181700	341000	529	2023-08-17
2020	138200	145200	283400	529	2023-08-17
2022	458500	287600	746100	530	2023-08-17
2021	458500	287600	746100	530	2023-08-17
2020	496700	247700	744400	530	2023-08-17
2022	58700	182400	241100	532	2023-08-17
2021	58700	182400	241100	532	2023-08-17
2020	54400	160700	215100	532	2023-08-17
2022	561200	195900	757100	533	2023-08-17
2021	561200	195900	757100	533	2023-08-17
2020	497900	258900	756800	533	2023-08-17
2022	544100	312100	856200	537	2023-08-17
2021	544100	312100	856200	537	2023-08-17
2020	601700	274900	876600	537	2023-08-17
2022	379300	175600	554900	538	2023-08-17
2021	377000	175600	552600	538	2023-08-17
2020	336800	176900	513700	538	2023-08-17
2022	296800	184500	481300	540	2023-08-17
2021	296800	184500	481300	540	2023-08-17
2020	244500	199900	444400	540	2023-08-17
2022	184300	147700	332000	542	2023-08-17
2021	177800	147700	325500	542	2023-08-17
2020	164900	130300	295200	542	2023-08-17
2022	0	1500	1500	543	2023-08-17
2021	0	1500	1500	543	2023-08-17
2020	0	1400	1400	543	2023-08-17
2022	62700	171200	233900	544	2023-08-17
2021	62700	171200	233900	544	2023-08-17
2020	47900	113500	161400	544	2023-08-17
2022	109800	168200	278000	545	2023-08-17
2021	102700	168200	270900	545	2023-08-17
2020	86300	111000	197300	545	2023-08-17
2022	115400	167300	282700	546	2023-08-17
2021	115400	167300	282700	546	2023-08-17
2020	107900	132900	240800	546	2023-08-17
2022	175800	185500	361300	547	2023-08-17
2021	175800	185500	361300	547	2023-08-17
2020	168900	156700	325600	547	2023-08-17
2022	3600	133400	137000	552	2023-08-17
2021	3600	133500	137100	552	2023-08-17
2020	3500	118200	121700	552	2023-08-17
2022	114900	203800	318700	557	2023-08-17
2021	114900	203800	318700	557	2023-08-17
2020	91600	151000	242600	557	2023-08-17
2022	45800	161200	207000	558	2023-08-17
2021	45800	161200	207000	558	2023-08-17
2020	50400	127300	177700	558	2023-08-17
2022	300300	147500	447800	559	2023-08-17
2021	300300	147500	447800	559	2023-08-17
2020	257700	179400	437100	559	2023-08-17
2022	123400	162900	286300	560	2023-08-17
2021	123400	162900	286300	560	2023-08-17
2020	123500	128700	252200	560	2023-08-17
2022	0	12200	12200	561	2023-08-17
2021	0	12200	12200	561	2023-08-17
2020	0	11900	11900	561	2023-08-17
2022	344200	236700	580900	563	2023-08-17
2021	344200	236700	580900	563	2023-08-17
2020	299500	204300	503800	563	2023-08-17
2022	497800	361900	859700	564	2023-08-17
2021	497800	362000	859800	564	2023-08-17
2020	421500	290600	712100	564	2023-08-17
2022	247800	263700	511500	565	2023-08-17
2021	247800	263700	511500	565	2023-08-17
2020	256000	188100	444100	565	2023-08-17
2022	730600	396100	1126700	569	2023-08-17
2021	732700	396100	1128800	569	2023-08-17
2020	802700	321300	1124000	569	2023-08-17
2022	184400	343600	528000	570	2023-08-17
2021	184400	343600	528000	570	2023-08-17
2020	138500	281900	420400	570	2023-08-17
2022	169100	180000	349100	571	2023-08-17
2021	169100	180000	349100	571	2023-08-17
2020	120400	158500	278900	571	2023-08-17
2022	155200	183900	339100	572	2023-08-17
2021	181000	183900	364900	572	2023-08-17
2020	31500	117100	148600	572	2023-08-17
2022	862000	884300	1746300	575	2023-08-17
2021	862000	884300	1746300	575	2023-08-17
2020	731800	537400	1269200	575	2023-08-17
2022	2084100	1274800	3358900	576	2023-08-17
2021	2084100	1349300	3433400	576	2023-08-17
2020	1802900	943100	2746000	576	2023-08-17
2022	881300	673600	1554900	578	2023-08-17
2021	881300	887500	1768800	578	2023-08-17
2020	931500	539800	1471300	578	2023-08-17
2022	443300	212000	655300	579	2023-08-17
2021	443300	212000	655300	579	2023-08-17
2020	360800	234300	595100	579	2023-08-17
2022	0	19300	19300	580	2023-08-17
2021	0	19300	19300	580	2023-08-17
2020	0	17500	17500	580	2023-08-17
2022	174700	246300	421000	581	2023-08-17
2021	169200	246300	415500	581	2023-08-17
2020	153400	246300	399700	581	2023-08-17
2022	1700400	406900	2107300	582	2023-08-17
2021	971900	406900	1378800	582	2023-08-17
2020	519000	278800	797800	582	2023-08-17
2022	561900	227200	789100	584	2023-08-17
2021	561900	227200	789100	584	2023-08-17
2020	454200	275500	729700	584	2023-08-17
2022	0	11200	11200	591	2023-08-17
2021	0	11200	11200	591	2023-08-17
2020	0	11200	11200	591	2023-08-17
2022	0	1000	1000	592	2023-08-17
2021	0	1000	1000	592	2023-08-17
2020	0	1000	1000	592	2023-08-17
2022	234800	290800	525600	593	2023-08-17
2021	234800	290800	525600	593	2023-08-17
2020	155100	257100	412200	593	2023-08-17
2022	541800	221200	763000	594	2023-08-17
2021	541800	221200	763000	594	2023-08-17
2020	459400	224800	684200	594	2023-08-17
2022	689900	302100	992000	597	2023-08-17
2021	689900	302100	992000	597	2023-08-17
2020	623600	288500	912100	597	2023-08-17
2022	0	35000	35000	598	2023-08-17
2021	0	35000	35000	598	2023-08-17
2020	0	30000	30000	598	2023-08-17
2022	133000	128800	261800	600	2023-08-17
2021	133000	128800	261800	600	2023-08-17
2020	137600	109600	247200	600	2023-08-17
2022	0	20600	20600	603	2023-08-17
2021	0	20600	20600	603	2023-08-17
2020	0	20600	20600	603	2023-08-17
2022	189700	133300	323000	605	2023-08-17
2021	189700	133300	323000	605	2023-08-17
2020	192500	100000	292500	605	2023-08-17
2022	243800	191800	435600	607	2023-08-17
2021	243800	191800	435600	607	2023-08-17
2020	236400	133400	369800	607	2023-08-17
2022	672000	166800	838800	611	2023-08-17
2021	672000	166800	838800	611	2023-08-17
2020	600800	150900	751700	611	2023-08-17
2022	403700	153200	556900	616	2023-08-17
2021	403700	153200	556900	616	2023-08-17
2020	285900	118900	404800	616	2023-08-17
2022	175400	155200	330600	617	2023-08-17
2021	153300	155200	308500	617	2023-08-17
2020	133900	126800	260700	617	2023-08-17
2022	83100	184500	267600	618	2023-08-17
2021	83100	184500	267600	618	2023-08-17
2020	89400	138000	227400	618	2023-08-17
2022	0	6900	6900	620	2023-08-17
2021	0	6900	6900	620	2023-08-17
2020	0	6900	6900	620	2023-08-17
2022	147500	142200	289700	621	2023-08-17
2021	147400	142200	289600	621	2023-08-17
2020	107100	114300	221400	621	2023-08-17
2022	97700	138300	236000	622	2023-08-17
2021	97700	138300	236000	622	2023-08-17
2020	94200	110600	204800	622	2023-08-17
2022	89500	147700	237200	623	2023-08-17
2021	89500	147700	237200	623	2023-08-17
2020	63100	99200	162300	623	2023-08-17
2022	301300	147600	448900	624	2023-08-17
2021	301300	147500	448800	624	2023-08-17
2020	281600	123900	405500	624	2023-08-17
2022	553700	220500	774200	625	2023-08-17
2021	553700	220500	774200	625	2023-08-17
2020	583700	191200	774900	625	2023-08-17
2022	428100	199300	627400	626	2023-08-17
2021	428100	199300	627400	626	2023-08-17
2020	317100	176300	493400	626	2023-08-17
2022	0	1100	1100	627	2023-08-17
2021	0	1100	1100	627	2023-08-17
2020	0	1100	1100	627	2023-08-17
2022	0	585800	585800	633	2023-08-17
2021	0	585800	585800	633	2023-08-17
2020	0	521100	521100	633	2023-08-17
2022	0	7700	7700	634	2023-08-17
2021	0	7700	7700	634	2023-08-17
2020	0	7700	7700	634	2023-08-17
2022	0	4200	4200	635	2023-08-17
2021	0	4200	4200	635	2023-08-17
2020	0	2900	2900	635	2023-08-17
2022	0	4200	4200	636	2023-08-17
2021	0	4200	4200	636	2023-08-17
2020	0	3300	3300	636	2023-08-17
2022	228800	81000	309800	637	2023-08-17
2021	228800	81000	309800	637	2023-08-17
2020	224000	48100	272100	637	2023-08-17
2022	279300	124600	403900	638	2023-08-17
2021	279300	124600	403900	638	2023-08-17
2020	267000	92700	359700	638	2023-08-17
2022	1610400	341100	1951500	639	2023-08-17
2021	1610400	341100	1951500	639	2023-08-17
2020	1516800	250100	1766900	639	2023-08-17
2022	0	40400	40400	643	2023-08-17
2021	0	40400	40400	643	2023-08-17
2020	0	37000	37000	643	2023-08-17
2022	243400	133300	376700	645	2023-08-17
2021	243400	133300	376700	645	2023-08-17
2020	240600	101500	342100	645	2023-08-17
2022	30000	258800	288800	647	2023-08-17
2021	30000	258800	288800	647	2023-08-17
2020	21600	185800	207400	647	2023-08-17
2022	838300	492700	1331000	648	2023-08-17
2021	838300	492700	1331000	648	2023-08-17
2020	685900	638500	1324400	648	2023-08-17
2022	318500	254900	573400	649	2023-08-17
2021	318500	254900	573400	649	2023-08-17
2020	282700	268400	551100	649	2023-08-17
2022	183500	235400	418900	650	2023-08-17
2021	183500	235400	418900	650	2023-08-17
2020	187900	222000	409900	650	2023-08-17
2022	183300	278100	461400	651	2023-08-17
2021	183300	278100	461400	651	2023-08-17
2020	180700	244500	425200	651	2023-08-17
2022	23900	208300	232200	652	2023-08-17
2021	23900	208300	232200	652	2023-08-17
2020	32100	154400	186500	652	2023-08-17
2022	68500	262400	330900	653	2023-08-17
2021	68500	262400	330900	653	2023-08-17
2020	94600	198400	293000	653	2023-08-17
2022	107000	269200	376200	654	2023-08-17
2021	107000	269200	376200	654	2023-08-17
2020	80800	196700	277500	654	2023-08-17
2022	480400	433200	913600	655	2023-08-17
2021	480400	433200	913600	655	2023-08-17
2020	421300	275600	696900	655	2023-08-17
2022	0	13900	13900	659	2023-08-17
2021	0	13900	13900	659	2023-08-17
2020	0	12100	12100	659	2023-08-17
2022	55700	128400	184100	664	2023-08-17
2021	55700	128400	184100	664	2023-08-17
2020	69800	107300	177100	664	2023-08-17
2022	18200	100700	118900	667	2023-08-17
2021	18200	100700	118900	667	2023-08-17
2020	21800	65500	87300	667	2023-08-17
2022	44600	194900	239500	673	2023-08-17
2021	44600	194900	239500	673	2023-08-17
2020	51500	141300	192800	673	2023-08-17
2022	0	11300	11300	675	2023-08-17
2021	0	11300	11300	675	2023-08-17
2020	0	10300	10300	675	2023-08-17
2022	0	11600	11600	686	2023-08-17
2021	0	11600	11600	686	2023-08-17
2020	0	10500	10500	686	2023-08-17
2022	2600	47600	50200	688	2023-08-17
2021	2600	47600	50200	688	2023-08-17
2020	2300	50000	52300	688	2023-08-17
2022	309800	161700	471500	689	2023-08-17
2021	301300	161700	463000	689	2023-08-17
2020	223400	142500	365900	689	2023-08-17
2022	726400	200500	926900	690	2023-08-17
2021	726400	200500	926900	690	2023-08-17
2020	591800	191700	783500	690	2023-08-17
2022	400600	212900	613500	691	2023-08-17
2021	400600	212900	613500	691	2023-08-17
2020	405100	169900	575000	691	2023-08-17
2022	578500	227500	806000	692	2023-08-17
2021	578500	227500	806000	692	2023-08-17
2020	516900	151300	668200	692	2023-08-17
2022	192900	152200	345100	694	2023-08-17
2021	191000	152200	343200	694	2023-08-17
2020	163000	114700	277700	694	2023-08-17
2022	179300	193800	373100	695	2023-08-17
2021	179300	193800	373100	695	2023-08-17
2020	138900	157700	296600	695	2023-08-17
2022	324100	191200	515300	696	2023-08-17
2021	301800	191200	493000	696	2023-08-17
2020	294500	165700	460200	696	2023-08-17
2022	227900	136100	364000	697	2023-08-17
2021	227900	136100	364000	697	2023-08-17
2020	169800	153100	322900	697	2023-08-17
2022	486500	179200	665700	698	2023-08-17
2021	486500	179200	665700	698	2023-08-17
2020	463100	180800	643900	698	2023-08-17
2022	48900	77600	126500	700	2023-08-17
2021	48900	77600	126500	700	2023-08-17
2020	40900	72900	113800	700	2023-08-17
2022	208100	176600	384700	701	2023-08-17
2021	208100	176600	384700	701	2023-08-17
2020	151100	142000	293100	701	2023-08-17
2022	216000	149500	365500	702	2023-08-17
2021	216000	149500	365500	702	2023-08-17
2020	213600	119400	333000	702	2023-08-17
2022	66400	191800	258200	703	2023-08-17
2021	66400	191800	258200	703	2023-08-17
2020	57500	143600	201100	703	2023-08-17
2022	146600	149000	295600	704	2023-08-17
2021	146600	149000	295600	704	2023-08-17
2020	128500	111800	240300	704	2023-08-17
2022	2000	8800	10800	705	2023-08-17
2021	2000	8800	10800	705	2023-08-17
2020	2000	8000	10000	705	2023-08-17
2022	213600	196500	410100	706	2023-08-17
2021	213600	196500	410100	706	2023-08-17
2020	202400	158400	360800	706	2023-08-17
2022	210800	170800	381600	707	2023-08-17
2021	210800	170800	381600	707	2023-08-17
2020	218500	139600	358100	707	2023-08-17
2022	144900	157600	302500	708	2023-08-17
2021	144900	157600	302500	708	2023-08-17
2020	153200	119600	272800	708	2023-08-17
2022	162700	125900	288600	711	2023-08-17
2021	162700	125900	288600	711	2023-08-17
2020	157400	96300	253700	711	2023-08-17
2022	0	9600	9600	717	2023-08-17
2021	0	9600	9600	717	2023-08-17
2020	0	9600	9600	717	2023-08-17
2022	347200	157400	504600	719	2023-08-17
2021	341500	157400	498900	719	2023-08-17
2020	222600	143600	366200	719	2023-08-17
2022	213000	175200	388200	720	2023-08-17
2021	213000	175200	388200	720	2023-08-17
2020	153400	137000	290400	720	2023-08-17
2022	249500	145600	395100	723	2023-08-17
2021	209100	145600	354700	723	2023-08-17
2020	136500	112000	248500	723	2023-08-17
2022	0	21900	21900	724	2023-08-17
2021	0	21900	21900	724	2023-08-17
2020	0	22000	22000	724	2023-08-17
2022	446600	217700	664300	725	2023-08-17
2021	446600	217700	664300	725	2023-08-17
2020	390300	192300	582600	725	2023-08-17
2022	559500	267700	827200	734	2023-08-17
2021	559500	267700	827200	734	2023-08-17
2020	527600	227300	754900	734	2023-08-17
2022	0	258100	258100	735	2023-08-17
2021	0	270500	270500	735	2023-08-17
2020	0	205100	205100	735	2023-08-17
2022	1054700	284700	1339400	736	2023-08-17
2021	1054700	284700	1339400	736	2023-08-17
2020	977700	289500	1267200	736	2023-08-17
2022	854300	275100	1129400	737	2023-08-17
2021	854300	275100	1129400	737	2023-08-17
2020	732000	185900	917900	737	2023-08-17
2022	375400	271100	646500	738	2023-08-17
2021	375400	271100	646500	738	2023-08-17
2020	354000	183600	537600	738	2023-08-17
2022	471700	329500	801200	739	2023-08-17
2021	540400	329500	869900	739	2023-08-17
2020	409400	265000	674400	739	2023-08-17
2022	668000	334400	1002400	740	2023-08-17
2021	668000	334400	1002400	740	2023-08-17
2020	651900	298400	950300	740	2023-08-17
2022	136000	199900	335900	741	2023-08-17
2021	146100	243200	389300	741	2023-08-17
2020	120000	163100	283100	741	2023-08-17
2022	602000	274100	876100	742	2023-08-17
2021	602000	274100	876100	742	2023-08-17
2020	562800	252000	814800	742	2023-08-17
2022	258000	268600	526600	743	2023-08-17
2021	256800	294500	551300	743	2023-08-17
2020	254400	215800	470200	743	2023-08-17
2022	525500	222500	748000	744	2023-08-17
2021	525500	222500	748000	744	2023-08-17
2020	446100	255900	702000	744	2023-08-17
2022	0	7000	7000	745	2023-08-17
2021	0	7000	7000	745	2023-08-17
2020	0	7000	7000	745	2023-08-17
2022	657300	297600	954900	746	2023-08-17
2021	657300	297600	954900	746	2023-08-17
2020	609500	263000	872500	746	2023-08-17
2022	454400	330800	785200	747	2023-08-17
2021	394000	330800	724800	747	2023-08-17
2020	362200	228900	591100	747	2023-08-17
2022	424400	311400	735800	748	2023-08-17
2021	424400	311400	735800	748	2023-08-17
2020	373100	252700	625800	748	2023-08-17
2022	1062400	477700	1540100	749	2023-08-17
2021	1062400	477600	1540000	749	2023-08-17
2020	1049800	378300	1428100	749	2023-08-17
2022	1008100	272500	1280600	750	2023-08-17
2021	926200	272500	1198700	750	2023-08-17
2020	822300	206900	1029200	750	2023-08-17
2022	311800	169900	481700	751	2023-08-17
2021	299700	169900	469600	751	2023-08-17
2020	284300	142000	426300	751	2023-08-17
2022	335600	185000	520600	752	2023-08-17
2021	335600	185000	520600	752	2023-08-17
2020	293500	185500	479000	752	2023-08-17
2022	475900	353400	829300	753	2023-08-17
2021	475900	353400	829300	753	2023-08-17
2020	415300	348400	763700	753	2023-08-17
2022	506500	179500	686000	754	2023-08-17
2021	506500	179500	686000	754	2023-08-17
2020	499500	173600	673100	754	2023-08-17
2022	173500	173400	346900	755	2023-08-17
2021	167000	173400	340400	755	2023-08-17
2020	139600	115500	255100	755	2023-08-17
2022	363200	293900	657100	756	2023-08-17
2021	363200	293800	657000	756	2023-08-17
2020	350100	251200	601300	756	2023-08-17
2022	0	251800	251800	757	2023-08-17
2021	0	251800	251800	757	2023-08-17
2020	0	226900	226900	757	2023-08-17
2022	122500	165700	288200	758	2023-08-17
2021	122500	165700	288200	758	2023-08-17
2020	108400	128600	237000	758	2023-08-17
2022	103400	177900	281300	759	2023-08-17
2021	103400	177900	281300	759	2023-08-17
2020	95400	139500	234900	759	2023-08-17
2022	0	136500	136500	760	2023-08-17
2021	0	136500	136500	760	2023-08-17
2020	0	113100	113100	760	2023-08-17
2022	0	500	500	762	2023-08-17
2021	0	500	500	762	2023-08-17
2020	0	500	500	762	2023-08-17
2022	53400	141100	194500	764	2023-08-17
2021	53400	141100	194500	764	2023-08-17
2020	55500	84500	140000	764	2023-08-17
2022	313700	150400	464100	765	2023-08-17
2021	313700	150400	464100	765	2023-08-17
2020	313300	175800	489100	765	2023-08-17
2022	8700	29100	37800	767	2023-08-17
2021	8700	29100	37800	767	2023-08-17
2020	7400	26600	34000	767	2023-08-17
2022	639200	215800	855000	768	2023-08-17
2021	627900	215800	843700	768	2023-08-17
2020	464000	168200	632200	768	2023-08-17
2022	195800	149200	345000	769	2023-08-17
2021	195800	149200	345000	769	2023-08-17
2020	193700	115300	309000	769	2023-08-17
2022	0	6400	6400	770	2023-08-17
2021	0	6400	6400	770	2023-08-17
2020	0	6400	6400	770	2023-08-17
2022	283000	205900	488900	771	2023-08-17
2021	283000	205900	488900	771	2023-08-17
2020	216300	160700	377000	771	2023-08-17
2022	256700	176600	433300	772	2023-08-17
2021	256700	176600	433300	772	2023-08-17
2020	250900	124800	375700	772	2023-08-17
2022	0	142900	142900	773	2023-08-17
2021	0	142900	142900	773	2023-08-17
2020	0	107300	107300	773	2023-08-17
2022	161200	147700	308900	774	2023-08-17
2021	161200	147700	308900	774	2023-08-17
2020	125900	107500	233400	774	2023-08-17
2022	127300	164800	292100	775	2023-08-17
2021	127300	164800	292100	775	2023-08-17
2020	91900	123000	214900	775	2023-08-17
2022	404000	206900	610900	776	2023-08-17
2021	404000	206900	610900	776	2023-08-17
2020	370200	131400	501600	776	2023-08-17
2022	831100	285700	1116800	782	2023-08-17
2021	831100	285700	1116800	782	2023-08-17
2020	760400	308000	1068400	782	2023-08-17
2022	94200	152700	246900	783	2023-08-17
2021	94200	152700	246900	783	2023-08-17
2020	117400	106300	223700	783	2023-08-17
2022	11200	149400	160600	784	2023-08-17
2021	11200	149400	160600	784	2023-08-17
2020	10400	140300	150700	784	2023-08-17
2022	857100	314100	1171200	785	2023-08-17
2021	857100	314100	1171200	785	2023-08-17
2020	701000	398200	1099200	785	2023-08-17
2022	484200	240000	724200	786	2023-08-17
2021	484200	240000	724200	786	2023-08-17
2020	419400	311500	730900	786	2023-08-17
2022	238800	166500	405300	787	2023-08-17
2021	238800	166500	405300	787	2023-08-17
2020	247800	95100	342900	787	2023-08-17
2022	136300	156300	292600	788	2023-08-17
2021	136300	156300	292600	788	2023-08-17
2020	95300	122000	217300	788	2023-08-17
2022	288700	130600	419300	789	2023-08-17
2021	273500	130600	404100	789	2023-08-17
2020	194500	102000	296500	789	2023-08-17
2022	413000	181300	594300	792	2023-08-17
2021	413000	181300	594300	792	2023-08-17
2020	408600	137100	545700	792	2023-08-17
2022	0	2800	2800	793	2023-08-17
2021	0	2800	2800	793	2023-08-17
2020	0	2800	2800	793	2023-08-17
2022	236000	161200	397200	795	2023-08-17
2021	236000	161200	397200	795	2023-08-17
2020	200700	124300	325000	795	2023-08-17
2022	55500	94000	149500	796	2023-08-17
2021	55500	94000	149500	796	2023-08-17
2020	48000	53000	101000	796	2023-08-17
2022	535400	214900	750300	797	2023-08-17
2021	535400	214900	750300	797	2023-08-17
2020	529200	183900	713100	797	2023-08-17
2022	5400	148600	154000	798	2023-08-17
2021	5400	148600	154000	798	2023-08-17
2020	5200	133200	138400	798	2023-08-17
2022	375900	182900	558800	799	2023-08-17
2021	375900	182900	558800	799	2023-08-17
2020	363200	161600	524800	799	2023-08-17
2022	1185500	328400	1513900	800	2023-08-17
2021	1185500	328400	1513900	800	2023-08-17
2020	1126900	310300	1437200	800	2023-08-17
2022	395700	216100	611800	801	2023-08-17
2021	395700	215800	611500	801	2023-08-17
2020	384700	192800	577500	801	2023-08-17
2022	453900	235100	689000	804	2023-08-17
2021	453900	235100	689000	804	2023-08-17
2020	364800	170300	535100	804	2023-08-17
2022	715100	206400	921500	806	2023-08-17
2021	715100	206400	921500	806	2023-08-17
2020	545900	178900	724800	806	2023-08-17
2022	0	14500	14500	807	2023-08-17
2021	0	14500	14500	807	2023-08-17
2020	0	14500	14500	807	2023-08-17
2022	268500	184100	452600	808	2023-08-17
2021	268500	184100	452600	808	2023-08-17
2020	227400	162700	390100	808	2023-08-17
2022	194900	182800	377700	809	2023-08-17
2021	194900	182800	377700	809	2023-08-17
2020	157100	169000	326100	809	2023-08-17
2022	747800	259700	1007500	810	2023-08-17
2021	747800	259700	1007500	810	2023-08-17
2020	780200	262300	1042500	810	2023-08-17
2022	17300	214900	232200	811	2023-08-17
2021	17300	214900	232200	811	2023-08-17
2020	15100	191000	206100	811	2023-08-17
2022	261500	139900	401400	812	2023-08-17
2021	256800	139900	396700	812	2023-08-17
2020	207600	107200	314800	812	2023-08-17
2022	494100	176200	670300	814	2023-08-17
2021	494100	176200	670300	814	2023-08-17
2020	513600	155000	668600	814	2023-08-17
2022	378600	252100	630700	815	2023-08-17
2021	378600	252100	630700	815	2023-08-17
2020	334900	200900	535800	815	2023-08-17
2022	611800	222200	834000	816	2023-08-17
2021	611800	222200	834000	816	2023-08-17
2020	559700	166600	726300	816	2023-08-17
2022	954300	195200	1149500	820	2023-08-17
2021	954300	195200	1149500	820	2023-08-17
2020	839700	207500	1047200	820	2023-08-17
2022	0	1300	1300	821	2023-08-17
2021	0	1300	1300	821	2023-08-17
2020	0	1300	1300	821	2023-08-17
2022	38200	190600	228800	824	2023-08-17
2021	38200	190600	228800	824	2023-08-17
2020	31300	146500	177800	824	2023-08-17
2022	301900	207100	509000	826	2023-08-17
2021	301900	207100	509000	826	2023-08-17
2020	278700	152800	431500	826	2023-08-17
2022	749700	566000	1315700	827	2023-08-17
2021	749700	566000	1315700	827	2023-08-17
2020	728500	531300	1259800	827	2023-08-17
2022	393900	294900	688800	829	2023-08-17
2021	393900	294900	688800	829	2023-08-17
2020	325300	210600	535900	829	2023-08-17
2022	159900	138800	298700	830	2023-08-17
2021	159900	138800	298700	830	2023-08-17
2020	133400	93400	226800	830	2023-08-17
2022	1136400	699600	1836000	831	2023-08-17
2021	1136400	699600	1836000	831	2023-08-17
2020	1092100	661200	1753300	831	2023-08-17
2022	0	100800	100800	832	2023-08-17
2021	0	100800	100800	832	2023-08-17
2020	0	69000	69000	832	2023-08-17
2022	342900	180000	522900	833	2023-08-17
2021	392400	180000	572400	833	2023-08-17
2020	287200	122800	410000	833	2023-08-17
2022	156300	120200	276500	834	2023-08-17
2021	156300	120200	276500	834	2023-08-17
2020	150100	100700	250800	834	2023-08-17
2022	342000	236200	578200	835	2023-08-17
2021	342000	236200	578200	835	2023-08-17
2020	325000	172600	497600	835	2023-08-17
2022	0	18800	18800	836	2023-08-17
2021	0	18800	18800	836	2023-08-17
2020	7700	15700	23400	836	2023-08-17
2022	498200	244700	742900	837	2023-08-17
2021	484200	244700	728900	837	2023-08-17
2020	355900	146000	501900	837	2023-08-17
2022	258600	142000	400600	838	2023-08-17
2021	258300	142000	400300	838	2023-08-17
2020	236500	110900	347400	838	2023-08-17
2022	534600	180000	714600	839	2023-08-17
2021	534600	180000	714600	839	2023-08-17
2020	470800	139800	610600	839	2023-08-17
2022	107300	130700	238000	840	2023-08-17
2021	106100	130700	236800	840	2023-08-17
2020	19400	99100	118500	840	2023-08-17
2022	543500	205900	749400	841	2023-08-17
2021	543500	205900	749400	841	2023-08-17
2020	507800	156800	664600	841	2023-08-17
2022	127100	93200	220300	842	2023-08-17
2021	127100	93200	220300	842	2023-08-17
2020	116200	83900	200100	842	2023-08-17
2022	83600	152200	235800	843	2023-08-17
2021	83600	152200	235800	843	2023-08-17
2020	75700	118000	193700	843	2023-08-17
2022	4300	88900	93200	844	2023-08-17
2021	4300	88900	93200	844	2023-08-17
2020	5900	79900	85800	844	2023-08-17
2022	211500	141600	353100	845	2023-08-17
2021	211500	141600	353100	845	2023-08-17
2020	180800	108400	289200	845	2023-08-17
2022	0	113800	113800	846	2023-08-17
2021	0	113800	113800	846	2023-08-17
2020	0	87900	87900	846	2023-08-17
2022	0	117700	117700	849	2023-08-17
2021	0	117700	117700	849	2023-08-17
2020	0	104600	104600	849	2023-08-17
2022	33500	152200	185700	850	2023-08-17
2021	33500	152200	185700	850	2023-08-17
2020	45400	99500	144900	850	2023-08-17
2022	1500	46500	48000	851	2023-08-17
2021	1500	46500	48000	851	2023-08-17
2020	1400	38000	39400	851	2023-08-17
2022	35100	139500	174600	852	2023-08-17
2021	35100	139500	174600	852	2023-08-17
2020	45000	85400	130400	852	2023-08-17
2022	79000	125500	204500	853	2023-08-17
2021	79000	125500	204500	853	2023-08-17
2020	104000	64000	168000	853	2023-08-17
2022	42800	128800	171600	855	2023-08-17
2021	42800	128800	171600	855	2023-08-17
2020	52900	77600	130500	855	2023-08-17
2022	0	8700	8700	858	2023-08-17
2021	0	8700	8700	858	2023-08-17
2020	0	8700	8700	858	2023-08-17
2022	0	7000	7000	860	2023-08-17
2021	0	7000	7000	860	2023-08-17
2020	0	7000	7000	860	2023-08-17
2022	203600	139000	342600	861	2023-08-17
2021	203600	139000	342600	861	2023-08-17
2020	217300	106000	323300	861	2023-08-17
2022	714100	334100	1048200	862	2023-08-17
2021	714500	334100	1048600	862	2023-08-17
2020	750000	273400	1023400	862	2023-08-17
2022	0	300	300	863	2023-08-17
2021	0	300	300	863	2023-08-17
2020	0	300	300	863	2023-08-17
2022	0	300	300	864	2023-08-17
2021	0	300	300	864	2023-08-17
2020	0	300	300	864	2023-08-17
2022	913800	228200	1142000	865	2023-08-17
2021	913800	228200	1142000	865	2023-08-17
2020	722900	360000	1082900	865	2023-08-17
2022	1064900	632100	1697000	867	2023-08-17
2021	1064900	632100	1697000	867	2023-08-17
2020	1013800	592200	1606000	867	2023-08-17
2022	314000	177800	491800	868	2023-08-17
2021	314000	177800	491800	868	2023-08-17
2020	306200	141600	447800	868	2023-08-17
2022	209700	155600	365300	869	2023-08-17
2021	209700	155600	365300	869	2023-08-17
2020	163800	126000	289800	869	2023-08-17
2022	367100	181500	548600	871	2023-08-17
2021	367100	181500	548600	871	2023-08-17
2020	313200	182700	495900	871	2023-08-17
2022	397900	202700	600600	872	2023-08-17
2021	397900	202700	600600	872	2023-08-17
2020	411800	141500	553300	872	2023-08-17
2022	522300	318800	841100	873	2023-08-17
2021	522300	318800	841100	873	2023-08-17
2020	504500	320300	824800	873	2023-08-17
2022	146500	300200	446700	874	2023-08-17
2021	146500	300200	446700	874	2023-08-17
2020	117400	287800	405200	874	2023-08-17
2022	434800	228300	663100	875	2023-08-17
2021	434800	228300	663100	875	2023-08-17
2020	411400	201500	612900	875	2023-08-17
2022	187900	263400	451300	876	2023-08-17
2021	187900	263500	451400	876	2023-08-17
2020	157300	247200	404500	876	2023-08-17
2022	468400	315800	784200	877	2023-08-17
2021	468400	315800	784200	877	2023-08-17
2020	401000	322800	723800	877	2023-08-17
2022	325900	336100	662000	878	2023-08-17
2021	325900	336100	662000	878	2023-08-17
2020	294700	221600	516300	878	2023-08-17
2022	183200	164700	347900	879	2023-08-17
2021	183200	164800	348000	879	2023-08-17
2020	167000	130600	297600	879	2023-08-17
2022	384400	181600	566000	880	2023-08-17
2021	384400	181600	566000	880	2023-08-17
2020	345800	160000	505800	880	2023-08-17
2022	1268800	289500	1558300	881	2023-08-17
2021	1268800	289500	1558300	881	2023-08-17
2020	990200	361200	1351400	881	2023-08-17
2022	21300	51700	73000	883	2023-08-17
2021	21300	51700	73000	883	2023-08-17
2020	31000	37900	68900	883	2023-08-17
2022	191000	161500	352500	884	2023-08-17
2021	191000	161500	352500	884	2023-08-17
2020	169000	142300	311300	884	2023-08-17
2022	998100	362200	1360300	887	2023-08-17
2021	998100	362200	1360300	887	2023-08-17
2020	950800	398700	1349500	887	2023-08-17
2022	0	800	800	888	2023-08-17
2021	0	800	800	888	2023-08-17
2020	0	800	800	888	2023-08-17
2022	403600	113200	516800	891	2023-08-17
2021	403600	113200	516800	891	2023-08-17
2020	334900	113000	447900	891	2023-08-17
2022	0	155100	155100	892	2023-08-17
2021	0	155100	155100	892	2023-08-17
2020	0	5100	5100	892	2023-08-17
2022	786900	198200	985100	895	2023-08-17
2021	743700	198200	941900	895	2023-08-17
2020	574400	192900	767300	895	2023-08-17
2022	1117300	270000	1387300	896	2023-08-17
2021	1117300	270000	1387300	896	2023-08-17
2020	885800	307400	1193200	896	2023-08-17
2022	0	6100	6100	897	2023-08-17
2021	0	6100	6100	897	2023-08-17
2020	0	6100	6100	897	2023-08-17
2022	0	1200	1200	898	2023-08-17
2021	0	1200	1200	898	2023-08-17
2020	0	1200	1200	898	2023-08-17
2022	581100	266100	847200	899	2023-08-17
2021	738600	266100	1004700	899	2023-08-17
2020	604100	267900	872000	899	2023-08-17
2022	563900	440300	1004200	900	2023-08-17
2021	563900	440300	1004200	900	2023-08-17
2020	517700	391600	909300	900	2023-08-17
2022	114200	178100	292300	901	2023-08-17
2021	114200	178100	292300	901	2023-08-17
2020	96400	109300	205700	901	2023-08-17
2022	0	700	700	907	2023-08-17
2021	0	700	700	907	2023-08-17
2020	0	700	700	907	2023-08-17
2022	0	3300	3300	908	2023-08-17
2021	0	3300	3300	908	2023-08-17
2020	0	3300	3300	908	2023-08-17
2022	1264700	637700	1902400	909	2023-08-17
2021	1264700	637700	1902400	909	2023-08-17
2020	1308200	483300	1791500	909	2023-08-17
2022	487700	250900	738600	910	2023-08-17
2021	487700	250900	738600	910	2023-08-17
2020	411800	244200	656000	910	2023-08-17
2022	420600	317400	738000	911	2023-08-17
2021	420600	317400	738000	911	2023-08-17
2020	382300	310000	692300	911	2023-08-17
2022	0	3700	3700	912	2023-08-17
2021	0	3700	3700	912	2023-08-17
2020	0	3700	3700	912	2023-08-17
2022	25900	149300	175200	913	2023-08-17
2021	25900	149300	175200	913	2023-08-17
2020	26500	100800	127300	913	2023-08-17
2022	133700	155800	289500	915	2023-08-17
2021	133700	155800	289500	915	2023-08-17
2020	134200	110300	244500	915	2023-08-17
2022	171000	178500	349500	916	2023-08-17
2021	171000	178500	349500	916	2023-08-17
2020	143400	141200	284600	916	2023-08-17
2022	250500	235300	485800	917	2023-08-17
2021	250500	235300	485800	917	2023-08-17
2020	249900	163200	413100	917	2023-08-17
2022	403900	269300	673200	920	2023-08-17
2021	399600	269300	668900	920	2023-08-17
2020	360500	215300	575800	920	2023-08-17
2022	302400	205200	507600	921	2023-08-17
2021	302400	205200	507600	921	2023-08-17
2020	267600	128800	396400	921	2023-08-17
2022	29900	171500	201400	923	2023-08-17
2021	29900	171500	201400	923	2023-08-17
2020	26300	128300	154600	923	2023-08-17
2022	0	6500	6500	924	2023-08-17
2021	0	6500	6500	924	2023-08-17
2020	0	6500	6500	924	2023-08-17
2022	0	400	400	925	2023-08-17
2021	0	400	400	925	2023-08-17
2020	0	400	400	925	2023-08-17
2022	0	1200	1200	934	2023-08-17
2021	0	1200	1200	934	2023-08-17
2020	0	1200	1200	934	2023-08-17
2022	458600	263000	721600	935	2023-08-17
2021	458600	263000	721600	935	2023-08-17
2020	412900	232400	645300	935	2023-08-17
2022	596300	245000	841300	939	2023-08-17
2021	596300	245000	841300	939	2023-08-17
2020	518000	293400	811400	939	2023-08-17
2022	432600	152100	584700	940	2023-08-17
2021	432600	152100	584700	940	2023-08-17
2020	406400	159900	566300	940	2023-08-17
2022	397900	168600	566500	941	2023-08-17
2021	397900	168600	566500	941	2023-08-17
2020	361200	163000	524200	941	2023-08-17
2022	402700	227300	630000	942	2023-08-17
2021	402700	227300	630000	942	2023-08-17
2020	377500	222300	599800	942	2023-08-17
2022	324200	261900	586100	943	2023-08-17
2021	324200	261900	586100	943	2023-08-17
2020	301800	186200	488000	943	2023-08-17
2022	331800	216000	547800	944	2023-08-17
2021	393600	258300	651900	944	2023-08-17
2020	309200	227700	536900	944	2023-08-17
2022	334800	143600	478400	947	2023-08-17
2021	334800	143600	478400	947	2023-08-17
2020	311900	93500	405400	947	2023-08-17
2022	423400	201100	624500	949	2023-08-17
2021	383600	201100	584700	949	2023-08-17
2020	349600	201000	550600	949	2023-08-17
2022	161600	106600	268200	951	2023-08-17
2021	161600	106600	268200	951	2023-08-17
2020	181500	74700	256200	951	2023-08-17
2022	122200	125500	247700	952	2023-08-17
2021	134400	133800	268200	952	2023-08-17
2020	94600	97000	191600	952	2023-08-17
2022	183800	126300	310100	953	2023-08-17
2021	183800	126300	310100	953	2023-08-17
2020	196900	129800	326700	953	2023-08-17
2022	134700	156100	290800	954	2023-08-17
2021	134700	156100	290800	954	2023-08-17
2020	128500	135400	263900	954	2023-08-17
2022	91100	124900	216000	955	2023-08-17
2021	91100	124900	216000	955	2023-08-17
2020	78700	94100	172800	955	2023-08-17
2022	311600	108600	420200	958	2023-08-17
2021	311600	108600	420200	958	2023-08-17
2020	254000	114300	368300	958	2023-08-17
2022	229100	112600	341700	959	2023-08-17
2021	229100	112600	341700	959	2023-08-17
2020	201500	106300	307800	959	2023-08-17
2022	209600	115100	324700	960	2023-08-17
2021	209600	115100	324700	960	2023-08-17
2020	196300	111100	307400	960	2023-08-17
2022	383800	243800	627600	961	2023-08-17
2021	383800	243800	627600	961	2023-08-17
2020	349400	201300	550700	961	2023-08-17
2022	371900	112400	484300	962	2023-08-17
2021	371900	112400	484300	962	2023-08-17
2020	311100	118200	429300	962	2023-08-17
2022	245600	239300	484900	963	2023-08-17
2021	245600	239300	484900	963	2023-08-17
2020	261400	167800	429200	963	2023-08-17
2022	0	211200	211200	964	2023-08-17
2021	0	211200	211200	964	2023-08-17
2020	79100	153500	232600	964	2023-08-17
2022	528500	231100	759600	965	2023-08-17
2021	524400	231100	755500	965	2023-08-17
2020	459700	188600	648300	965	2023-08-17
2022	376200	166000	542200	966	2023-08-17
2021	376200	166000	542200	966	2023-08-17
2020	330800	144000	474800	966	2023-08-17
2022	467700	172900	640600	967	2023-08-17
2021	467700	172900	640600	967	2023-08-17
2020	438500	152000	590500	967	2023-08-17
2022	215000	162500	377500	968	2023-08-17
2021	207300	162600	369900	968	2023-08-17
2020	168400	126100	294500	968	2023-08-17
2022	143300	156100	299400	969	2023-08-17
2021	143300	156100	299400	969	2023-08-17
2020	118900	103800	222700	969	2023-08-17
2022	207900	172600	380500	971	2023-08-17
2021	207900	172600	380500	971	2023-08-17
2020	191500	136900	328400	971	2023-08-17
2022	0	1600	1600	972	2023-08-17
2021	0	1600	1600	972	2023-08-17
2020	0	1600	1600	972	2023-08-17
2022	253200	151600	404800	973	2023-08-17
2021	245500	151600	397100	973	2023-08-17
2020	246700	116700	363400	973	2023-08-17
2022	463100	181400	644500	974	2023-08-17
2021	463100	181400	644500	974	2023-08-17
2020	395700	183300	579000	974	2023-08-17
2022	0	900	900	975	2023-08-17
2021	0	900	900	975	2023-08-17
2020	0	900	900	975	2023-08-17
2022	261400	211800	473200	976	2023-08-17
2021	262700	211800	474500	976	2023-08-17
2020	198300	167700	366000	976	2023-08-17
2022	584200	192500	776700	977	2023-08-17
2021	584200	192500	776700	977	2023-08-17
2020	565300	152800	718100	977	2023-08-17
2022	26100	134100	160200	978	2023-08-17
2021	26100	134100	160200	978	2023-08-17
2020	22400	101900	124300	978	2023-08-17
2022	94700	130300	225000	979	2023-08-17
2021	94700	130300	225000	979	2023-08-17
2020	87600	98700	186300	979	2023-08-17
2022	270900	128900	399800	981	2023-08-17
2021	270900	128900	399800	981	2023-08-17
2020	226600	97500	324100	981	2023-08-17
2022	112400	137000	249400	982	2023-08-17
2021	112400	137000	249400	982	2023-08-17
2020	72500	104800	177300	982	2023-08-17
2022	12100	137300	149400	983	2023-08-17
2021	12100	137300	149400	983	2023-08-17
2020	4600	106700	111300	983	2023-08-17
2022	90800	118300	209100	984	2023-08-17
2021	90800	118300	209100	984	2023-08-17
2020	78500	90100	168600	984	2023-08-17
2022	107000	139600	246600	986	2023-08-17
2021	107000	139600	246600	986	2023-08-17
2020	122600	96500	219100	986	2023-08-17
2022	258800	164100	422900	987	2023-08-17
2021	258800	164100	422900	987	2023-08-17
2020	231400	117700	349100	987	2023-08-17
2022	4100	1100	5200	990	2023-08-17
2021	4100	1100	5200	990	2023-08-17
2020	3800	1100	4900	990	2023-08-17
2022	77800	131000	208800	991	2023-08-17
2021	77800	131000	208800	991	2023-08-17
2020	73200	99300	172500	991	2023-08-17
2022	0	13500	13500	992	2023-08-17
2021	0	13500	13500	992	2023-08-17
2020	0	13500	13500	992	2023-08-17
2022	226300	135900	362200	993	2023-08-17
2021	210700	135900	346600	993	2023-08-17
2020	194900	99100	294000	993	2023-08-17
2022	145200	171100	316300	994	2023-08-17
2021	145200	171100	316300	994	2023-08-17
2020	121500	122900	244400	994	2023-08-17
2022	165900	84200	250100	995	2023-08-17
2021	165900	89400	255300	995	2023-08-17
2020	111000	49900	160900	995	2023-08-17
2022	336100	186700	522800	996	2023-08-17
2021	336100	186700	522800	996	2023-08-17
2020	310800	163900	474700	996	2023-08-17
2022	212500	160700	373200	997	2023-08-17
2021	212500	160700	373200	997	2023-08-17
2020	208500	141500	350000	997	2023-08-17
2022	442600	212200	654800	998	2023-08-17
2021	442600	212200	654800	998	2023-08-17
2020	435600	162900	598500	998	2023-08-17
2022	0	4800	4800	1002	2023-08-17
2021	0	4800	4800	1002	2023-08-17
2020	0	4800	4800	1002	2023-08-17
2022	167600	166900	334500	1003	2023-08-17
2021	179900	166900	346800	1003	2023-08-17
2020	198500	137300	335800	1003	2023-08-17
2022	370900	175200	546100	1004	2023-08-17
2021	370900	175200	546100	1004	2023-08-17
2020	289200	166000	455200	1004	2023-08-17
2022	348300	184800	533100	1005	2023-08-17
2021	348300	184800	533100	1005	2023-08-17
2020	303600	124000	427600	1005	2023-08-17
2022	131500	140300	271800	1006	2023-08-17
2021	131500	140300	271800	1006	2023-08-17
2020	113800	106500	220300	1006	2023-08-17
2022	0	10800	10800	1009	2023-08-17
2021	0	10800	10800	1009	2023-08-17
2020	0	10800	10800	1009	2023-08-17
2022	56500	122100	178600	1015	2023-08-17
2021	56500	122100	178600	1015	2023-08-17
2020	49200	95200	144400	1015	2023-08-17
2022	122600	155100	277700	1016	2023-08-17
2021	122600	155100	277700	1016	2023-08-17
2020	111500	118800	230300	1016	2023-08-17
2022	43400	94600	138000	1018	2023-08-17
2021	43400	94600	138000	1018	2023-08-17
2020	39600	81900	121500	1018	2023-08-17
2022	265300	163000	428300	1019	2023-08-17
2021	265300	163000	428300	1019	2023-08-17
2020	253200	126000	379200	1019	2023-08-17
2022	81200	169000	250200	1020	2023-08-17
2021	81200	169000	250200	1020	2023-08-17
2020	102200	131400	233600	1020	2023-08-17
2022	370500	182300	552800	1022	2023-08-17
2021	370500	182300	552800	1022	2023-08-17
2020	256100	140500	396600	1022	2023-08-17
2022	160500	195700	356200	1023	2023-08-17
2021	160500	195700	356200	1023	2023-08-17
2020	139700	158800	298500	1023	2023-08-17
2022	142900	148400	291300	1024	2023-08-17
2021	142900	148400	291300	1024	2023-08-17
2020	121200	102400	223600	1024	2023-08-17
2022	296500	202000	498500	1025	2023-08-17
2021	277500	202000	479500	1025	2023-08-17
2020	201800	189300	391100	1025	2023-08-17
2022	261400	176100	437500	1026	2023-08-17
2021	261400	176100	437500	1026	2023-08-17
2020	248000	138200	386200	1026	2023-08-17
2022	0	19100	19100	1027	2023-08-17
2021	0	19100	19100	1027	2023-08-17
2020	0	19100	19100	1027	2023-08-17
2022	0	12200	12200	1028	2023-08-17
2021	0	12200	12200	1028	2023-08-17
2020	0	10500	10500	1028	2023-08-17
2022	368900	264300	633200	1030	2023-08-17
2021	368900	264300	633200	1030	2023-08-17
2020	320700	229000	549700	1030	2023-08-17
2022	145000	141700	286700	1031	2023-08-17
2021	145000	141700	286700	1031	2023-08-17
2020	114500	113400	227900	1031	2023-08-17
2022	298200	179500	477700	1033	2023-08-17
2021	298200	179500	477700	1033	2023-08-17
2020	229300	139800	369100	1033	2023-08-17
2022	17100	16600	33700	1034	2023-08-17
2021	17100	16600	33700	1034	2023-08-17
2020	15300	13100	28400	1034	2023-08-17
2022	162400	251800	414200	1035	2023-08-17
2021	162400	251800	414200	1035	2023-08-17
2020	140800	195200	336000	1035	2023-08-17
2022	53700	226100	279800	1037	2023-08-17
2021	53700	226100	279800	1037	2023-08-17
2020	29400	226000	255400	1037	2023-08-17
2022	114400	97000	211400	1038	2023-08-17
2021	103600	97000	200600	1038	2023-08-17
2020	70800	87600	158400	1038	2023-08-17
2022	0	6000	6000	1039	2023-08-17
2021	0	113300	113300	1039	2023-08-17
2020	0	108100	108100	1039	2023-08-17
2022	391100	143100	534200	1040	2023-08-17
2021	355700	143100	498800	1040	2023-08-17
2020	332600	144300	476900	1040	2023-08-17
2022	348600	147700	496300	1041	2023-08-17
2021	348600	147700	496300	1041	2023-08-17
2020	301900	152300	454200	1041	2023-08-17
2022	245800	152800	398600	1042	2023-08-17
2021	245800	152800	398600	1042	2023-08-17
2020	228600	139800	368400	1042	2023-08-17
2022	125600	100500	226100	1043	2023-08-17
2021	125600	100500	226100	1043	2023-08-17
2020	122000	80700	202700	1043	2023-08-17
2022	68200	105400	173600	1045	2023-08-17
2021	68200	105400	173600	1045	2023-08-17
2020	65600	96400	162000	1045	2023-08-17
2022	128000	131300	259300	1046	2023-08-17
2021	128000	131300	259300	1046	2023-08-17
2020	121700	99600	221300	1046	2023-08-17
2022	0	4400	4400	1048	2023-08-17
2021	0	4400	4400	1048	2023-08-17
2020	0	4100	4100	1048	2023-08-17
2022	31100	161400	192500	1049	2023-08-17
2021	31100	161400	192500	1049	2023-08-17
2020	28800	132700	161500	1049	2023-08-17
2022	73600	147200	220800	1051	2023-08-17
2021	73600	147200	220800	1051	2023-08-17
2020	66800	114100	180900	1051	2023-08-17
2022	118300	136000	254300	1052	2023-08-17
2021	118300	136000	254300	1052	2023-08-17
2020	73500	94100	167600	1052	2023-08-17
2022	859100	328400	1187500	1053	2023-08-17
2021	859100	328400	1187500	1053	2023-08-17
2020	779800	366200	1146000	1053	2023-08-17
2022	1622000	407700	2029700	1054	2023-08-17
2021	1616600	469200	2085800	1054	2023-08-17
2020	1158900	417200	1576100	1054	2023-08-17
2022	0	16900	16900	1055	2023-08-17
2021	0	16900	16900	1055	2023-08-17
2020	0	16900	16900	1055	2023-08-17
2022	0	1700	1700	1057	2023-08-17
2021	0	1700	1700	1057	2023-08-17
2020	0	1700	1700	1057	2023-08-17
2022	9400	17000	26400	1058	2023-08-17
2021	9400	17000	26400	1058	2023-08-17
2020	8900	12400	21300	1058	2023-08-17
2022	952200	193100	1145300	1060	2023-08-17
2021	952200	193100	1145300	1060	2023-08-17
2020	766000	147900	913900	1060	2023-08-17
2022	132200	194200	326400	1061	2023-08-17
2021	132200	194200	326400	1061	2023-08-17
2020	123300	155500	278800	1061	2023-08-17
2022	536700	155500	692200	1064	2023-08-17
2021	536700	155500	692200	1064	2023-08-17
2020	492900	121100	614000	1064	2023-08-17
2022	620900	192600	813500	1068	2023-08-17
2021	620900	192600	813500	1068	2023-08-17
2020	607300	148600	755900	1068	2023-08-17
2022	0	1600	1600	1069	2023-08-17
2021	0	1600	1600	1069	2023-08-17
2020	0	1600	1600	1069	2023-08-17
2022	62100	169800	231900	1070	2023-08-17
2021	62100	169800	231900	1070	2023-08-17
2020	48800	134300	183100	1070	2023-08-17
2022	496200	139200	635400	1071	2023-08-17
2021	496200	139200	635400	1071	2023-08-17
2020	452100	106500	558600	1071	2023-08-17
2022	0	5300	5300	1076	2023-08-17
2021	0	5300	5300	1076	2023-08-17
2020	0	5300	5300	1076	2023-08-17
2022	0	30700	30700	1077	2023-08-17
2021	0	30700	30700	1077	2023-08-17
2020	0	30700	30700	1077	2023-08-17
2022	200900	103900	304800	1078	2023-08-17
2021	200900	103900	304800	1078	2023-08-17
2020	166600	82200	248800	1078	2023-08-17
2022	0	100	100	1079	2023-08-17
2021	0	100	100	1079	2023-08-17
2020	0	100	100	1079	2023-08-17
2022	0	100	100	1081	2023-08-17
2021	0	100	100	1081	2023-08-17
2020	0	100	100	1081	2023-08-17
2022	33700	95900	129600	1082	2023-08-17
2021	33700	95900	129600	1082	2023-08-17
2020	49500	72100	121600	1082	2023-08-17
2022	0	3900	3900	1083	2023-08-17
2021	0	3900	3900	1083	2023-08-17
2020	0	3900	3900	1083	2023-08-17
2022	0	100	100	1084	2023-08-17
2021	0	100	100	1084	2023-08-17
2020	0	100	100	1084	2023-08-17
2022	0	1300	1300	1085	2023-08-17
2021	0	1300	1300	1085	2023-08-17
2020	0	1300	1300	1085	2023-08-17
2022	0	83500	83500	1087	2023-08-17
2021	0	83500	83500	1087	2023-08-17
2020	0	68100	68100	1087	2023-08-17
2022	80800	145200	226000	1091	2023-08-17
2021	89200	145200	234400	1091	2023-08-17
2020	76500	99500	176000	1091	2023-08-17
2022	309500	161300	470800	1092	2023-08-17
2021	309500	161300	470800	1092	2023-08-17
2020	308900	125600	434500	1092	2023-08-17
2022	0	139200	139200	1093	2023-08-17
2021	0	139200	139200	1093	2023-08-17
2020	0	113400	113400	1093	2023-08-17
2022	179900	240600	420500	1094	2023-08-17
2021	179900	240600	420500	1094	2023-08-17
2020	161200	186300	347500	1094	2023-08-17
2022	1589900	319000	1908900	1096	2023-08-17
2021	1543900	319000	1862900	1096	2023-08-17
2020	1186300	299800	1486100	1096	2023-08-17
2022	0	900	900	1097	2023-08-17
2021	0	900	900	1097	2023-08-17
2020	0	900	900	1097	2023-08-17
2022	0	1800	1800	1098	2023-08-17
2021	0	1800	1800	1098	2023-08-17
2020	0	1800	1800	1098	2023-08-17
2022	257600	194800	452400	1099	2023-08-17
2021	237600	194800	432400	1099	2023-08-17
2020	190800	109900	300700	1099	2023-08-17
2022	0	400	400	1100	2023-08-17
2021	0	400	400	1100	2023-08-17
2020	0	400	400	1100	2023-08-17
2022	176500	127400	303900	1101	2023-08-17
2021	176500	127400	303900	1101	2023-08-17
2020	157500	86200	243700	1101	2023-08-17
2022	94200	134800	229000	1102	2023-08-17
2021	94200	134800	229000	1102	2023-08-17
2020	79300	92900	172200	1102	2023-08-17
2022	0	3100	3100	1103	2023-08-17
2021	0	3100	3100	1103	2023-08-17
2020	0	3100	3100	1103	2023-08-17
2022	535000	189900	724900	1104	2023-08-17
2021	535000	189900	724900	1104	2023-08-17
2020	527000	156600	683600	1104	2023-08-17
2022	538000	187500	725500	1105	2023-08-17
2021	538000	187500	725500	1105	2023-08-17
2020	498600	165900	664500	1105	2023-08-17
2022	653900	214600	868500	1109	2023-08-17
2021	653900	214600	868500	1109	2023-08-17
2020	600500	209100	809600	1109	2023-08-17
2022	0	128800	128800	1111	2023-08-17
2021	0	128800	128800	1111	2023-08-17
2020	0	103700	103700	1111	2023-08-17
2022	196600	168700	365300	1112	2023-08-17
2021	196600	168700	365300	1112	2023-08-17
2020	161500	134800	296300	1112	2023-08-17
2022	73200	222800	296000	1113	2023-08-17
2021	73200	222800	296000	1113	2023-08-17
2020	46300	178700	225000	1113	2023-08-17
2022	204900	130200	335100	1118	2023-08-17
2021	204900	130200	335100	1118	2023-08-17
2020	195400	93200	288600	1118	2023-08-17
2022	0	3700	3700	1119	2023-08-17
2021	0	3700	3700	1119	2023-08-17
2020	0	3700	3700	1119	2023-08-17
2022	370500	163700	534200	1120	2023-08-17
2021	370500	163700	534200	1120	2023-08-17
2020	336800	140600	477400	1120	2023-08-17
2022	221000	148900	369900	1121	2023-08-17
2021	221000	148900	369900	1121	2023-08-17
2020	195500	102800	298300	1121	2023-08-17
2022	27800	97300	125100	1122	2023-08-17
2021	27800	97300	125100	1122	2023-08-17
2020	10300	67100	77400	1122	2023-08-17
2022	37100	140400	177500	1123	2023-08-17
2021	37100	140400	177500	1123	2023-08-17
2020	14500	115400	129900	1123	2023-08-17
2022	39500	95000	134500	1124	2023-08-17
2021	39500	95000	134500	1124	2023-08-17
2020	120300	68900	189200	1124	2023-08-17
2022	27000	50400	77400	1125	2023-08-17
2021	27000	50400	77400	1125	2023-08-17
2020	12200	44600	56800	1125	2023-08-17
2022	194300	103600	297900	1126	2023-08-17
2021	194300	103600	297900	1126	2023-08-17
2020	168200	79300	247500	1126	2023-08-17
2022	50200	120200	170400	1127	2023-08-17
2021	50200	120200	170400	1127	2023-08-17
2020	39800	123100	162900	1127	2023-08-17
2022	0	100	100	1129	2023-08-17
2021	0	100	100	1129	2023-08-17
2020	0	100	100	1129	2023-08-17
2022	54200	119100	173300	1131	2023-08-17
2021	54200	119100	173300	1131	2023-08-17
2020	30900	91200	122100	1131	2023-08-17
2022	605600	163900	769500	1132	2023-08-17
2021	605600	163900	769500	1132	2023-08-17
2020	529300	142800	672100	1132	2023-08-17
2022	121200	111300	232500	1133	2023-08-17
2021	121200	111300	232500	1133	2023-08-17
2020	85800	88100	173900	1133	2023-08-17
2022	82700	92300	175000	1136	2023-08-17
2021	82700	92300	175000	1136	2023-08-17
2020	68400	70500	138900	1136	2023-08-17
2022	26500	75000	101500	1137	2023-08-17
2021	26500	75000	101500	1137	2023-08-17
2020	12800	62700	75500	1137	2023-08-17
2022	40000	46500	86500	1138	2023-08-17
2021	40000	46500	86500	1138	2023-08-17
2020	32600	36700	69300	1138	2023-08-17
2022	233000	150300	383300	1140	2023-08-17
2021	275600	143300	418900	1140	2023-08-17
2020	211300	84300	295600	1140	2023-08-17
2022	0	3300	3300	1141	2023-08-17
2021	0	3300	3300	1141	2023-08-17
2020	0	3000	3000	1141	2023-08-17
2022	252600	151900	404500	1142	2023-08-17
2021	68200	151900	220100	1142	2023-08-17
2020	61500	96900	158400	1142	2023-08-17
2022	380000	145800	525800	1144	2023-08-17
2021	380000	148900	528900	1144	2023-08-17
2020	395700	121000	516700	1144	2023-08-17
2022	164600	169900	334500	1149	2023-08-17
2021	165700	169900	335600	1149	2023-08-17
2020	127500	130200	257700	1149	2023-08-17
2022	195100	190700	385800	1150	2023-08-17
2021	195100	190700	385800	1150	2023-08-17
2020	217700	164100	381800	1150	2023-08-17
2022	0	347500	347500	1151	2023-08-17
2021	0	347500	347500	1151	2023-08-17
2020	0	299700	299700	1151	2023-08-17
2022	0	4800	4800	1152	2023-08-17
2021	0	4800	4800	1152	2023-08-17
2020	0	4800	4800	1152	2023-08-17
2022	0	100400	100400	1154	2023-08-17
2021	0	100400	100400	1154	2023-08-17
2020	0	79000	79000	1154	2023-08-17
2022	0	1100	1100	1155	2023-08-17
2021	0	1100	1100	1155	2023-08-17
2020	0	1100	1100	1155	2023-08-17
2022	343100	149700	492800	1156	2023-08-17
2021	343100	149700	492800	1156	2023-08-17
2020	333100	114000	447100	1156	2023-08-17
2022	77200	125100	202300	1157	2023-08-17
2021	77200	125000	202200	1157	2023-08-17
2020	87100	95500	182600	1157	2023-08-17
2022	0	4400	4400	1158	2023-08-17
2021	0	4400	4400	1158	2023-08-17
2020	0	4400	4400	1158	2023-08-17
2022	0	3600	3600	1163	2023-08-17
2021	0	3600	3600	1163	2023-08-17
2020	0	3600	3600	1163	2023-08-17
2022	0	102500	102500	1164	2023-08-17
2021	0	102500	102500	1164	2023-08-17
2020	0	102500	102500	1164	2023-08-17
2022	70500	85100	155600	1165	2023-08-17
2021	70500	85100	155600	1165	2023-08-17
2020	57300	71800	129100	1165	2023-08-17
2022	182400	154900	337300	1166	2023-08-17
2021	182400	154900	337300	1166	2023-08-17
2020	191000	121100	312100	1166	2023-08-17
2022	154000	142600	296600	1167	2023-08-17
2021	154000	142600	296600	1167	2023-08-17
2020	132500	111500	244000	1167	2023-08-17
2022	527000	191300	718300	1169	2023-08-17
2021	527000	191300	718300	1169	2023-08-17
2020	509600	146000	655600	1169	2023-08-17
2022	261600	171800	433400	1170	2023-08-17
2021	261600	171700	433300	1170	2023-08-17
2020	274400	143000	417400	1170	2023-08-17
2022	0	1200	1200	1171	2023-08-17
2021	0	1200	1200	1171	2023-08-17
2020	0	1200	1200	1171	2023-08-17
2022	58600	123700	182300	1173	2023-08-17
2021	58600	123700	182300	1173	2023-08-17
2020	52300	45300	97600	1173	2023-08-17
2022	0	13700	13700	1177	2023-08-17
2021	0	13700	13700	1177	2023-08-17
2020	0	13700	13700	1177	2023-08-17
2022	0	1200	1200	1186	2023-08-17
2021	0	1200	1200	1186	2023-08-17
2020	0	1200	1200	1186	2023-08-17
2022	0	500	500	1187	2023-08-17
2021	0	500	500	1187	2023-08-17
2020	0	500	500	1187	2023-08-17
2022	477000	167100	644100	1188	2023-08-17
2021	477000	167100	644100	1188	2023-08-17
2020	464400	130100	594500	1188	2023-08-17
2022	0	6800	6800	1189	2023-08-17
2021	0	6800	6800	1189	2023-08-17
2020	0	6800	6800	1189	2023-08-17
2022	1200	113100	114300	1190	2023-08-17
2021	1200	113100	114300	1190	2023-08-17
2020	1000	87200	88200	1190	2023-08-17
2022	0	110100	110100	1191	2023-08-17
2021	0	110100	110100	1191	2023-08-17
2020	0	84500	84500	1191	2023-08-17
2022	0	22300	22300	1192	2023-08-17
2021	0	22300	22300	1192	2023-08-17
2020	0	18100	18100	1192	2023-08-17
2022	0	77500	77500	1193	2023-08-17
2021	0	77500	77500	1193	2023-08-17
2020	0	68300	68300	1193	2023-08-17
2022	318700	160200	478900	1195	2023-08-17
2021	314400	160200	474600	1195	2023-08-17
2020	289100	125600	414700	1195	2023-08-17
2022	325600	168700	494300	1196	2023-08-17
2021	325600	168700	494300	1196	2023-08-17
2020	347600	106300	453900	1196	2023-08-17
2022	4300	63600	67900	1197	2023-08-17
2021	4300	63600	67900	1197	2023-08-17
2020	3900	48900	52800	1197	2023-08-17
2022	0	0	0	1198	2023-08-17
2021	0	0	0	1198	2023-08-17
2020	0	0	0	1198	2023-08-17
2022	119800	138500	258300	1199	2023-08-17
2021	119800	138500	258300	1199	2023-08-17
2020	106300	100200	206500	1199	2023-08-17
2022	165800	130700	296500	1200	2023-08-17
2021	165800	130700	296500	1200	2023-08-17
2020	121900	99800	221700	1200	2023-08-17
2022	284500	138100	422600	1201	2023-08-17
2021	284500	138100	422600	1201	2023-08-17
2020	271600	105500	377100	1201	2023-08-17
2022	294100	138100	432200	1202	2023-08-17
2021	294100	138100	432200	1202	2023-08-17
2020	308300	105500	413800	1202	2023-08-17
2022	189100	138100	327200	1203	2023-08-17
2021	189100	138100	327200	1203	2023-08-17
2020	169000	99800	268800	1203	2023-08-17
2022	187600	145500	333100	1204	2023-08-17
2021	187600	145500	333100	1204	2023-08-17
2020	223100	105500	328600	1204	2023-08-17
2022	0	625400	625400	1206	2023-08-17
2021	0	625400	625400	1206	2023-08-17
2020	0	565200	565200	1206	2023-08-17
2022	0	16100	16100	1207	2023-08-17
2021	0	16100	16100	1207	2023-08-17
2020	0	12600	12600	1207	2023-08-17
2022	293700	162800	456500	1208	2023-08-17
2021	293700	162800	456500	1208	2023-08-17
2020	288100	141600	429700	1208	2023-08-17
2022	294100	199500	493600	1209	2023-08-17
2021	294100	199500	493600	1209	2023-08-17
2020	278000	156700	434700	1209	2023-08-17
2022	116300	167700	284000	1211	2023-08-17
2021	116300	167700	284000	1211	2023-08-17
2020	112900	120000	232900	1211	2023-08-17
2022	474700	190000	664700	1212	2023-08-17
2021	470800	190000	660800	1212	2023-08-17
2020	369200	160700	529900	1212	2023-08-17
2022	390400	189300	579700	1213	2023-08-17
2021	390400	189300	579700	1213	2023-08-17
2020	393500	160800	554300	1213	2023-08-17
2022	0	200	200	1214	2023-08-17
2021	0	200	200	1214	2023-08-17
2020	0	200	200	1214	2023-08-17
2022	0	5000	5000	1215	2023-08-17
2021	0	5000	5000	1215	2023-08-17
2020	0	5000	5000	1215	2023-08-17
2022	428200	195800	624000	1222	2023-08-17
2021	376600	195800	572400	1222	2023-08-17
2020	316000	155300	471300	1222	2023-08-17
2022	0	7600	7600	1223	2023-08-17
2021	0	7600	7600	1223	2023-08-17
2020	0	7600	7600	1223	2023-08-17
2022	222900	171500	394400	1225	2023-08-17
2021	222900	171500	394400	1225	2023-08-17
2020	215800	147900	363700	1225	2023-08-17
2022	831300	458400	1289700	1226	2023-08-17
2021	831300	458200	1289500	1226	2023-08-17
2020	828300	475500	1303800	1226	2023-08-17
2022	425300	149000	574300	1227	2023-08-17
2021	425300	149000	574300	1227	2023-08-17
2020	404100	146300	550400	1227	2023-08-17
2022	162200	168600	330800	1228	2023-08-17
2021	162200	168600	330800	1228	2023-08-17
2020	139600	144500	284100	1228	2023-08-17
2022	34700	33200	67900	1229	2023-08-17
2021	34700	33200	67900	1229	2023-08-17
2020	38700	29100	67800	1229	2023-08-17
2022	358200	135200	493400	1230	2023-08-17
2021	358200	135100	493300	1230	2023-08-17
2020	302600	103300	405900	1230	2023-08-17
2022	156500	147100	303600	1232	2023-08-17
2021	156500	147100	303600	1232	2023-08-17
2020	157000	113400	270400	1232	2023-08-17
2022	304300	176600	480900	1233	2023-08-17
2021	304300	176600	480900	1233	2023-08-17
2020	277100	166400	443500	1233	2023-08-17
2022	129400	136700	266100	1234	2023-08-17
2021	129400	136700	266100	1234	2023-08-17
2020	100400	93900	194300	1234	2023-08-17
2022	114800	120800	235600	1235	2023-08-17
2021	114800	120800	235600	1235	2023-08-17
2020	71100	91700	162800	1235	2023-08-17
2022	66500	143200	209700	1236	2023-08-17
2021	66500	143200	209700	1236	2023-08-17
2020	51800	106900	158700	1236	2023-08-17
2022	0	3400	3400	1243	2023-08-17
2021	0	3400	3400	1243	2023-08-17
2020	0	3400	3400	1243	2023-08-17
2022	510900	281800	792700	1247	2023-08-17
2021	510900	281800	792700	1247	2023-08-17
2020	426000	236900	662900	1247	2023-08-17
2022	455900	235400	691300	1248	2023-08-17
2021	455900	235400	691300	1248	2023-08-17
2020	431100	217500	648600	1248	2023-08-17
2022	176600	414100	590700	1249	2023-08-17
2021	176600	414100	590700	1249	2023-08-17
2020	161600	375100	536700	1249	2023-08-17
2022	278300	168700	447000	1250	2023-08-17
2021	278300	168700	447000	1250	2023-08-17
2020	275100	134800	409900	1250	2023-08-17
2022	457500	129900	587400	1251	2023-08-17
2021	457500	129900	587400	1251	2023-08-17
2020	382500	100300	482800	1251	2023-08-17
2022	363500	157800	521300	1255	2023-08-17
2021	363500	157800	521300	1255	2023-08-17
2020	284600	125300	409900	1255	2023-08-17
2022	238500	140300	378800	1256	2023-08-17
2021	238500	140300	378800	1256	2023-08-17
2020	244700	109400	354100	1256	2023-08-17
2022	149000	130700	279700	1257	2023-08-17
2021	149000	130700	279700	1257	2023-08-17
2020	130800	90300	221100	1257	2023-08-17
2022	156000	170500	326500	1263	2023-08-17
2021	156000	170500	326500	1263	2023-08-17
2020	156600	129000	285600	1263	2023-08-17
2022	255500	146600	402100	1265	2023-08-17
2021	255500	146600	402100	1265	2023-08-17
2020	249900	118100	368000	1265	2023-08-17
2022	324100	173300	497400	1266	2023-08-17
2021	324100	173300	497400	1266	2023-08-17
2020	302300	140100	442400	1266	2023-08-17
2022	278100	149300	427400	1267	2023-08-17
2021	278100	149300	427400	1267	2023-08-17
2020	209900	103700	313600	1267	2023-08-17
2022	21400	118300	139700	1268	2023-08-17
2021	28300	126800	155100	1268	2023-08-17
2020	13000	91900	104900	1268	2023-08-17
2022	184700	136800	321500	1269	2023-08-17
2021	184700	136800	321500	1269	2023-08-17
2020	190400	100000	290400	1269	2023-08-17
2022	0	5200	5200	1270	2023-08-17
2021	0	5200	5200	1270	2023-08-17
2020	0	4500	4500	1270	2023-08-17
2022	312500	150800	463300	1271	2023-08-17
2021	312500	150800	463300	1271	2023-08-17
2020	321200	111500	432700	1271	2023-08-17
2022	389400	151700	541100	1272	2023-08-17
2021	369200	151700	520900	1272	2023-08-17
2020	367100	120100	487200	1272	2023-08-17
2022	312200	168100	480300	1274	2023-08-17
2021	312200	168100	480300	1274	2023-08-17
2020	306100	128300	434400	1274	2023-08-17
2022	0	13900	13900	1277	2023-08-17
2021	0	13900	13900	1277	2023-08-17
2020	0	13900	13900	1277	2023-08-17
2022	0	304600	304600	1282	2023-08-17
2021	0	304600	304600	1282	2023-08-17
2020	0	261200	261200	1282	2023-08-17
2022	0	2600	2600	1289	2023-08-17
2021	0	2600	2600	1289	2023-08-17
2020	0	2600	2600	1289	2023-08-17
2022	0	400	400	1291	2023-08-17
2021	0	400	400	1291	2023-08-17
2020	0	400	400	1291	2023-08-17
2022	0	186800	186800	1292	2023-08-17
2021	0	186800	186800	1292	2023-08-17
2020	0	168000	168000	1292	2023-08-17
2022	1014200	171600	1185800	1298	2023-08-17
2021	1009200	171600	1180800	1298	2023-08-17
2020	900600	225200	1125800	1298	2023-08-17
2022	329400	124400	453800	1299	2023-08-17
2021	329400	124400	453800	1299	2023-08-17
2020	312600	93000	405600	1299	2023-08-17
2022	0	191600	191600	1302	2023-08-17
2021	0	191600	191600	1302	2023-08-17
2020	0	157900	157900	1302	2023-08-17
2022	830300	1101600	1931900	1304	2023-08-17
2021	830300	1101600	1931900	1304	2023-08-17
2020	782300	765000	1547300	1304	2023-08-17
2022	3697300	337000	4034300	1305	2023-08-17
2021	3697300	337000	4034300	1305	2023-08-17
2020	3564000	286000	3850000	1305	2023-08-17
2022	0	5200	5200	1309	2023-08-17
2021	0	5200	5200	1309	2023-08-17
2020	0	5200	5200	1309	2023-08-17
2022	441600	237500	679100	1311	2023-08-17
2021	441600	237500	679100	1311	2023-08-17
2020	411300	215900	627200	1311	2023-08-17
2022	0	778800	778800	1312	2023-08-17
2021	0	778800	778800	1312	2023-08-17
2020	0	708000	708000	1312	2023-08-17
2022	241900	133700	375600	1313	2023-08-17
2021	241900	133700	375600	1313	2023-08-17
2020	235400	97100	332500	1313	2023-08-17
2022	5700	17500	23200	1319	2023-08-17
2021	5700	17500	23200	1319	2023-08-17
2020	3900	20900	24800	1319	2023-08-17
2022	402700	163300	566000	1323	2023-08-17
2021	402700	163300	566000	1323	2023-08-17
2020	368900	171300	540200	1323	2023-08-17
2022	207200	252600	459800	1325	2023-08-17
2021	207200	252600	459800	1325	2023-08-17
2020	176000	193300	369300	1325	2023-08-17
2022	780700	260200	1040900	1326	2023-08-17
2021	780700	260200	1040900	1326	2023-08-17
2020	693500	280700	974200	1326	2023-08-17
2022	0	435200	435200	1327	2023-08-17
2021	0	435200	435200	1327	2023-08-17
2020	0	396800	396800	1327	2023-08-17
2022	0	2700	2700	1332	2023-08-17
2021	0	2700	2700	1332	2023-08-17
2020	0	2700	2700	1332	2023-08-17
2022	527300	224000	751300	1333	2023-08-17
2021	527300	224000	751300	1333	2023-08-17
2020	417400	217900	635300	1333	2023-08-17
2022	307900	254700	562600	1335	2023-08-17
2021	307900	254700	562600	1335	2023-08-17
2020	309700	243500	553200	1335	2023-08-17
2022	0	7000	7000	1336	2023-08-17
2021	0	7000	7000	1336	2023-08-17
2020	0	7000	7000	1336	2023-08-17
2022	0	800	800	1337	2023-08-17
2021	0	800	800	1337	2023-08-17
2020	0	800	800	1337	2023-08-17
2022	546500	178300	724800	1338	2023-08-17
2021	546500	178300	724800	1338	2023-08-17
2020	518300	155300	673600	1338	2023-08-17
2022	225000	195500	420500	1340	2023-08-17
2021	225000	195500	420500	1340	2023-08-17
2020	306100	194900	501000	1340	2023-08-17
2022	644800	202500	847300	1341	2023-08-17
2021	644800	202500	847300	1341	2023-08-17
2020	540800	231100	771900	1341	2023-08-17
2022	456000	230800	686800	1342	2023-08-17
2021	456000	230800	686800	1342	2023-08-17
2020	405700	196500	602200	1342	2023-08-17
2022	100700	198500	299200	1343	2023-08-17
2021	100700	198500	299200	1343	2023-08-17
2020	111900	160500	272400	1343	2023-08-17
2022	518400	278300	796700	1344	2023-08-17
2021	518400	278300	796700	1344	2023-08-17
2020	503200	271000	774200	1344	2023-08-17
2022	280600	235100	515700	1352	2023-08-17
2021	280600	235100	515700	1352	2023-08-17
2020	248600	244300	492900	1352	2023-08-17
2022	716800	255300	972100	1353	2023-08-17
2021	716800	255300	972100	1353	2023-08-17
2020	674200	246700	920900	1353	2023-08-17
2022	328100	345100	673200	1354	2023-08-17
2021	328100	345100	673200	1354	2023-08-17
2020	390500	244400	634900	1354	2023-08-17
2022	0	7500	7500	1355	2023-08-17
2021	0	7500	7500	1355	2023-08-17
2020	0	7500	7500	1355	2023-08-17
2022	0	59500	59500	1356	2023-08-17
2021	0	59500	59500	1356	2023-08-17
2020	0	59500	59500	1356	2023-08-17
2022	0	1900	1900	1358	2023-08-17
2021	0	1800	1800	1358	2023-08-17
2020	0	1800	1800	1358	2023-08-17
2022	0	12400	12400	1360	2023-08-17
2021	0	12400	12400	1360	2023-08-17
2020	0	12400	12400	1360	2023-08-17
2022	0	3000	3000	1361	2023-08-17
2021	0	3000	3000	1361	2023-08-17
2020	0	3000	3000	1361	2023-08-17
2022	0	14700	14700	1362	2023-08-17
2021	0	14700	14700	1362	2023-08-17
2020	0	13300	13300	1362	2023-08-17
2022	0	8500	8500	1363	2023-08-17
2021	0	8500	8500	1363	2023-08-17
2020	0	7600	7600	1363	2023-08-17
2022	0	1500	1500	1364	2023-08-17
2021	0	1500	1500	1364	2023-08-17
2020	0	1500	1500	1364	2023-08-17
2022	0	200	200	1365	2023-08-17
2021	0	200	200	1365	2023-08-17
2020	0	200	200	1365	2023-08-17
2022	0	1600	1600	1366	2023-08-17
2021	0	1600	1600	1366	2023-08-17
2020	0	1600	1600	1366	2023-08-17
2022	1900	207700	209600	1367	2023-08-17
2021	1900	207700	209600	1367	2023-08-17
2020	3300	162900	166200	1367	2023-08-17
2022	970800	433900	1404700	1373	2023-08-17
2021	970800	433900	1404700	1373	2023-08-17
2020	946000	403700	1349700	1373	2023-08-17
2022	271300	225400	496700	1374	2023-08-17
2021	271300	225400	496700	1374	2023-08-17
2020	181700	207800	389500	1374	2023-08-17
2022	1454000	363600	1817600	1375	2023-08-17
2021	1454000	363600	1817600	1375	2023-08-17
2020	1201400	535400	1736800	1375	2023-08-17
2022	0	4300	4300	1379	2023-08-17
2021	0	4300	4300	1379	2023-08-17
2020	0	4300	4300	1379	2023-08-17
2022	613200	345400	958600	1382	2023-08-17
2021	613200	345400	958600	1382	2023-08-17
2020	495200	390700	885900	1382	2023-08-17
2022	633900	226400	860300	1384	2023-08-17
2021	633900	226500	860400	1384	2023-08-17
2020	514900	340200	855100	1384	2023-08-17
2022	596100	172400	768500	1385	2023-08-17
2021	596200	172300	768500	1385	2023-08-17
2020	468200	224500	692700	1385	2023-08-17
2022	800900	405800	1206700	1386	2023-08-17
2021	800900	405800	1206700	1386	2023-08-17
2020	843000	392100	1235100	1386	2023-08-17
2022	0	2900	2900	1387	2023-08-17
2021	0	2800	2800	1387	2023-08-17
2020	0	2800	2800	1387	2023-08-17
2022	0	8200	8200	1388	2023-08-17
2021	0	8200	8200	1388	2023-08-17
2020	0	8200	8200	1388	2023-08-17
2022	159400	177400	336800	1389	2023-08-17
2021	159400	177400	336800	1389	2023-08-17
2020	111500	141900	253400	1389	2023-08-17
2022	0	12400	12400	1394	2023-08-17
2021	0	11800	11800	1394	2023-08-17
2020	0	11800	11800	1394	2023-08-17
2022	0	3600	3600	1399	2023-08-17
2021	0	3600	3600	1399	2023-08-17
2020	0	3600	3600	1399	2023-08-17
2022	0	6700	6700	1400	2023-08-17
2021	0	6300	6300	1400	2023-08-17
2020	0	6300	6300	1400	2023-08-17
2022	0	3300	3300	1401	2023-08-17
2021	0	3300	3300	1401	2023-08-17
2020	0	3300	3300	1401	2023-08-17
2022	0	4000	4000	1402	2023-08-17
2021	0	4000	4000	1402	2023-08-17
2020	0	4000	4000	1402	2023-08-17
2022	0	100	100	1403	2023-08-17
2021	0	100	100	1403	2023-08-17
2020	0	100	100	1403	2023-08-17
2022	703700	229900	933600	1406	2023-08-17
2021	703700	230000	933700	1406	2023-08-17
2020	754700	274500	1029200	1406	2023-08-17
2022	165400	109200	274600	1410	2023-08-17
2021	165400	109200	274600	1410	2023-08-17
2020	153800	114800	268600	1410	2023-08-17
2022	105000	97900	202900	1412	2023-08-17
2021	105000	97900	202900	1412	2023-08-17
2020	96200	75900	172100	1412	2023-08-17
2022	0	2100	2100	1413	2023-08-17
2021	0	2100	2100	1413	2023-08-17
2020	0	2100	2100	1413	2023-08-17
2022	0	16700	16700	1417	2023-08-17
2021	0	16700	16700	1417	2023-08-17
2020	0	16700	16700	1417	2023-08-17
2022	0	342200	342200	1423	2023-08-17
2021	0	342200	342200	1423	2023-08-17
2020	0	311000	311000	1423	2023-08-17
2022	0	88300	88300	1435	2023-08-17
2021	0	88300	88300	1435	2023-08-17
2020	0	80300	80300	1435	2023-08-17
2022	0	57100	57100	1436	2023-08-17
2021	0	57100	57100	1436	2023-08-17
2020	0	51900	51900	1436	2023-08-17
2022	0	183500	183500	1437	2023-08-17
2021	0	183500	183500	1437	2023-08-17
2020	0	166900	166900	1437	2023-08-17
2022	0	177200	177200	1438	2023-08-17
2021	0	177200	177200	1438	2023-08-17
2020	0	159300	159300	1438	2023-08-17
2022	0	85000	85000	1439	2023-08-17
2021	0	85000	85000	1439	2023-08-17
2020	0	77200	77200	1439	2023-08-17
2022	0	404400	404400	1440	2023-08-17
2021	0	404400	404400	1440	2023-08-17
2020	0	367600	367600	1440	2023-08-17
2022	0	7500	7500	1441	2023-08-17
2021	0	7500	7500	1441	2023-08-17
2020	0	6800	6800	1441	2023-08-17
2022	0	10900	10900	1442	2023-08-17
2021	0	10900	10900	1442	2023-08-17
2020	0	9200	9200	1442	2023-08-17
2022	0	5900	5900	1443	2023-08-17
2021	0	5900	5900	1443	2023-08-17
2020	0	5900	5900	1443	2023-08-17
2022	0	11000	11000	1446	2023-08-17
2021	0	11000	11000	1446	2023-08-17
2020	0	11000	11000	1446	2023-08-17
2022	200	2500	2700	1447	2023-08-17
2021	200	2500	2700	1447	2023-08-17
2020	200	2500	2700	1447	2023-08-17
2022	0	183000	183000	1448	2023-08-17
2021	0	183000	183000	1448	2023-08-17
2020	0	142000	142000	1448	2023-08-17
2022	60700	274900	335600	1449	2023-08-17
2021	60700	274900	335600	1449	2023-08-17
2020	79000	179900	258900	1449	2023-08-17
2022	18900	73200	92100	1450	2023-08-17
2021	18900	73200	92100	1450	2023-08-17
2020	16600	64000	80600	1450	2023-08-17
2022	109100	145500	254600	1451	2023-08-17
2021	109100	145500	254600	1451	2023-08-17
2020	86700	118800	205500	1451	2023-08-17
2022	224900	230900	455800	1455	2023-08-17
2021	219200	230900	450100	1455	2023-08-17
2020	208300	142200	350500	1455	2023-08-17
2022	18300	173700	192000	1456	2023-08-17
2021	34800	173700	208500	1456	2023-08-17
2020	27700	110900	138600	1456	2023-08-17
2022	122000	159100	281100	1457	2023-08-17
2021	122000	159100	281100	1457	2023-08-17
2020	123200	132400	255600	1457	2023-08-17
2022	316800	276100	592900	1462	2023-08-17
2021	316800	276100	592900	1462	2023-08-17
2020	280900	216200	497100	1462	2023-08-17
2022	0	1300	1300	1464	2023-08-17
2021	0	1300	1300	1464	2023-08-17
2020	0	1300	1300	1464	2023-08-17
2022	0	3600	3600	1466	2023-08-17
2021	0	3600	3600	1466	2023-08-17
2020	0	3600	3600	1466	2023-08-17
2022	280800	257600	538400	1468	2023-08-17
2021	280800	257500	538300	1468	2023-08-17
2020	232700	186000	418700	1468	2023-08-17
2022	0	75600	75600	1469	2023-08-17
2021	0	75600	75600	1469	2023-08-17
2020	0	70600	70600	1469	2023-08-17
2022	13000	165800	178800	1471	2023-08-17
2021	13000	165800	178800	1471	2023-08-17
2020	13000	67300	80300	1471	2023-08-17
2022	56000	236400	292400	1472	2023-08-17
2021	51300	236400	287700	1472	2023-08-17
2020	44100	156400	200500	1472	2023-08-17
2022	163200	276700	439900	1473	2023-08-17
2021	163200	276700	439900	1473	2023-08-17
2020	165800	161000	326800	1473	2023-08-17
2022	64200	240800	305000	1475	2023-08-17
2021	32700	240800	273500	1475	2023-08-17
2020	46200	126000	172200	1475	2023-08-17
2022	94400	139000	233400	1477	2023-08-17
2021	95100	139000	234100	1477	2023-08-17
2020	79700	106000	185700	1477	2023-08-17
2022	105200	166100	271300	1484	2023-08-17
2021	105200	166100	271300	1484	2023-08-17
2020	87300	123600	210900	1484	2023-08-17
2022	152700	201200	353900	1485	2023-08-17
2021	152700	201200	353900	1485	2023-08-17
2020	120000	148400	268400	1485	2023-08-17
2022	270400	120200	390600	1486	2023-08-17
2021	270400	120200	390600	1486	2023-08-17
2020	256300	98100	354400	1486	2023-08-17
2022	0	11200	11200	1488	2023-08-17
2021	0	11200	11200	1488	2023-08-17
2020	0	11200	11200	1488	2023-08-17
2022	0	6400	6400	1489	2023-08-17
2021	0	6400	6400	1489	2023-08-17
2020	0	6400	6400	1489	2023-08-17
2022	765900	167200	933100	100000	2023-08-17
2021	765900	167200	933100	100000	2023-08-17
2020	681800	174100	855900	100000	2023-08-17
2022	1128800	230900	1359700	100021	2023-08-17
2021	1128800	230900	1359700	100021	2023-08-17
2020	1046600	280100	1326700	100021	2023-08-17
2022	0	8800	8800	100041	2023-08-17
2021	0	8800	8800	100041	2023-08-17
2020	0	8800	8800	100041	2023-08-17
2022	234700	111100	345800	100103	2023-08-17
2021	234700	111100	345800	100103	2023-08-17
2020	243600	84100	327700	100103	2023-08-17
2022	386900	159800	546700	100122	2023-08-17
2021	386900	159800	546700	100122	2023-08-17
2020	316200	125500	441700	100122	2023-08-17
2022	217500	0	217500	100142	2023-08-17
2021	217500	0	217500	100142	2023-08-17
2020	185200	0	185200	100142	2023-08-17
2022	217500	0	217500	100162	2023-08-17
2021	217500	0	217500	100162	2023-08-17
2020	185200	0	185200	100162	2023-08-17
2022	251600	0	251600	100163	2023-08-17
2021	251600	0	251600	100163	2023-08-17
2020	229300	0	229300	100163	2023-08-17
2022	244700	0	244700	100164	2023-08-17
2021	244700	0	244700	100164	2023-08-17
2020	213500	0	213500	100164	2023-08-17
2022	377100	0	377100	100182	2023-08-17
2021	377100	0	377100	100182	2023-08-17
2020	326100	0	326100	100182	2023-08-17
2022	349600	0	349600	100184	2023-08-17
2021	349600	0	349600	100184	2023-08-17
2020	356600	0	356600	100184	2023-08-17
2022	0	20600	20600	100202	2023-08-17
2021	0	20600	20600	100202	2023-08-17
2020	0	20600	20600	100202	2023-08-17
2022	478200	158900	637100	100243	2023-08-17
2021	478200	158900	637100	100243	2023-08-17
2020	388000	131300	519300	100243	2023-08-17
2022	826700	181900	1008600	100262	2023-08-17
2021	826700	181900	1008600	100262	2023-08-17
2020	685200	194900	880100	100262	2023-08-17
2022	609800	202300	812100	100263	2023-08-17
2021	609800	202300	812100	100263	2023-08-17
2020	516000	171900	687900	100263	2023-08-17
2022	0	400	400	100264	2023-08-17
2021	0	400	400	100264	2023-08-17
2020	0	400	400	100264	2023-08-17
2022	431900	203100	635000	100265	2023-08-17
2021	431900	203100	635000	100265	2023-08-17
2020	345400	170500	515900	100265	2023-08-17
2022	545900	190100	736000	100282	2023-08-17
2021	545900	190100	736000	100282	2023-08-17
2020	447700	161300	609000	100282	2023-08-17
2022	263600	206300	469900	100302	2023-08-17
2021	263600	206300	469900	100302	2023-08-17
2020	221900	159500	381400	100302	2023-08-17
2022	0	4300	4300	100322	2023-08-17
2021	0	4300	4300	100322	2023-08-17
2020	0	4300	4300	100322	2023-08-17
2022	0	4200	4200	100361	2023-08-17
2021	0	4200	4200	100361	2023-08-17
2020	0	4200	4200	100361	2023-08-17
2022	0	2500	2500	100401	2023-08-17
2021	0	2500	2500	100401	2023-08-17
2020	0	2500	2500	100401	2023-08-17
2022	451200	0	451200	100422	2023-08-17
2021	451200	0	451200	100422	2023-08-17
2020	416300	0	416300	100422	2023-08-17
2022	387700	0	387700	100442	2023-08-17
2021	387700	0	387700	100442	2023-08-17
2020	355600	0	355600	100442	2023-08-17
2022	204700	0	204700	100462	2023-08-17
2021	204700	0	204700	100462	2023-08-17
2020	188700	0	188700	100462	2023-08-17
2022	398200	0	398200	100463	2023-08-17
2021	398200	0	398200	100463	2023-08-17
2020	364500	0	364500	100463	2023-08-17
2022	212900	0	212900	100482	2023-08-17
2021	212900	0	212900	100482	2023-08-17
2020	197100	0	197100	100482	2023-08-17
2022	421200	0	421200	100502	2023-08-17
2021	421200	0	421200	100502	2023-08-17
2020	385100	0	385100	100502	2023-08-17
2022	261900	0	261900	100503	2023-08-17
2021	261900	0	261900	100503	2023-08-17
2020	197400	0	197400	100503	2023-08-17
2022	184400	0	184400	100522	2023-08-17
2021	184400	0	184400	100522	2023-08-17
2020	171300	0	171300	100522	2023-08-17
2022	332100	0	332100	100523	2023-08-17
2021	332100	0	332100	100523	2023-08-17
2020	306200	0	306200	100523	2023-08-17
2022	473800	0	473800	100542	2023-08-17
2021	473800	0	473800	100542	2023-08-17
2020	429200	0	429200	100542	2023-08-17
2022	543400	0	543400	100543	2023-08-17
2021	543400	0	543400	100543	2023-08-17
2020	496700	0	496700	100543	2023-08-17
2022	427400	0	427400	100562	2023-08-17
2021	427400	0	427400	100562	2023-08-17
2020	393600	0	393600	100562	2023-08-17
2022	340300	0	340300	100563	2023-08-17
2021	340300	0	340300	100563	2023-08-17
2020	313300	0	313300	100563	2023-08-17
2022	385200	0	385200	100582	2023-08-17
2021	385200	0	385200	100582	2023-08-17
2020	346100	0	346100	100582	2023-08-17
2022	1848200	0	1848200	100583	2023-08-17
2021	1848200	0	1848200	100583	2023-08-17
2020	1690400	0	1690400	100583	2023-08-17
2022	0	2100	2100	100602	2023-08-17
2021	0	2100	2100	100602	2023-08-17
2020	0	2100	2100	100602	2023-08-17
2022	0	1500	1500	100622	2023-08-17
2021	0	1500	1500	100622	2023-08-17
2020	0	1500	1500	100622	2023-08-17
2022	0	33000	33000	100642	2023-08-17
2021	0	33000	33000	100642	2023-08-17
2020	0	30000	30000	100642	2023-08-17
2022	0	2600	2600	100662	2023-08-17
2021	0	2600	2600	100662	2023-08-17
2020	0	2600	2600	100662	2023-08-17
2022	374200	176700	550900	100722	2023-08-17
2021	359600	176700	536300	100722	2023-08-17
2020	248500	192600	441100	100722	2023-08-17
2022	674200	219200	893400	100742	2023-08-17
2021	674200	219200	893400	100742	2023-08-17
2020	346600	200800	547400	100742	2023-08-17
2022	147600	290200	437800	100822	2023-08-17
2021	147600	290200	437800	100822	2023-08-17
2020	134100	265300	399400	100822	2023-08-17
2022	162900	104400	267300	100863	2023-08-17
2021	162900	104400	267300	100863	2023-08-17
2020	154900	81500	236400	100863	2023-08-17
2022	0	179500	179500	101082	2023-08-17
2021	0	179500	179500	101082	2023-08-17
2020	0	135200	135200	101082	2023-08-17
2022	531300	180100	711400	101143	2023-08-17
2021	588800	207200	796000	101143	2023-08-17
2020	503500	142500	646000	101143	2023-08-17
2022	273300	253100	526400	101162	2023-08-17
2021	273300	253100	526400	101162	2023-08-17
2020	234200	253100	487300	101162	2023-08-17
2022	457000	332800	789800	101182	2023-08-17
2021	457000	332800	789800	101182	2023-08-17
2020	363200	293700	656900	101182	2023-08-17
2022	0	400	400	101183	2023-08-17
2021	0	400	400	101183	2023-08-17
2020	0	400	400	101183	2023-08-17
2022	0	3100	3100	101202	2023-08-17
2021	0	3100	3100	101202	2023-08-17
2020	0	2900	2900	101202	2023-08-17
2022	0	6400	6400	101203	2023-08-17
2021	0	6400	6400	101203	2023-08-17
2020	0	6400	6400	101203	2023-08-17
2022	0	2800	2800	101204	2023-08-17
2021	0	2800	2800	101204	2023-08-17
2020	0	2800	2800	101204	2023-08-17
2022	0	2500	2500	101205	2023-08-17
2021	0	2500	2500	101205	2023-08-17
2020	0	2500	2500	101205	2023-08-17
2022	521700	174800	696500	101224	2023-08-17
2021	484500	174400	658900	101224	2023-08-17
2020	389900	158900	548800	101224	2023-08-17
2022	660000	249300	909300	101242	2023-08-17
2021	660000	249300	909300	101242	2023-08-17
2020	533100	220700	753800	101242	2023-08-17
2022	621200	221300	842500	101243	2023-08-17
2021	621200	221300	842500	101243	2023-08-17
2020	486400	188500	674900	101243	2023-08-17
2022	408800	185900	594700	101262	2023-08-17
2021	405400	185900	591300	101262	2023-08-17
2020	380700	163700	544400	101262	2023-08-17
2022	384200	200700	584900	101282	2023-08-17
2021	384200	200600	584800	101282	2023-08-17
2020	267400	155600	423000	101282	2023-08-17
2022	628800	203400	832200	101325	2023-08-17
2021	628800	203400	832200	101325	2023-08-17
2020	594700	241800	836500	101325	2023-08-17
2022	812300	660900	1473200	101342	2023-08-17
2021	810900	874800	1685700	101342	2023-08-17
2020	811100	528100	1339200	101342	2023-08-17
2022	516800	186500	703300	101362	2023-08-17
2021	516900	186400	703300	101362	2023-08-17
2020	108200	119700	227900	101362	2023-08-17
2022	244600	182200	426800	101382	2023-08-17
2021	244400	182200	426600	101382	2023-08-17
2020	246400	182700	429100	101382	2023-08-17
2022	3500	89800	93300	101442	2023-08-17
2021	3500	89800	93300	101442	2023-08-17
2020	3300	32100	35400	101442	2023-08-17
2022	926800	191100	1117900	101462	2023-08-17
2021	926800	191100	1117900	101462	2023-08-17
2020	840900	176500	1017400	101462	2023-08-17
2022	200	144400	144600	101483	2023-08-17
2021	200	144400	144600	101483	2023-08-17
2020	0	119900	119900	101483	2023-08-17
2022	0	13400	13400	101502	2023-08-17
2021	0	13400	13400	101502	2023-08-17
2020	0	11600	11600	101502	2023-08-17
2022	319000	144400	463400	101523	2023-08-17
2021	319000	144400	463400	101523	2023-08-17
2020	295500	105300	400800	101523	2023-08-17
2022	203700	327400	531100	101542	2023-08-17
2021	203700	327400	531100	101542	2023-08-17
2020	109800	271800	381600	101542	2023-08-17
2022	900	15900	16800	101562	2023-08-17
2021	900	15900	16800	101562	2023-08-17
2020	800	15600	16400	101562	2023-08-17
2022	0	2900	2900	101582	2023-08-17
2021	0	2800	2800	101582	2023-08-17
2020	0	2800	2800	101582	2023-08-17
2022	243200	0	243200	101602	2023-08-17
2021	243200	0	243200	101602	2023-08-17
2020	217800	0	217800	101602	2023-08-17
2022	344800	114500	459300	101622	2023-08-17
2021	334300	114400	448700	101622	2023-08-17
2020	139800	96100	235900	101622	2023-08-17
2022	281900	144800	426700	101642	2023-08-17
2021	281900	144800	426700	101642	2023-08-17
2020	260900	111600	372500	101642	2023-08-17
2022	6300	16400	22700	102644	2023-08-17
2021	6300	16400	22700	102644	2023-08-17
2020	8300	11800	20100	102644	2023-08-17
2022	791100	301800	1092900	102691	2023-08-17
2021	791100	301800	1092900	102691	2023-08-17
2020	718300	355800	1074100	102691	2023-08-17
2022	645300	168900	814200	102692	2023-08-17
2021	645300	168900	814200	102692	2023-08-17
2020	522900	148200	671100	102692	2023-08-17
2022	11100	246900	258000	102712	2023-08-17
2021	11100	246900	258000	102712	2023-08-17
2020	8300	183700	192000	102712	2023-08-17
2022	36300	69300	105600	102732	2023-08-17
2021	36300	69300	105600	102732	2023-08-17
2020	16600	62700	79300	102732	2023-08-17
2022	425900	192300	618200	102736	2023-08-17
2021	425900	192300	618200	102736	2023-08-17
2020	394900	192000	586900	102736	2023-08-17
2022	672900	368500	1041400	102737	2023-08-17
2021	672900	368500	1041400	102737	2023-08-17
2020	569100	324800	893900	102737	2023-08-17
2022	0	600	600	102759	2023-08-17
2021	0	600	600	102759	2023-08-17
2020	0	600	600	102759	2023-08-17
2022	0	3300	3300	102763	2023-08-17
2021	0	3300	3300	102763	2023-08-17
2020	0	3300	3300	102763	2023-08-17
2022	171800	174300	346100	102766	2023-08-17
2021	171800	174300	346100	102766	2023-08-17
2020	169600	153300	322900	102766	2023-08-17
2022	0	109300	109300	102768	2023-08-17
2021	0	109300	109300	102768	2023-08-17
2020	0	83800	83800	102768	2023-08-17
2022	632600	180600	813200	102770	2023-08-17
2021	632600	180600	813200	102770	2023-08-17
2020	572100	196400	768500	102770	2023-08-17
2022	155400	136800	292200	102771	2023-08-17
2021	155400	136800	292200	102771	2023-08-17
2020	142000	93900	235900	102771	2023-08-17
2022	0	14800	14800	102772	2023-08-17
2021	0	14800	14800	102772	2023-08-17
2020	0	14800	14800	102772	2023-08-17
2022	49000	342900	391900	102814	2023-08-17
2021	49000	342900	391900	102814	2023-08-17
2020	42600	278300	320900	102814	2023-08-17
2022	0	126900	126900	102815	2023-08-17
2021	0	126900	126900	102815	2023-08-17
2020	0	114900	114900	102815	2023-08-17
2022	860200	346200	1206400	102834	2023-08-17
2021	860200	346200	1206400	102834	2023-08-17
2020	756800	297800	1054600	102834	2023-08-17
2022	67300	91400	158700	102854	2023-08-17
2021	67300	91400	158700	102854	2023-08-17
2020	45900	69600	115500	102854	2023-08-17
2022	0	3800	3800	102874	2023-08-17
2021	0	3800	3800	102874	2023-08-17
2020	0	3800	3800	102874	2023-08-17
2022	0	13700	13700	102875	2023-08-17
2021	0	13700	13700	102875	2023-08-17
2020	0	13700	13700	102875	2023-08-17
2022	0	800	800	102876	2023-08-17
2021	0	800	800	102876	2023-08-17
2020	0	800	800	102876	2023-08-17
2022	0	500	500	102896	2023-08-17
2021	0	500	500	102896	2023-08-17
2020	0	400	400	102896	2023-08-17
2022	72500	265300	337800	102897	2023-08-17
2021	72500	265300	337800	102897	2023-08-17
2020	96500	216600	313100	102897	2023-08-17
2022	0	25000	25000	102916	2023-08-17
2021	0	25000	25000	102916	2023-08-17
2020	0	25000	25000	102916	2023-08-17
2022	0	237100	237100	102956	2023-08-17
2021	0	237100	237100	102956	2023-08-17
2020	0	206300	206300	102956	2023-08-17
2022	37100	121900	159000	102976	2023-08-17
2021	37100	121900	159000	102976	2023-08-17
2020	28500	93900	122400	102976	2023-08-17
2022	0	10000	10000	102996	2023-08-17
2021	0	9900	9900	102996	2023-08-17
2020	0	9900	9900	102996	2023-08-17
2022	34800	42800	77600	103016	2023-08-17
2021	34800	42800	77600	103016	2023-08-17
2020	34200	43200	77400	103016	2023-08-17
2022	0	2000	2000	103036	2023-08-17
2021	0	2000	2000	103036	2023-08-17
2020	0	2000	2000	103036	2023-08-17
2022	327800	330000	657800	103057	2023-08-17
2021	327800	330000	657800	103057	2023-08-17
2020	411500	237400	648900	103057	2023-08-17
2022	0	2300	2300	103079	2023-08-17
2021	0	2300	2300	103079	2023-08-17
2020	0	2300	2300	103079	2023-08-17
2022	0	3000	3000	103097	2023-08-17
2021	0	3000	3000	103097	2023-08-17
2020	0	3000	3000	103097	2023-08-17
2022	37000	44500	81500	103117	2023-08-17
2021	37000	44500	81500	103117	2023-08-17
2020	39700	44500	84200	103117	2023-08-17
2022	50000	0	50000	103137	2023-08-17
2021	50000	0	50000	103137	2023-08-17
2020	45500	0	45500	103137	2023-08-17
2022	0	4500	4500	103157	2023-08-17
2021	0	4500	4500	103157	2023-08-17
2020	0	4500	4500	103157	2023-08-17
2022	33600	88000	121600	103178	2023-08-17
2021	33600	88000	121600	103178	2023-08-17
2022	60000	0	60000	103197	2023-08-17
2021	60000	0	60000	103197	2023-08-17
2022	0	1500	1500	103220	2023-08-17
2022	0	1300	1300	103222	2023-08-17
2022	350700	0	350700	103224	2023-08-17
2022	148500	0	148500	103225	2023-08-17
2022	175000	0	175000	103226	2023-08-17
2022	144800	0	144800	103227	2023-08-17
2022	138900	0	138900	103228	2023-08-17
2022	138000	0	138000	103229	2023-08-17
2022	152100	0	152100	103230	2023-08-17
2022	141100	0	141100	103233	2023-08-17
2022	141000	0	141000	103237	2023-08-17
2022	131100	0	131100	103238	2023-08-17
2022	146200	0	146200	103239	2023-08-17
2022	147300	0	147300	103240	2023-08-17
2022	143100	0	143100	103242	2023-08-17
2022	145400	0	145400	103243	2023-08-17
2022	140800	0	140800	103244	2023-08-17
2022	161100	0	161100	103245	2023-08-17
2022	139800	0	139800	103246	2023-08-17
2022	139800	0	139800	103247	2023-08-17
2022	155900	0	155900	103248	2023-08-17
2022	141600	0	141600	103249	2023-08-17
2022	158900	0	158900	103250	2023-08-17
2022	144800	0	144800	103251	2023-08-17
No Data for PID				103252	2023-08-17
No Data for PID				103253	2023-08-17
No Data for PID				103254	2023-08-17
No Data for PID				103255	2023-08-17
